
Rk,Player,Pos,Age,Tm,G,GS,MP,FG,FGA,FG%,3P,3PA,3P%,2P,2PA,2P%,eFG%,FT,FTA,FT%,ORB,DRB,TRB,AST,STL,BLK,TOV,PF,PTS
1,Kareem Abdul-Jabbar*\abdulka01,C,32,LAL,82,,3143,835,1383,.604,0,1,.000,835,1382,.604,.604,364,476,.765,190,696,886,371,81,280,297,216,2034
2,Tom Abernethy\abernto01,PF,25,GSW,67,,1222,153,318,.481,0,1,.000,153,317,.483,.481,56,82,.683,62,129,191,87,35,12,39,118,362
3,Alvan Adams\adamsal01,C,25,PHO,75,,2168,465,875,.531,0,2,.000,465,873,.533,.531,188,236,.797,158,451,609,322,108,55,218,237,1118
4,Tiny Archibald*\architi01,PG,31,BOS,80,80,2864,383,794,.482,4,18,.222,379,776,.488,.485,361,435,.830,59,138,197,671,106,10,242,218,1131
5,Dennis Awtrey\awtrede01,C,31,CHI,26,,560,27,60,.450,0,0,,27,60,.450,.450,32,50,.640,29,86,115,40,12,15,27,66,86
6,Gus Bailey\bailegu01,SG,28,WSB,20,,180,16,35,.457,1,1,1.000,15,34,.441,.471,5,13,.385,6,22,28,26,7,4,11,18,38
7,James Bailey\baileja01,PF,22,SEA,67,,726,122,271,.450,0,0,,122,271,.450,.450,68,101,.673,71,126,197,28,21,54,79,116,312
8,Greg Ballard\ballagr01,SF,25,WSB,82,,2438,545,1101,.495,16,47,.340,529,1054,.502,.502,171,227,.753,240,398,638,159,90,36,133,197,1277
9,Mike Bantom\bantomi01,SF,28,IND,77,,2330,384,760,.505,1,3,.333,383,757,.506,.506,139,209,.665,192,264,456,279,85,49,189,268,908
10,Marvin Barnes\barnema01,PF,27,SDC,20,,287,24,60,.400,0,0,,24,60,.400,.400,16,32,.500,34,43,77,18,5,12,18,52,64
11,Rick Barry*\barryri01,SF,35,HOU,72,,1816,325,771,.422,73,221,.330,252,550,.458,.469,143,153,.935,53,183,236,268,80,28,152,182,866
12,Tim Bassett\basseti01,PF,28,TOT,12,,164,12,34,.353,0,0,,12,34,.353,.353,10,15,.667,11,22,33,14,8,0,9,27,34
13,Billy Ray Bates\batesbi01,SG,23,POR,16,,235,72,146,.493,8,19,.421,64,127,.504,.521,28,39,.718,13,16,29,31,14,2,20,26,180
14,Ron Behagen\behagro01,PF,29,WSB,6,,64,9,23,.391,0,0,,9,23,.391,.391,5,6,.833,6,8,14,7,0,4,4,14,23
15,Kent Benson\bensoke01,C,25,TOT,73,,1891,299,618,.484,1,5,.200,298,613,.486,.485,99,141,.702,126,327,453,178,73,92,157,246,698
16,Del Beshore\beshode01,PG,23,CHI,68,,869,88,250,.352,10,26,.385,78,224,.348,.372,58,87,.667,16,47,63,139,58,5,104,105,244
17,Henry Bibby\bibbyhe01,PG,30,PHI,82,,2035,251,626,.401,11,52,.212,240,574,.418,.410,226,286,.790,65,143,208,307,62,6,147,161,739
18,Larry Bird*\birdla01,PF,23,BOS,82,82,2955,693,1463,.474,58,143,.406,635,1320,.481,.494,301,360,.836,216,636,852,370,143,53,263,279,1745
19,Otis Birdsong\birdsot01,SG,24,KCK,82,,2885,781,1546,.505,10,36,.278,771,1510,.511,.508,286,412,.694,170,161,331,202,136,22,179,226,1858
20,Ron Boone\boonero01,SG,33,TOT,81,,2392,405,915,.443,19,50,.380,386,865,.446,.453,175,196,.893,54,173,227,309,97,3,197,232,1004
21,Lawrence Boston\bostola01,PF,23,WSB,13,,125,24,52,.462,0,0,,24,52,.462,.462,8,13,.615,19,20,39,2,4,2,8,25,56
22,Tom Boswell\bosweto01,PF,26,TOT,79,,2077,346,613,.564,5,10,.500,341,603,.566,.569,206,273,.755,146,296,442,161,29,37,181,270,903
23,Winford Boynes\boynewi01,SG,22,NJN,64,,1102,221,467,.473,0,4,.000,221,463,.477,.473,104,136,.765,51,82,133,95,59,19,96,132,546
24,Alonzo Bradley\bradlal01,SF,26,HOU,22,,96,17,48,.354,1,1,1.000,16,47,.340,.365,6,9,.667,2,4,6,3,3,0,8,9,41
25,Dudley Bradley\bradldu01,SG,22,IND,82,,2027,275,609,.452,2,5,.400,273,604,.452,.453,136,174,.782,69,154,223,252,211,48,166,194,688
26,Mike Bratz\bratzmi01,PG,24,PHO,82,,1589,269,687,.392,21,86,.244,248,601,.413,.407,141,162,.870,50,117,167,223,93,9,135,165,700
27,Jim Brewer\breweji01,PF,28,POR,67,,1016,90,184,.489,0,5,.000,90,179,.503,.489,14,29,.483,101,156,257,75,42,43,47,129,194
28,Ron Brewer\brewero01,SG,24,POR,82,,2815,548,1182,.464,6,32,.188,542,1150,.471,.466,184,219,.840,54,160,214,216,98,48,167,154,1286
29,Junior Bridgeman\bridgju01,SF,26,MIL,81,,2316,594,1243,.478,5,27,.185,589,1216,.484,.480,230,266,.865,104,197,301,237,94,20,172,216,1423
30,Allan Bristow\bristal01,SF,28,UTA,82,,2304,377,785,.480,2,7,.286,375,778,.482,.482,197,243,.811,170,342,512,341,88,6,179,211,953
31,Fred Brown\brownfr01,SG,31,SEA,80,,1701,404,843,.479,39,88,.443,365,755,.483,.502,113,135,.837,35,120,155,174,65,17,105,117,960
32,John Brown\brownjo01,SF,28,TOT,32,,385,37,105,.352,0,0,,37,105,.352,.352,38,48,.792,26,45,71,18,3,4,29,70,112
33,Roger Brown\brownro02,C,29,CHI,4,,37,1,3,.333,0,0,,1,3,.333,.333,0,0,,2,8,10,1,0,3,0,4,2
34,Joe Bryant\bryanjo01,PF,25,SDC,81,,2328,294,682,.431,5,34,.147,289,648,.446,.435,161,217,.742,171,345,516,144,102,39,170,258,754
35,Quinn Buckner\bucknqu01,PG,25,MIL,67,,1690,306,655,.467,2,5,.400,304,650,.468,.469,105,143,.734,69,169,238,383,135,4,149,202,719
36,Tom Burleson\burleto01,C,27,KCK,37,,272,36,104,.346,0,3,.000,36,101,.356,.346,23,40,.575,23,49,72,20,8,13,25,49,95
37,Don Buse\busedo01,PG,29,PHO,81,,2499,261,589,.443,19,79,.241,242,510,.475,.459,85,128,.664,70,163,233,320,132,10,91,111,626
38,Marty Byrnes\byrnema01,SF,23,LAL,32,,194,25,50,.500,0,0,,25,50,.500,.500,13,15,.867,9,18,27,13,5,1,22,32,63
39,Corky Calhoun\calhoco01,SF,29,IND,7,,30,4,9,.444,0,0,,4,9,.444,.444,0,2,.000,7,3,10,0,2,0,1,6,8
40,Mack Calvin\calvima01,PG,32,UTA,48,,772,100,227,.441,1,11,.091,99,216,.458,.443,105,117,.897,13,71,84,134,27,0,57,72,306
41,Austin Carr\carrau01,SG,31,CLE,77,,1595,390,839,.465,2,6,.333,388,833,.466,.466,127,172,.738,81,84,165,150,39,3,108,120,909
42,Kenny Carr\carrke01,PF,24,TOT,79,,1838,378,768,.492,0,4,.000,378,764,.495,.492,173,263,.658,199,389,588,77,66,52,154,246,929
43,M.L. Carr\carrml01,SF,29,BOS,82,7,1994,362,763,.474,12,41,.293,350,722,.485,.482,178,241,.739,106,224,330,156,120,36,143,214,914
44,Bob Carrington\carribo01,SG,26,SDC,10,,134,15,37,.405,0,2,.000,15,35,.429,.405,6,8,.750,6,7,13,3,4,1,5,18,36
45,Ron Carter\cartero01,SG,23,IND,13,,117,15,37,.405,0,0,,15,37,.405,.405,2,7,.286,5,14,19,9,2,3,10,19,32
46,Bill Cartwright\cartwbi01,C,22,NYK,82,,3150,665,1215,.547,0,0,,665,1215,.547,.547,451,566,.797,194,532,726,165,48,101,222,279,1781
47,Harvey Catchings\catchha01,C,28,MIL,72,,1366,97,244,.398,0,1,.000,97,243,.399,.398,39,62,.629,164,246,410,82,23,162,68,191,233
48,Don Chaney\chanedo01,SG,33,BOS,60,0,523,67,189,.354,1,6,.167,66,183,.361,.357,32,42,.762,31,42,73,38,31,11,33,80,167
49,Maurice Cheeks*\cheekma01,PG,23,PHI,79,,2623,357,661,.540,4,9,.444,353,652,.541,.543,180,231,.779,75,199,274,556,183,32,216,197,898
50,Phil Chenier\cheniph01,SG,29,TOT,43,,850,136,349,.390,5,12,.417,131,337,.389,.397,49,67,.731,19,59,78,89,33,15,55,55,326
51,Jim Chones\choneji01,C,30,LAL,82,,2394,372,760,.489,0,2,.000,372,758,.491,.489,125,169,.740,143,421,564,151,56,65,175,271,869
52,Jim Cleamons\cleamji01,PG,30,TOT,79,,1789,214,450,.476,7,31,.226,207,419,.494,.483,84,113,.743,53,99,152,288,57,11,109,133,519
53,Doug Collins\collido01,SG,28,PHI,36,,963,191,410,.466,0,1,.000,191,409,.467,.466,113,124,.911,29,65,94,100,30,7,82,76,495
54,Jeff Cook\cookje01,PF,23,PHO,66,,904,129,275,.469,0,3,.000,129,272,.474,.469,104,129,.806,90,151,241,84,28,18,71,102,362
55,Michael Cooper\coopemi01,SG,23,LAL,82,,1973,303,578,.524,5,20,.250,298,558,.534,.529,111,143,.776,101,128,229,221,86,38,142,215,722
56,Wayne Cooper\coopewa01,PF,23,GSW,79,,1781,367,750,.489,1,4,.250,366,746,.491,.490,136,181,.751,202,305,507,42,20,79,140,246,871
57,Hollis Copeland\copelho01,SF,24,NYK,75,,1142,182,368,.495,0,2,.000,182,366,.497,.495,63,86,.733,70,86,156,80,61,25,84,154,427
58,Dave Corzine\corzida01,C,23,WSB,78,,826,90,216,.417,0,0,,90,216,.417,.417,45,68,.662,104,166,270,63,9,31,60,120,225
59,John Coughran\coughjo01,SF,28,GSW,24,,160,29,81,.358,2,9,.222,27,72,.375,.370,8,14,.571,2,17,19,12,7,1,13,24,68
60,Dave Cowens*\cowenda01,C,31,BOS,66,55,2159,422,932,.453,1,12,.083,421,920,.458,.453,95,122,.779,126,408,534,206,69,61,108,216,940
61,Charlie Criss\crissch01,PG,31,ATL,81,,1794,249,578,.431,1,17,.059,248,561,.442,.432,172,212,.811,27,89,116,246,74,4,130,133,671
62,Terry Crosby\crosbte01,PG,23,KCK,4,,28,2,4,.500,0,0,,2,4,.500,.500,2,2,1.000,0,1,1,7,0,0,5,4,6
63,Pat Cummings\cummipa01,C,23,MIL,71,,900,187,370,.505,0,0,,187,370,.505,.505,94,123,.764,81,157,238,53,22,17,74,141,468
64,Bob Dandridge\dandrbo01,SF,32,WSB,45,,1457,329,729,.451,2,11,.182,327,718,.455,.453,123,152,.809,63,183,246,178,29,36,123,112,783
65,Adrian Dantley*\dantlad01,SF,23,UTA,68,,2674,730,1267,.576,0,2,.000,730,1265,.577,.576,443,526,.842,183,333,516,191,96,14,233,211,1903
66,Brad Davis\davisbr01,PG,24,TOT,18,,268,35,63,.556,0,1,.000,35,62,.565,.556,13,16,.813,4,13,17,50,13,1,14,28,83
67,Harry Davis\davisha01,SF,24,SAS,4,,30,6,12,.500,0,0,,6,12,.500,.500,1,2,.500,2,4,6,0,1,0,3,8,13
68,Johnny Davis\davisjo01,PG,24,IND,82,,2912,496,1159,.428,4,42,.095,492,1117,.440,.430,304,352,.864,102,124,226,440,110,23,202,178,1300
69,Walter Davis\daviswa03,SF,25,PHO,75,,2309,657,1166,.563,0,4,.000,657,1162,.565,.563,299,365,.819,75,197,272,337,114,19,242,202,1613
70,Darryl Dawkins\dawkida01,C,23,PHI,80,,2541,494,946,.522,0,6,.000,494,940,.526,.522,190,291,.653,197,496,693,149,49,142,230,328,1178
71,Paul Dawkins\dawkipa01,SF,22,UTA,57,,776,141,300,.470,1,5,.200,140,295,.475,.472,33,48,.688,42,83,125,77,33,9,76,112,316
72,Greg Deane\deanegr01,SG,22,UTA,7,,48,2,11,.182,1,1,1.000,1,10,.100,.227,5,7,.714,2,4,6,6,0,0,3,3,10
73,Larry Demic\demicla01,PF,22,NYK,82,,1872,230,528,.436,0,0,,230,528,.436,.436,110,183,.601,195,288,483,64,56,30,168,306,570
74,Coby Dietrick\dietrco01,C,31,CHI,79,,1830,227,500,.454,1,9,.111,226,491,.460,.455,90,118,.763,101,262,363,216,89,51,112,230,545
75,Leon Douglas\douglle01,C,25,DET,70,,1782,221,455,.486,0,1,.000,221,454,.487,.486,125,185,.676,171,330,501,121,30,62,127,249,567
76,John Drew\drewjo01,SF,25,ATL,80,,2306,535,1182,.453,0,7,.000,535,1175,.455,.453,489,646,.757,203,268,471,101,91,23,240,313,1559
77,Terry Duerod\duerote01,SG,23,DET,67,,1331,282,598,.472,15,53,.283,267,545,.490,.484,45,66,.682,29,69,98,117,41,11,79,102,624
78,Mike Dunleavy\dunlemi01,PG,25,HOU,51,,1036,148,319,.464,3,20,.150,145,299,.485,.469,111,134,.828,26,74,100,210,40,4,110,120,410
79,T.R. Dunn\dunntr01,SG,24,POR,82,,1841,240,551,.436,0,3,.000,240,548,.438,.436,84,111,.757,132,192,324,147,102,31,91,145,564
80,James Edwards\edwarja01,C,24,IND,82,,2314,528,1032,.512,0,1,.000,528,1031,.512,.512,231,339,.681,179,399,578,127,55,104,131,324,1287
81,Bob Elliott\elliobo01,PF,24,NJN,54,,722,101,228,.443,1,4,.250,100,224,.446,.445,104,152,.684,67,118,185,53,29,14,88,97,307
82,Bo Ellis\ellisbo02,PF,25,DEN,48,,502,61,136,.449,0,3,.000,61,133,.459,.449,40,53,.755,51,65,116,30,10,24,24,67,162
83,Len Elmore\elmorle01,C,27,KCK,58,,915,104,242,.430,0,0,,104,242,.430,.430,51,74,.689,74,183,257,64,41,39,67,154,259
84,Alex English*\englial01,SF,26,TOT,78,,2401,553,1113,.497,2,6,.333,551,1107,.498,.498,210,266,.789,269,336,605,224,73,62,214,206,1318
85,Julius Erving*\ervinju01,SF,29,PHI,78,,2812,838,1614,.519,4,20,.200,834,1594,.523,.520,420,534,.787,215,361,576,355,170,140,284,208,2100
86,Earl Evans\evansea01,PF,24,DET,36,,381,63,140,.450,7,18,.389,56,122,.459,.475,24,42,.571,26,49,75,37,14,1,36,64,157
87,Mike Evans\evansmi01,SG,24,SAS,79,,1246,208,464,.448,12,42,.286,196,422,.464,.461,58,85,.682,29,78,107,230,60,9,128,194,486
88,Eric Fernsten\fernser01,PF,26,BOS,56,0,431,71,153,.464,0,0,,71,153,.464,.464,33,52,.635,40,56,96,28,17,12,20,43,175
89,Chris Ford\fordch01,SG,31,BOS,73,73,2115,330,709,.465,70,164,.427,260,545,.477,.515,86,114,.754,77,104,181,215,111,27,105,178,816
90,Don Ford\forddo01,SF,27,TOT,73,,999,131,274,.478,1,3,.333,130,271,.480,.480,45,53,.849,44,141,185,65,22,21,51,131,308
91,Phil Ford\fordph01,PG,23,KCK,82,,2621,489,1058,.462,4,23,.174,485,1035,.469,.464,346,423,.818,29,143,172,610,136,4,282,208,1328
92,Walt Frazier*\fraziwa01,PG,34,CLE,3,,27,4,11,.364,0,1,.000,4,10,.400,.364,2,2,1.000,1,2,3,8,2,1,4,2,10
93,World B. Free\freewo01,SG,26,SDC,68,,2585,737,1556,.474,9,25,.360,728,1531,.476,.477,572,760,.753,129,109,238,283,81,32,228,195,2055
94,Terry Furlow\furlote01,SG,25,TOT,76,,2122,430,926,.464,24,82,.293,406,844,.481,.477,171,196,.872,70,124,194,293,73,23,163,98,1055
95,Mike Gale\galemi01,PG,29,SAS,67,,1474,171,377,.454,2,13,.154,169,364,.464,.456,97,120,.808,34,118,152,312,123,13,115,134,441
96,Gary Garland\garlaga01,PG,22,DEN,78,,1106,155,356,.435,6,19,.316,149,337,.442,.444,18,26,.692,50,88,138,145,54,4,73,80,334
97,Gus Gerard\gerargu01,SF,26,KCK,73,,869,159,348,.457,1,3,.333,158,345,.458,.458,66,100,.660,77,100,177,43,41,26,49,96,385
98,George Gervin*\gervige01,SG,27,SAS,78,,2934,1024,1940,.528,32,102,.314,992,1838,.540,.536,505,593,.852,154,249,403,202,110,79,254,208,2585
99,John Gianelli\gianejo01,C,29,UTA,17,,285,23,66,.348,0,0,,23,66,.348,.348,9,16,.563,14,48,62,17,6,7,22,26,55
100,Artis Gilmore*\gilmoar01,C,30,CHI,48,,1568,305,513,.595,0,0,,305,513,.595,.595,245,344,.712,108,324,432,133,29,59,133,167,855
101,Jack Givens\givenja01,SF,23,ATL,82,,1254,182,473,.385,0,2,.000,182,471,.386,.385,106,128,.828,114,128,242,59,51,19,59,132,470
102,Mike Glenn\glennmi01,SG,24,NYK,75,,800,188,364,.516,2,10,.200,186,354,.525,.519,63,73,.863,21,45,66,85,35,7,38,79,441
103,Glen Gondrezick\gondrgl01,SF,24,DEN,59,,1020,148,286,.517,2,6,.333,146,280,.521,.521,92,121,.760,107,152,259,81,68,16,58,119,390
104,Mike Green\greenmi01,C,28,KCK,21,,459,69,159,.434,0,2,.000,69,157,.439,.434,24,42,.571,35,78,113,28,13,21,36,55,162
105,Dave Greenwood\greenda01,PF,22,CHI,82,,2791,498,1051,.474,1,7,.143,497,1044,.476,.474,337,416,.810,223,550,773,182,60,129,210,313,1334
106,Kevin Grevey\greveke01,SF,26,WSB,65,,1818,331,804,.412,34,92,.370,297,712,.417,.433,216,249,.867,80,107,187,177,56,16,102,158,912
107,Paul Griffin\griffpa01,C,26,SAS,82,,1812,173,313,.553,0,0,,173,313,.553,.553,174,240,.725,154,284,438,250,81,53,131,306,520
108,Bob Gross\grossbo01,SF,26,POR,62,,1581,221,472,.468,1,10,.100,220,462,.476,.469,95,114,.833,84,165,249,228,60,47,166,179,538
109,Ernie Grunfeld\grunfer01,SF,24,KCK,80,,1397,186,420,.443,1,2,.500,185,418,.443,.444,101,131,.771,87,145,232,109,56,9,81,151,474
110,Roy Hamilton\hamilro01,PG,22,DET,72,,1116,115,287,.401,0,2,.000,115,285,.404,.401,103,150,.687,45,62,107,192,48,5,118,82,333
111,James Hardy\hardyja01,PF,23,UTA,76,,1600,184,363,.507,1,2,.500,183,361,.507,.508,51,66,.773,124,275,399,104,47,87,105,207,420
112,Joe Hassett\hassejo01,SG,24,IND,74,,1135,215,509,.422,69,198,.348,146,311,.469,.490,24,29,.828,35,59,94,104,46,8,45,85,523
113,Steve Hawes\hawesst01,PF,29,ATL,82,,1853,304,605,.502,3,8,.375,301,597,.504,.505,150,182,.824,148,348,496,144,74,29,121,205,761
114,Elvin Hayes*\hayesel01,PF,34,WSB,81,,3183,761,1677,.454,3,13,.231,758,1664,.456,.455,334,478,.699,269,627,896,129,62,189,215,309,1859
115,Spencer Haywood*\haywosp01,PF,30,LAL,76,,1544,288,591,.487,1,4,.250,287,587,.489,.488,159,206,.772,132,214,346,93,35,57,134,197,736
116,Gar Heard\heardga01,PF,31,PHO,82,,1403,171,410,.417,0,2,.000,171,408,.419,.417,64,86,.744,118,262,380,97,84,49,88,177,406
117,Gerald Henderson\hendege01,PG,24,BOS,76,2,1061,191,382,.500,2,6,.333,189,376,.503,.503,89,129,.690,37,46,83,147,45,15,109,96,473
118,Tom Henderson\hendeto01,PG,28,HOU,66,,1551,154,323,.477,0,2,.000,154,321,.480,.477,56,77,.727,34,77,111,274,55,4,102,107,364
119,Johnny High\highjo01,PG,22,PHO,82,,1121,144,323,.446,1,7,.143,143,316,.453,.447,120,178,.674,69,104,173,119,71,15,123,172,409
120,Armond Hill\hillar01,PG,26,ATL,79,,2092,177,431,.411,1,4,.250,176,427,.412,.412,124,146,.849,31,107,138,424,107,8,171,261,479
121,Darnell Hillman\hillmda01,PF,30,GSW,49,,708,82,179,.458,0,0,,82,179,.458,.458,34,68,.500,59,121,180,47,21,24,59,128,198
122,Brad Holland\hollabr01,SG,23,LAL,38,,197,44,104,.423,3,15,.200,41,89,.461,.438,15,16,.938,4,13,17,22,15,1,13,24,106
123,Lionel Hollins\hollili01,SG-PG,26,TOT,47,,1209,212,526,.403,3,20,.150,209,506,.413,.406,101,140,.721,29,60,89,162,76,10,128,103,528
124,Phil Hubbard\hubbaph01,PF,23,DET,64,,1189,210,451,.466,0,2,.000,210,449,.468,.466,165,220,.750,114,206,320,70,48,10,120,202,585
125,Kim Hughes\hugheki01,C,27,DEN,70,,1208,102,202,.505,0,0,,102,202,.505,.505,15,41,.366,125,201,326,74,66,77,50,184,219
126,Geoff Huston\hustoge01,PG,22,NYK,71,,923,94,241,.390,3,17,.176,91,224,.406,.396,28,38,.737,14,44,58,159,39,5,73,83,219
127,Dan Issel*\isselda01,C,31,DEN,82,,2938,715,1416,.505,4,12,.333,711,1404,.506,.506,517,667,.775,236,483,719,198,88,54,163,190,1951
128,Phil Jackson*\jacksph01,PF,34,NJN,16,,194,29,46,.630,0,2,.000,29,44,.659,.630,7,10,.700,12,12,24,12,5,4,9,35,65
129,Abdul Jeelani\jeelaab01,SF,25,POR,77,,1286,288,565,.510,0,6,.000,288,559,.515,.510,161,204,.789,114,156,270,95,40,40,117,155,737
130,Cheese Johnson\johnsch02,SF,22,GSW,9,,53,12,30,.400,0,0,,12,30,.400,.400,3,5,.600,6,8,14,2,1,0,4,11,27
131,Clemon Johnson\johnscl01,C,23,IND,79,,1541,199,396,.503,0,0,,199,396,.503,.503,74,117,.632,145,249,394,115,48,121,78,211,472
132,Dennis Johnson*\johnsde01,SG,25,SEA,81,,2937,574,1361,.422,12,58,.207,562,1303,.431,.426,380,487,.780,173,241,414,332,144,82,227,267,1540
133,Eddie Johnson\johnsed02,SG,24,ATL,79,,2622,590,1212,.487,5,13,.385,585,1199,.488,.489,280,338,.828,95,105,200,370,120,24,189,216,1465
134,George Johnson\johnsge02,C,31,NJN,81,,2119,248,543,.457,0,1,.000,248,542,.458,.457,89,126,.706,192,410,602,173,53,258,199,312,585
135,George Johnson\johnsge03,PF,23,DEN,75,,1938,309,649,.476,2,9,.222,307,640,.480,.478,148,189,.783,190,394,584,157,84,67,148,260,768
136,John Johnson\johnsjo01,SF,32,SEA,81,,2533,377,772,.488,0,0,,377,772,.488,.488,161,201,.801,163,263,426,424,76,35,247,213,915
137,Magic Johnson*\johnsma02,SG,20,LAL,77,,2795,503,949,.530,7,31,.226,496,918,.540,.534,374,462,.810,166,430,596,563,187,41,305,218,1387
138,Marques Johnson\johnsma01,SF,23,MIL,77,,2686,689,1267,.544,2,9,.222,687,1258,.546,.545,291,368,.791,217,349,566,273,100,70,185,173,1671
139,Mickey Johnson\johnsmi01,PF,27,IND,82,,2647,588,1271,.463,5,32,.156,583,1239,.471,.465,385,482,.799,258,423,681,344,153,112,286,291,1566
140,Ollie Johnson\johnsol01,SF,30,CHI,79,,1535,262,527,.497,1,11,.091,261,516,.506,.498,82,93,.882,50,113,163,161,59,24,96,165,607
141,Vinnie Johnson\johnsvi01,SG,23,SEA,38,,325,45,115,.391,0,1,.000,45,114,.395,.391,31,39,.795,19,36,55,54,19,4,42,40,121
142,Bobby Jones\jonesbo01,PF,28,PHI,81,,2125,398,748,.532,0,3,.000,398,745,.534,.532,257,329,.781,152,298,450,146,102,118,146,223,1053
143,Caldwell Jones\jonesca01,C,29,PHI,80,,2771,232,532,.436,0,2,.000,232,530,.438,.436,124,178,.697,219,731,950,164,43,162,218,298,588
144,Dwight Jones\jonesdw01,PF,27,TOT,74,,1448,257,506,.508,0,0,,257,506,.508,.508,146,201,.726,114,254,368,101,28,42,122,207,660
145,Major Jones\jonesma01,PF,26,HOU,82,,1545,188,392,.480,1,3,.333,187,389,.481,.481,61,108,.565,147,234,381,67,50,67,112,186,438
146,Eddie Jordan\jordaed01,PG,25,NJN,82,,2657,437,1017,.430,12,48,.250,425,969,.439,.436,201,258,.779,62,208,270,557,223,27,258,238,1087
147,Jeff Judkins\judkije01,SF,23,BOS,65,0,674,139,276,.504,11,27,.407,128,249,.514,.524,62,76,.816,32,34,66,47,29,5,49,91,351
148,Rich Kelley\kelleri01,C,26,TOT,80,,1839,229,484,.473,0,3,.000,229,481,.476,.473,244,310,.787,200,315,515,178,78,96,198,273,702
149,Greg Kelser\kelsegr01,SF,22,DET,50,,1233,280,593,.472,3,15,.200,277,578,.479,.475,146,203,.719,124,152,276,108,60,34,140,176,709
150,Larry Kenon\kenonla01,PF,27,SAS,78,,2798,647,1333,.485,1,9,.111,646,1324,.488,.486,270,345,.783,258,517,775,231,111,18,232,192,1565
151,Irv Kiffin\kiffiir01,SF,28,SAS,26,,212,32,96,.333,0,0,,32,96,.333,.333,18,25,.720,12,28,40,19,10,2,30,43,82
152,Carl Kilpatrick\kilpaca01,C,23,UTA,2,,6,1,2,.500,0,0,,1,2,.500,.500,1,2,.500,1,3,4,0,0,0,0,1,3
153,Bernard King*\kingbe01,SF,23,UTA,19,,419,71,137,.518,0,0,,71,137,.518,.518,34,63,.540,24,64,88,52,7,4,50,66,176
154,Reggie King\kingre01,PF,22,KCK,82,,2052,257,499,.515,0,1,.000,257,498,.516,.515,159,219,.726,184,382,566,106,69,31,100,230,673
155,Billy Knight\knighbi01,SF,27,IND,75,,1910,385,722,.533,4,15,.267,381,707,.539,.536,212,262,.809,136,225,361,155,82,9,132,96,986
156,Toby Knight\knighto01,SF,24,NYK,81,,2945,669,1265,.529,0,2,.000,669,1263,.530,.529,211,261,.808,201,292,493,150,117,86,163,302,1549
157,Arvid Kramer\kramear01,C,23,DEN,8,,45,7,22,.318,0,0,,7,22,.318,.318,2,2,1.000,6,6,12,3,0,5,5,8,16
158,Joel Kramer\kramejo01,C,24,PHO,54,,711,67,143,.469,0,1,.000,67,142,.472,.469,56,70,.800,49,102,151,75,26,5,51,104,190
159,John Kuester\kuestjo01,PG,24,IND,24,,100,12,34,.353,0,1,.000,12,33,.364,.353,5,7,.714,3,11,14,16,7,1,5,8,29
160,Kevin Kunnert\kunneke01,C,28,POR,18,,302,50,114,.439,0,0,,50,114,.439,.439,26,43,.605,37,75,112,29,7,22,41,59,126
161,Mitch Kupchak\kupchmi01,PF,25,WSB,40,,451,67,160,.419,0,2,.000,67,158,.424,.419,52,75,.693,32,73,105,16,8,8,40,49,186
162,Sam Lacey\laceysa01,C,31,KCK,81,,2412,303,677,.448,0,1,.000,303,676,.448,.448,137,185,.741,172,473,645,460,111,109,211,307,743
163,Tom LaGarde\lagarto01,C,24,SEA,82,,1164,146,306,.477,0,0,,146,306,.477,.477,90,137,.657,127,185,312,91,19,34,97,206,382
164,John Lambert\lambejo01,PF,27,CLE,74,,1324,165,400,.413,0,3,.000,165,397,.416,.413,73,101,.723,138,214,352,56,47,42,64,203,403
165,Mark Landsberger\landsma01,C,24,TOT,77,,1510,249,483,.516,0,0,,249,483,.516,.516,116,222,.523,226,387,613,46,33,22,100,140,614
166,Bob Lanier*\laniebo01,C,31,TOT,63,,2131,466,867,.537,1,6,.167,465,861,.540,.538,277,354,.782,152,400,552,184,74,89,162,200,1210
167,Allen Leavell\leaveal01,PG,22,HOU,77,,2123,330,656,.503,3,19,.158,327,637,.513,.505,180,221,.814,57,127,184,417,127,28,205,197,843
168,Butch Lee\leebu01,PG,23,TOT,14,,55,6,24,.250,0,0,,6,24,.250,.250,6,8,.750,7,4,11,12,1,0,10,2,18
169,Ron Lee\leero01,PG,27,TOT,61,,1167,113,305,.370,22,59,.373,91,246,.370,.407,44,70,.629,40,83,123,241,99,17,101,172,292
170,John Long\longjo01,SG,23,DET,69,,2364,588,1164,.505,1,12,.083,587,1152,.510,.506,160,194,.825,152,185,337,206,129,26,206,221,1337
171,John Lucas\lucasjo01,PG,26,GSW,80,,2763,388,830,.467,12,42,.286,376,788,.477,.475,222,289,.768,61,159,220,602,138,3,184,196,1010
172,Maurice Lucas\lucasma01,PF,27,TOT,63,,1884,371,813,.456,2,9,.222,369,804,.459,.458,179,239,.749,143,394,537,208,42,62,218,223,923
173,Ollie Mack\mackol01,SG,22,TOT,50,,681,98,199,.492,0,5,.000,98,194,.505,.492,38,51,.745,32,39,71,53,24,3,35,50,234
174,Moses Malone*\malonmo01,C,24,HOU,82,,3140,778,1549,.502,0,6,.000,778,1543,.504,.502,563,783,.719,573,617,1190,147,80,107,300,210,2119
175,Steve Malovic\malovst01,PF,23,TOT,39,,445,31,67,.463,0,0,,31,67,.463,.463,18,27,.667,36,50,86,26,8,6,23,51,80
176,Pete Maravich*\maravpe01,SG,32,TOT,43,4,964,244,543,.449,10,15,.667,234,528,.443,.459,91,105,.867,17,61,78,83,24,6,82,79,589
177,Cedric Maxwell\maxwece01,SF,24,BOS,80,80,2744,457,750,.609,0,0,,457,750,.609,.609,436,554,.787,284,420,704,199,76,61,230,266,1350
178,Scott May\maysc01,SF,25,CHI,54,,1298,264,587,.450,0,4,.000,264,583,.453,.450,144,172,.837,78,140,218,104,45,5,77,126,672
179,Bob McAdoo*\mcadobo01,PF,28,DET,58,,2097,492,1025,.480,3,24,.125,489,1001,.489,.481,235,322,.730,100,367,467,200,73,65,238,178,1222
180,Jim McElroy\mcelrji01,PG,26,TOT,67,,1528,228,527,.433,5,21,.238,223,506,.441,.437,132,172,.767,32,67,99,227,46,19,131,123,593
181,George McGinnis*\mcginge01,PF,29,TOT,73,,2208,400,886,.451,2,15,.133,398,871,.457,.453,270,488,.553,222,477,699,333,101,23,281,303,1072
182,Billy McKinney\mckinbi01,PG,24,KCK,76,,1333,206,459,.449,1,10,.100,205,449,.457,.450,107,133,.805,20,66,86,248,58,5,89,87,520
183,Tom McMillen\mcmilto01,C,27,ATL,53,,1071,191,382,.500,0,1,.000,191,381,.501,.500,81,107,.757,70,150,220,62,36,14,64,126,463
184,John Mengelt\mengejo01,SG,30,CHI,36,,387,90,166,.542,0,6,.000,90,160,.563,.542,39,49,.796,3,20,23,38,10,0,36,54,219
185,Joe Meriweather\meriwjo01,PF,26,NYK,65,,1565,252,477,.528,0,1,.000,252,476,.529,.528,78,121,.645,122,228,350,66,37,120,112,239,582
186,Dave Meyers\meyerda01,PF,26,MIL,79,,2204,399,830,.481,1,5,.200,398,825,.482,.481,156,246,.634,140,308,448,225,72,40,182,218,955
187,Mike Mitchell\mitchmi01,SF,24,CLE,82,,2802,775,1482,.523,0,6,.000,775,1476,.525,.523,270,343,.787,206,385,591,93,70,77,172,259,1820
188,Steve Mix\mixst01,SF,32,PHI,81,,1543,363,703,.516,4,10,.400,359,693,.518,.519,207,249,.831,114,176,290,149,67,9,132,114,937
189,Paul Mokeski\mokespa01,C,23,HOU,12,,113,11,33,.333,0,0,,11,33,.333,.333,7,9,.778,14,15,29,2,1,6,10,24,29
190,Sidney Moncrief\moncrsi01,SG,22,MIL,77,,1557,211,451,.468,0,1,.000,211,450,.469,.468,232,292,.795,154,184,338,133,72,16,117,106,654
191,Eric Money\moneyer01,SG-PG,24,TOT,61,,1549,273,546,.500,0,0,,273,546,.500,.500,83,106,.783,31,73,104,254,53,11,155,146,629
192,Earl Monroe*\monroea01,SG,35,NYK,51,,633,161,352,.457,0,0,,161,352,.457,.457,56,64,.875,16,20,36,67,21,3,28,46,378
193,Calvin Murphy*\murphca01,SG,31,HOU,76,,2676,624,1267,.493,1,25,.040,623,1242,.502,.493,271,302,.897,68,82,150,299,143,9,162,269,1520
194,Swen Nater\natersw01,C,30,SDC,81,,2860,443,799,.554,0,2,.000,443,797,.556,.554,196,273,.718,352,864,1216,233,45,37,257,259,1082
195,Calvin Natt\nattca01,SF,23,TOT,78,,2857,622,1298,.479,3,9,.333,619,1289,.480,.480,306,419,.730,239,452,691,169,102,34,198,205,1553
196,Mike Newlin\newlimi01,SG,31,NJN,78,,2510,611,1329,.460,45,152,.296,566,1177,.481,.477,367,415,.884,101,163,264,314,115,4,231,195,1634
197,Norm Nixon\nixonno01,PG,24,LAL,82,,3226,624,1209,.516,1,8,.125,623,1201,.519,.517,197,253,.779,52,177,229,642,147,14,288,241,1446
198,Sylvester Norris\norrisy01,C,22,SAS,17,,189,18,43,.419,0,0,,18,43,.419,.419,4,6,.667,10,33,43,6,3,12,19,41,40
199,Mark Olberding\olberma01,SF,23,SAS,75,,2111,291,609,.478,0,3,.000,291,606,.480,.478,210,264,.795,83,335,418,327,67,22,180,274,792
200,John Olive\olivejo01,SF,24,SDC,1,,15,0,2,.000,0,0,,0,2,.000,.000,0,0,,0,1,1,0,0,0,2,2,0
201,Tom Owens\owensto01,C,30,POR,76,,2337,518,1008,.514,1,2,.500,517,1006,.514,.514,213,283,.753,189,384,573,194,45,53,174,270,1250
202,Robert Parish*\parisro01,C,26,GSW,72,,2119,510,1006,.507,0,1,.000,510,1005,.507,.507,203,284,.715,247,536,783,122,58,115,225,248,1223
203,Sonny Parker\parkeso01,SF,24,GSW,82,,2849,483,988,.489,0,2,.000,483,986,.490,.489,237,302,.785,166,298,464,254,173,32,163,195,1203
204,Billy Paultz\paultbi01,C,31,TOT,84,,2193,327,673,.486,0,1,.000,327,672,.487,.486,109,182,.599,187,399,586,188,69,84,115,213,763
205,Jim Paxson\paxsoji02,SG,22,POR,72,,1270,189,460,.411,1,22,.045,188,438,.429,.412,64,90,.711,25,84,109,144,48,5,93,97,443
206,Wiley Peck\peckwi01,SF,22,SAS,52,,628,73,169,.432,0,2,.000,73,167,.437,.432,34,55,.618,66,117,183,33,17,23,48,100,180
207,Sam Pellom\pellosa01,PF,28,ATL,44,,373,44,108,.407,0,0,,44,108,.407,.407,21,30,.700,28,64,92,18,12,12,18,70,109
208,Roger Phegley\pheglro01,SG,23,TOT,78,,1512,350,733,.477,4,9,.444,346,724,.478,.480,177,203,.872,75,110,185,102,34,7,119,158,881
209,Stan Pietkiewicz\pietkst01,PG,23,SDC,50,,577,91,179,.508,9,36,.250,82,143,.573,.534,37,46,.804,26,19,45,94,25,4,51,52,228
210,Ben Poquette\poquebe01,C,24,UTA,82,,2349,296,566,.523,0,2,.000,296,564,.525,.523,139,167,.832,124,436,560,131,45,162,103,283,731
211,Kevin Porter\porteke01,PG,29,WSB,70,,1494,201,438,.459,0,4,.000,201,434,.463,.459,110,137,.803,25,57,82,457,59,11,164,180,512
212,Clifford Ray\raycl01,C,31,GSW,81,,1683,203,383,.530,0,2,.000,203,381,.533,.530,84,149,.564,122,344,466,183,51,32,155,266,490
213,Marlon Redmond\redmoma01,SG,24,KCK,24,,298,59,138,.428,0,9,.000,59,129,.457,.428,24,34,.706,18,34,52,19,4,9,19,27,142
214,Robert Reid\reidro01,SF,24,HOU,76,,2304,419,861,.487,0,3,.000,419,858,.488,.487,153,208,.736,140,301,441,244,132,57,164,281,991
215,Kevin Restani\restake01,SF,28,SAS,82,,1966,369,727,.508,5,29,.172,364,698,.521,.511,131,161,.814,142,244,386,189,54,12,129,186,874
216,Clint Richardson\richacl01,SG,23,PHI,52,,988,159,348,.457,1,3,.333,158,345,.458,.458,28,45,.622,55,68,123,107,24,15,64,97,347
217,Micheal Ray Richardson\richami01,SG,24,NYK,82,,3060,502,1063,.472,27,110,.245,475,953,.498,.485,223,338,.660,151,388,539,832,265,35,359,260,1254
218,Anthony Roberts\roberan01,SF,24,DEN,23,,486,69,181,.381,0,1,.000,69,180,.383,.381,39,60,.650,54,55,109,20,13,3,28,52,177
219,Rick Robey\robeyri01,C,24,BOS,82,27,1918,379,727,.521,0,1,.000,379,726,.522,.521,184,269,.684,209,321,530,92,53,15,151,244,942
220,Cliff Robinson\robincl01,PF,19,NJN,70,,1661,391,833,.469,1,4,.250,390,829,.470,.470,168,242,.694,174,332,506,98,61,34,137,178,951
221,Jackie Robinson\robinja01,SF,24,DET,7,,51,9,17,.529,0,1,.000,9,16,.563,.529,9,11,.818,3,2,5,0,3,3,2,8,27
222,Truck Robinson\robintr01,PF,28,PHO,82,,2710,545,1064,.512,0,0,,545,1064,.512,.512,325,487,.667,213,557,770,142,58,59,251,262,1415
223,Bill Robinzine\robinbi01,PF,27,KCK,81,,1917,362,723,.501,1,2,.500,361,721,.501,.501,200,274,.730,184,342,526,62,106,23,148,311,925
224,Dave Robisch\robisda01,C,30,CLE,82,,2670,489,940,.520,0,3,.000,489,937,.522,.520,277,329,.842,225,433,658,192,53,53,138,211,1255
225,John Roche\rochejo01,PG,30,DEN,82,,2286,354,741,.478,49,129,.380,305,612,.498,.511,175,202,.866,24,91,115,405,82,12,159,139,932
226,Tree Rollins\rollitr01,C,24,ATL,82,,2123,287,514,.558,0,0,,287,514,.558,.558,157,220,.714,283,491,774,76,54,244,99,322,731
227,Dan Roundfield\roundda01,PF,26,ATL,81,,2588,502,1007,.499,0,4,.000,502,1003,.500,.499,330,465,.710,293,544,837,184,101,139,233,317,1334
228,Campy Russell\russeca02,SF,28,CLE,41,,1331,284,630,.451,1,9,.111,283,621,.456,.452,178,239,.745,76,149,225,173,72,20,148,113,747
229,Alvin Scott\scottal01,SF,24,PHO,79,,1303,127,301,.422,1,3,.333,126,298,.423,.424,95,122,.779,89,139,228,98,47,53,92,101,350
230,Charlie Scott*\scottch01,SG,31,DEN,69,,1860,276,688,.401,2,11,.182,274,677,.405,.403,85,118,.720,51,115,166,250,47,23,163,197,639
231,Lonnie Shelton\sheltlo01,PF,24,SEA,76,,2243,425,802,.530,1,5,.200,424,797,.532,.531,184,241,.763,199,383,582,145,92,79,169,292,1035
232,Purvis Short\shortpu01,SF,22,GSW,62,,1636,461,916,.503,0,6,.000,461,910,.507,.503,134,165,.812,119,197,316,123,63,9,122,186,1056
233,John Shumate\shumajo01,PF,27,TOT,65,,1337,207,392,.528,0,1,.000,207,391,.529,.528,165,216,.764,108,255,363,84,40,45,91,126,579
234,Jack Sikma\sikmaja01,C,24,SEA,82,,2793,470,989,.475,0,1,.000,470,988,.476,.475,235,292,.805,198,710,908,279,68,77,202,232,1175
235,James Silas\silasja01,PG,30,SAS,77,,2293,513,999,.514,0,4,.000,513,995,.516,.514,339,382,.887,45,122,167,347,61,14,192,206,1365
236,Paul Silas\silaspa01,PF,36,SEA,82,,1595,113,299,.378,0,0,,113,299,.378,.378,89,136,.654,204,232,436,66,25,5,83,120,315
237,Ralph Simpson\simpsra01,SG,30,NJN,8,,81,18,47,.383,0,2,.000,18,45,.400,.383,5,10,.500,6,5,11,14,9,0,12,3,41
238,Al Skinner\skinnal01,SG,27,PHI,2,,10,1,2,.500,0,0,,1,2,.500,.500,0,0,,0,0,0,2,0,0,2,1,2
239,Bingo Smith\smithbi02,SF-SG,33,TOT,78,,2123,385,891,.432,23,81,.284,362,810,.447,.445,100,115,.870,94,165,259,100,62,17,81,209,893
240,Phil Smith\smithph01,SG,27,GSW,51,,1552,325,685,.474,7,22,.318,318,663,.480,.480,135,171,.789,28,118,146,187,62,15,121,154,792
241,Randy Smith\smithra01,SG,31,CLE,82,,2677,599,1326,.452,10,53,.189,589,1273,.463,.456,233,283,.823,93,163,256,363,125,7,200,190,1441
242,Robert Smith\smithro01,PG,24,TOT,65,,809,118,269,.439,8,26,.308,110,243,.453,.454,80,92,.870,20,59,79,92,26,4,53,105,324
243,Sam Smith\smithsa02,SF,25,CHI,30,,496,97,230,.422,8,35,.229,89,195,.456,.439,57,63,.905,22,32,54,42,25,7,33,54,259
244,Willie Smith\smithwi02,PG,26,CLE,62,,1051,121,315,.384,17,71,.239,104,244,.426,.411,40,52,.769,56,65,121,259,75,1,95,110,299
245,Ricky Sobers\soberri01,PG,27,CHI,82,,2673,470,1002,.469,21,68,.309,449,934,.481,.480,200,239,.837,75,167,242,426,136,17,282,294,1161
246,Jim Spanarkel\spanaji01,SG,22,PHI,40,,442,72,153,.471,0,2,.000,72,151,.477,.471,54,65,.831,27,27,54,51,12,6,57,58,198
247,Larry Steele\steella01,SF,30,POR,16,,446,62,146,.425,0,4,.000,62,142,.437,.425,22,27,.815,13,32,45,67,25,1,33,53,146
248,Earl Tatum\tatumea01,SG,26,CLE,33,,225,36,94,.383,2,6,.333,34,88,.386,.394,11,19,.579,11,15,26,20,16,5,17,29,85
249,Brian Taylor\taylobr01,PG,28,SDC,78,,2754,418,895,.467,90,239,.377,328,656,.500,.517,130,162,.802,76,112,188,335,147,25,141,246,1056
250,Reggie Theus\theusre01,SG,22,CHI,82,,3029,566,1172,.483,28,105,.267,538,1067,.504,.495,500,597,.838,143,186,329,515,114,20,348,262,1660
251,David Thompson*\thompda01,SG,25,DEN,39,,1239,289,617,.468,7,19,.368,282,598,.472,.474,254,335,.758,56,118,174,124,39,38,116,106,839
252,Rudy Tomjanovich\tomjaru01,PF,31,HOU,62,,1834,370,778,.476,22,79,.278,348,699,.498,.490,118,147,.803,132,226,358,109,32,10,98,161,880
253,Bernard Toone\toonebe01,PF,23,PHI,23,,124,23,64,.359,1,7,.143,22,57,.386,.367,8,10,.800,12,22,34,12,4,5,16,20,55
254,Raymond Townsend\townsra01,SG,24,GSW,75,,1159,171,421,.406,4,26,.154,167,395,.423,.411,60,84,.714,33,56,89,116,60,4,65,113,406
255,Dave Twardzik\twardda01,PG,29,POR,67,,1594,183,394,.464,4,7,.571,179,387,.463,.470,197,252,.782,52,104,156,273,77,1,131,149,567
256,Terry Tyler\tylerte01,SF,23,DET,82,,2670,430,925,.465,2,12,.167,428,913,.469,.466,143,187,.765,228,399,627,129,107,220,175,237,1005
257,Wes Unseld*\unselwe01,C,33,WSB,82,,2973,327,637,.513,1,2,.500,326,635,.513,.514,139,209,.665,334,760,1094,366,65,61,153,249,794
258,Jan van Breda Kolff\vanbrja01,SF,28,NJN,82,,2399,212,458,.463,7,20,.350,205,438,.468,.471,130,155,.839,103,326,429,247,100,76,158,307,561
259,Andre Wakefield\wakefan01,SG,25,UTA,8,,47,6,15,.400,0,0,,6,15,.400,.400,3,3,1.000,0,4,4,3,1,0,8,13,15
260,Foots Walker\walkefo01,PG,28,CLE,76,,2422,258,568,.454,1,9,.111,257,559,.460,.455,195,243,.802,78,209,287,607,155,12,157,202,712
261,Wally Walker\walkewa01,SF,25,SEA,70,,844,139,274,.507,0,0,,139,274,.507,.507,48,64,.750,64,106,170,53,21,4,50,102,326
262,Bill Walton*\waltobi01,C,27,SDC,14,,337,81,161,.503,0,0,,81,161,.503,.503,32,54,.593,28,98,126,34,8,38,37,37,194
263,Lloyd Walton\waltoll01,PG,26,MIL,76,,1243,110,242,.455,1,3,.333,109,239,.456,.457,49,71,.690,33,58,91,285,43,2,112,68,270
264,Kermit Washington\washike01,PF,28,POR,80,,2657,421,761,.553,0,3,.000,421,758,.555,.553,231,360,.642,325,517,842,167,73,131,170,307,1073
265,Richard Washington\washiri01,PF,24,MIL,75,,1092,197,421,.468,0,0,,197,421,.468,.468,46,76,.605,95,181,276,55,26,48,63,166,440
266,Nick Weatherspoon\weathni01,SF,29,SDC,57,,1124,164,378,.434,0,0,,164,378,.434,.434,63,91,.692,83,125,208,54,34,17,86,136,391
267,Marvin Webster\webstma01,C,27,NYK,20,,298,38,79,.481,0,0,,38,79,.481,.481,12,16,.750,28,52,80,9,3,11,20,39,88
268,Scott Wedman\wedmasc01,SF,27,KCK,68,,2347,569,1112,.512,7,22,.318,562,1090,.516,.515,145,181,.801,114,272,386,145,84,45,112,230,1290
269,Paul Westphal\westppa01,SG,29,PHO,82,,2665,692,1317,.525,26,93,.280,666,1224,.544,.535,382,443,.862,46,141,187,416,119,35,207,162,1792
270,Jo Jo White*\whitejo01,PG,33,GSW,78,,2052,336,706,.476,1,6,.167,335,700,.479,.477,97,114,.851,42,139,181,239,88,13,157,186,770
271,Rudy White\whiteru01,SG,26,HOU,9,,106,13,24,.542,0,0,,13,24,.542,.542,10,13,.769,0,9,9,5,5,0,8,8,36
272,Jerome Whitehead\whiteje01,C,23,TOT,50,,553,58,114,.509,0,0,,58,114,.509,.509,10,35,.286,56,111,167,24,8,17,36,97,126
273,Sidney Wicks\wickssi01,PF,30,SDC,71,,2146,210,496,.423,0,1,.000,210,495,.424,.423,83,152,.546,138,271,409,213,76,52,167,241,503
274,Bob Wilkerson\wilkebo01,SF,25,DEN,75,,2381,430,1030,.417,7,34,.206,423,996,.425,.421,166,222,.748,85,231,316,243,93,27,193,194,1033
275,Jamaal Wilkes*\wilkeja01,SF,26,LAL,82,,3111,726,1358,.535,3,17,.176,723,1341,.539,.536,189,234,.808,176,349,525,250,129,28,157,220,1644
276,Duck Williams\willidu01,PG,23,UTA,77,,1794,232,519,.447,0,12,.000,232,507,.458,.447,42,60,.700,21,85,106,183,100,11,107,166,506
277,Freeman Williams\willifr01,SG,23,SDC,82,,2118,645,1343,.480,42,128,.328,603,1215,.496,.496,194,238,.815,103,89,192,166,72,9,171,145,1526
278,Gus Williams\willigu01,PG,26,SEA,82,,2969,739,1533,.482,7,36,.194,732,1497,.489,.484,331,420,.788,127,148,275,397,200,37,181,160,1816
279,Ray Williams\willira01,PG,25,NYK,82,,2582,687,1384,.496,7,37,.189,680,1347,.505,.499,333,423,.787,149,263,412,512,167,24,256,295,1714
280,Sly Williams\willisl01,SF,22,NYK,57,,556,104,267,.390,0,4,.000,104,263,.395,.390,58,90,.644,65,56,121,36,19,8,49,73,266
281,John Williamson\willijo01,SG,28,TOT,58,,1374,359,817,.439,11,35,.314,348,782,.445,.446,116,138,.841,38,61,99,126,36,19,92,137,845
282,Bill Willoughby\willobi01,SF,22,CLE,78,,1447,219,457,.479,1,9,.111,218,448,.487,.480,96,127,.756,122,207,329,72,32,62,68,189,535
283,Bubba Wilson\wilsobu01,SG,24,GSW,16,,143,7,25,.280,0,0,,7,25,.280,.280,3,6,.500,6,10,16,12,2,0,8,11,17
284,Rick Wilson\wilsori01,SG,23,ATL,5,,59,2,14,.143,0,0,,2,14,.143,.143,4,6,.667,2,1,3,11,4,1,8,3,8
285,Brian Winters\wintebr01,SG,27,MIL,80,,2623,535,1116,.479,38,102,.373,497,1014,.490,.496,184,214,.860,48,175,223,362,101,28,186,208,1292
286,Larry Wright\wrighla01,PG,25,WSB,76,,1286,229,500,.458,4,16,.250,225,484,.465,.462,96,108,.889,40,82,122,222,49,18,108,144,558
287,Tony Zeno\zenoto01,SF,22,IND,8,,59,6,21,.286,0,0,,6,21,.286,.286,2,2,1.000,3,11,14,1,4,3,9,13,14