
Rk,Player,Pos,Age,Tm,G,GS,MP,FG,FGA,FG%,3P,3PA,3P%,2P,2PA,2P%,eFG%,FT,FTA,FT%,ORB,DRB,TRB,AST,STL,BLK,TOV,PF,PTS
1,Kareem Abdul-Jabbar*\abdulka01,C,37,LAL,79,79,2630,723,1207,.599,0,1,.000,723,1206,.600,.599,289,395,.732,162,460,622,249,63,162,197,238,1735
2,Alvan Adams\adamsal01,PF,30,PHO,82,69,2136,476,915,.520,0,0,,476,915,.520,.520,250,283,.883,153,347,500,308,115,48,197,254,1202
3,Mark Aguirre\aguirma01,SF,25,DAL,80,79,2699,794,1569,.506,27,85,.318,767,1484,.517,.515,440,580,.759,188,289,477,249,60,24,253,250,2055
4,Danny Ainge\aingeda01,SG,25,BOS,75,73,2564,419,792,.529,15,56,.268,404,736,.549,.539,118,136,.868,76,192,268,399,122,6,149,228,971
5,Chuck Aleksinas\aleksch01,C,25,GSW,74,4,1114,161,337,.478,0,1,.000,161,336,.479,.478,55,75,.733,87,183,270,36,15,15,72,171,377
6,J.J. Anderson\anderjj01,SF,24,UTA,44,0,457,61,149,.409,0,2,.000,61,147,.415,.409,27,45,.600,29,53,82,21,29,9,32,70,149
7,Ron Anderson\anderro01,SF,26,CLE,36,7,520,84,195,.431,1,2,.500,83,193,.430,.433,41,50,.820,39,49,88,34,9,7,34,40,210
8,John Bagley\baglejo01,PG,24,CLE,81,65,2401,338,693,.488,3,26,.115,335,667,.502,.490,125,167,.749,54,237,291,697,129,5,207,132,804
9,James Bailey\baileja01,PF,27,NYK,74,28,1297,156,349,.447,0,1,.000,156,348,.448,.447,73,108,.676,122,222,344,39,30,50,100,286,385
10,Thurl Bailey\baileth01,PF,23,UTA,80,68,2481,507,1034,.490,1,1,1.000,506,1033,.490,.491,197,234,.842,153,372,525,138,51,105,152,215,1212
11,Greg Ballard\ballagr01,SF,30,WSB,82,77,2664,469,978,.480,14,46,.304,455,932,.488,.487,120,151,.795,150,381,531,208,100,33,106,221,1072
12,Gene Banks\banksge01,SF,25,SAS,82,41,2091,289,493,.586,1,3,.333,288,490,.588,.587,199,257,.774,133,312,445,234,65,13,140,220,778
13,Ken Bannister\bannike01,PF,24,NYK,75,50,1404,209,445,.470,0,0,,209,445,.470,.470,91,192,.474,108,222,330,39,38,40,141,279,509
14,Charles Barkley*\barklch01,PF,21,PHI,82,60,2347,427,783,.545,1,6,.167,426,777,.548,.546,293,400,.733,266,437,703,155,95,80,209,301,1148
15,Kent Benson\bensoke01,C,30,DET,72,35,1401,201,397,.506,0,3,.000,201,394,.510,.506,76,94,.809,103,221,324,93,53,44,68,207,478
16,Larry Bird*\birdla01,SF,28,BOS,80,77,3161,918,1760,.522,56,131,.427,862,1629,.529,.538,403,457,.882,164,678,842,531,129,98,248,208,2295
17,Otis Birdsong\birdsot01,SG,29,NJN,56,45,1842,495,968,.511,4,21,.190,491,947,.518,.513,161,259,.622,60,88,148,232,84,7,117,145,1155
18,Rolando Blackman\blackro01,SG,25,DAL,81,80,2834,625,1230,.508,6,20,.300,619,1210,.512,.511,342,413,.828,107,193,300,289,61,16,162,96,1598
19,Cory Blackwell\blackco01,SF,21,SEA,60,0,551,87,237,.367,0,2,.000,87,235,.370,.367,28,55,.509,42,54,96,26,25,3,44,55,202
20,Sam Bowie\bowiesa01,C,23,POR,76,62,2216,299,557,.537,0,0,,299,557,.537,.537,160,225,.711,207,449,656,215,55,203,172,278,758
21,Dudley Bradley\bradldu01,SG,27,WSB,73,24,1232,142,299,.475,20,64,.313,122,235,.519,.508,54,79,.684,34,100,134,173,96,21,84,152,358
22,Mike Bratz\bratzmi01,PG,29,GSW,56,6,746,106,250,.424,6,26,.231,100,224,.446,.436,69,82,.841,11,47,58,122,47,4,54,76,287
23,Randy Breuer\breuera01,C,24,MIL,78,0,1083,162,317,.511,0,0,,162,317,.511,.511,89,127,.701,92,164,256,40,21,82,63,179,413
24,Ron Brewer\brewero01,SG,29,TOT,20,0,326,62,118,.525,0,2,.000,62,116,.534,.525,23,25,.920,9,12,21,17,6,6,9,23,147
25,Frank Brickowski\brickfr01,C,25,SEA,78,9,1115,150,305,.492,0,4,.000,150,301,.498,.492,85,127,.669,76,184,260,100,34,15,100,171,385
26,Junior Bridgeman\bridgju01,SF,31,LAC,80,15,2042,460,990,.465,14,39,.359,446,951,.469,.472,181,206,.879,55,175,230,171,47,18,116,128,1115
27,Rickey Brown\brownri01,C,26,ATL,69,5,814,78,192,.406,0,0,,78,192,.406,.406,39,68,.574,76,147,223,25,19,22,51,117,195
28,Tony Brown\brownto01,SF,24,IND,82,26,1586,214,465,.460,0,6,.000,214,459,.466,.460,116,171,.678,146,142,288,159,59,12,116,212,544
29,Wallace Bryant\bryanwa01,C,25,DAL,56,35,860,67,148,.453,0,0,,67,148,.453,.453,30,44,.682,74,167,241,84,21,24,46,110,164
30,Quinn Buckner\bucknqu01,PG,30,BOS,75,6,858,74,193,.383,0,1,.000,74,192,.385,.383,32,50,.640,26,61,87,148,63,2,67,142,180
31,Steve Burtt\burttst01,SG,22,GSW,47,0,418,72,188,.383,0,1,.000,72,187,.385,.383,53,77,.688,10,18,28,20,21,4,33,76,197
32,Don Buse\busedo01,PG,34,KCK,65,14,939,82,203,.404,31,87,.356,51,116,.440,.480,23,30,.767,21,40,61,203,38,1,45,75,218
33,Michael Cage\cagemi01,PF,23,LAC,75,41,1610,216,398,.543,0,0,,216,398,.543,.543,101,137,.737,126,266,392,51,41,32,81,164,533
34,Tony Campbell\campbto01,SF,22,DET,56,0,625,130,262,.496,0,1,.000,130,261,.498,.496,56,70,.800,41,48,89,24,28,3,69,107,316
35,Rick Carlisle\carliri01,SG,25,BOS,38,0,179,26,67,.388,0,2,.000,26,65,.400,.388,15,17,.882,8,13,21,25,3,0,19,21,67
36,Antoine Carr\carran01,PF,23,ATL,62,15,1195,198,375,.528,2,6,.333,196,369,.531,.531,101,128,.789,79,153,232,80,29,78,108,219,499
37,Kenny Carr\carrke01,PF,29,POR,48,30,1120,190,363,.523,0,3,.000,190,360,.528,.523,118,164,.720,90,233,323,56,25,17,100,141,498
38,M.L. Carr\carrml01,SF,34,BOS,47,0,397,62,149,.416,9,23,.391,53,126,.421,.446,17,17,1.000,21,22,43,24,21,6,24,44,150
39,Butch Carter\cartebu01,SG,26,NYK,69,11,1279,214,476,.450,11,43,.256,203,433,.469,.461,109,134,.813,36,59,95,167,57,5,109,151,548
40,Howard Carter\carteho01,SG,23,DAL,11,0,66,4,23,.174,0,3,.000,4,20,.200,.174,1,1,1.000,1,2,3,4,1,0,8,4,9
41,Harvey Catchings\catchha01,C,33,LAC,70,14,1049,72,149,.483,0,1,.000,72,148,.486,.483,59,89,.663,89,173,262,14,15,57,55,162,203
42,Ron Cavenall\cavenro01,C,25,NYK,53,2,653,28,86,.326,0,0,,28,86,.326,.326,22,39,.564,53,113,166,19,12,42,45,123,78
43,Tom Chambers\chambto01,PF,25,SEA,81,60,2923,629,1302,.483,6,22,.273,623,1280,.487,.485,475,571,.832,164,415,579,209,70,57,260,312,1739
44,Maurice Cheeks*\cheekma01,PG,28,PHI,78,78,2616,422,741,.570,6,26,.231,416,715,.582,.574,175,199,.879,54,163,217,497,169,24,155,184,1025
45,Carlos Clark\clarkca01,SG,24,BOS,62,3,562,64,152,.421,0,5,.000,64,147,.435,.421,41,53,.774,29,40,69,48,35,2,42,66,169
46,Don Collins\collido02,SG,26,WSB,11,0,91,12,34,.353,0,0,,12,34,.353,.353,8,9,.889,10,9,19,7,7,4,8,5,32
47,Steve Colter\coltest01,PG,22,POR,78,22,1462,216,477,.453,26,74,.351,190,403,.471,.480,98,130,.754,40,110,150,243,75,9,112,142,556
48,Lester Conner\connele01,PG,25,GSW,79,49,2258,246,546,.451,4,20,.200,242,526,.460,.454,144,192,.750,87,159,246,369,161,13,138,136,640
49,Darwin Cook\cookda01,PG,26,NJN,58,9,1063,212,453,.468,2,23,.087,210,430,.488,.470,47,54,.870,21,71,92,160,74,10,75,96,473
50,Jeff Cook\cookje01,PF,28,TOT,72,5,1288,138,279,.495,0,1,.000,138,278,.496,.495,47,64,.734,122,192,314,62,30,23,48,203,323
51,Joe Cooper\coopejo01,C,27,SEA,3,1,45,7,15,.467,0,0,,7,15,.467,.467,3,6,.500,3,6,9,2,2,1,0,7,17
52,Michael Cooper\coopemi01,SG,28,LAL,82,20,2189,276,593,.465,35,123,.285,241,470,.513,.495,115,133,.865,56,199,255,429,93,49,156,208,702
53,Wayne Cooper\coopewa01,C,28,DEN,80,78,2031,404,856,.472,0,2,.000,404,854,.473,.472,161,235,.685,229,402,631,86,28,197,149,304,969
54,Dave Corzine\corzida01,C,28,CHI,82,50,2062,276,568,.486,0,1,.000,276,567,.487,.486,149,200,.745,130,292,422,140,32,64,124,189,701
55,Charlie Criss\crissch01,PG,36,ATL,4,2,115,7,17,.412,0,2,.000,7,15,.467,.412,4,6,.667,2,12,14,22,3,0,11,5,18
56,Pat Cummings\cummipa01,C,28,NYK,63,63,2069,410,797,.514,0,4,.000,410,793,.517,.514,177,227,.780,139,379,518,109,50,17,166,247,997
57,Terry Cummings\cummite01,PF,23,MIL,79,78,2722,759,1532,.495,0,1,.000,759,1531,.496,.495,343,463,.741,244,472,716,228,117,67,190,264,1861
58,Earl Cureton\curetea01,C,27,DET,81,1,1642,207,428,.484,0,3,.000,207,425,.487,.484,82,144,.569,169,250,419,83,56,42,114,216,496
59,Quintin Dailey\dailequ01,SG,24,CHI,79,0,2101,525,1111,.473,7,30,.233,518,1081,.479,.476,205,251,.817,57,151,208,191,71,5,154,192,1262
60,Adrian Dantley*\dantlad01,SF,28,UTA,55,46,1971,512,964,.531,0,0,,512,964,.531,.531,438,545,.804,148,175,323,186,57,8,171,133,1462
61,Brad Davis\davisbr01,PG,29,DAL,82,82,2539,310,614,.505,47,115,.409,263,499,.527,.543,158,178,.888,39,154,193,581,91,10,123,219,825
62,Charles Davis\davisch02,SF,26,TOT,61,2,774,153,356,.430,1,10,.100,152,346,.439,.431,51,62,.823,59,94,153,51,22,5,54,113,358
63,Johnny Davis\davisjo01,PG,29,CLE,76,30,1920,337,791,.426,12,46,.261,325,745,.436,.434,255,300,.850,35,84,119,426,43,4,152,136,941
64,Walter Davis\daviswa03,SG,30,PHO,23,9,570,139,309,.450,3,10,.300,136,299,.455,.455,64,73,.877,6,29,35,98,18,0,50,42,345
65,Darryl Dawkins\dawkida01,C,28,NJN,39,30,972,192,339,.566,0,1,.000,192,338,.568,.566,143,201,.711,55,126,181,45,14,35,93,171,527
66,Darren Daye\dayeda01,SF,24,WSB,80,8,1573,258,504,.512,1,7,.143,257,497,.517,.513,178,249,.715,93,179,272,240,53,19,134,164,695
67,James Donaldson\donalja01,C,27,LAC,82,58,2392,351,551,.637,0,0,,351,551,.637,.637,227,303,.749,168,500,668,48,28,130,206,217,929
68,John Drew\drewjo01,SF,30,UTA,19,16,463,107,260,.412,0,4,.000,107,256,.418,.412,94,122,.770,36,46,82,35,22,2,42,65,308
69,Larry Drew\drewla01,PG,26,KCK,72,66,2373,457,913,.501,7,28,.250,450,885,.508,.504,154,194,.794,39,125,164,484,93,8,179,147,1075
70,Clyde Drexler*\drexlcl01,SG,22,POR,80,43,2555,573,1161,.494,8,37,.216,565,1124,.503,.497,223,294,.759,217,259,476,441,177,68,223,265,1377
71,Mike Dunleavy\dunlemi01,PG,30,MIL,19,19,433,64,135,.474,16,47,.340,48,88,.545,.533,25,29,.862,6,25,31,85,15,3,40,55,169
72,T.R. Dunn\dunntr01,SG,29,DEN,81,81,2290,175,358,.489,0,2,.000,175,356,.492,.489,84,116,.724,169,216,385,153,140,14,65,213,434
73,Devin Durrant\durrade01,SF,24,IND,59,8,756,114,274,.416,0,3,.000,114,271,.421,.416,72,102,.706,49,75,124,80,19,10,77,106,300
74,Mark Eaton\eatonma01,C,28,UTA,82,82,2813,302,673,.449,0,0,,302,673,.449,.449,190,267,.712,207,720,927,124,36,456,206,312,794
75,Jerry Eaves\eavesje01,PG,25,ATL,3,0,37,3,6,.500,0,0,,3,6,.500,.500,5,6,.833,0,0,0,4,0,0,4,6,11
76,Kenton Edelin\edelike01,SF,22,IND,10,1,143,4,13,.308,0,0,,4,13,.308,.308,3,8,.375,8,18,26,10,5,4,3,39,11
77,Franklin Edwards\edwarfr01,PG,25,LAC,16,0,198,36,66,.545,0,0,,36,66,.545,.545,19,24,.792,3,11,14,38,17,0,17,10,91
78,James Edwards\edwarja01,C,29,PHO,70,58,1787,384,766,.501,0,3,.000,384,763,.503,.501,276,370,.746,95,292,387,153,26,52,162,237,1044
79,Craig Ehlo\ehlocr01,SG,23,HOU,45,0,189,34,69,.493,0,3,.000,34,66,.515,.493,19,30,.633,8,17,25,26,11,3,22,26,87
80,Dale Ellis\ellisda01,SF,24,DAL,72,4,1314,274,603,.454,42,109,.385,232,494,.470,.489,77,104,.740,100,138,238,56,46,7,58,131,667
81,Chris Engler\englech01,C,25,TOT,11,0,82,8,20,.400,0,0,,8,20,.400,.400,5,9,.556,12,18,30,0,2,5,2,5,21
82,Alex English*\englial01,SF,31,DEN,81,81,2924,939,1812,.518,1,5,.200,938,1807,.519,.518,383,462,.829,203,255,458,344,101,46,251,259,2262
83,Julius Erving*\ervinju01,SF,34,PHI,78,78,2535,610,1236,.494,3,14,.214,607,1222,.497,.495,338,442,.765,172,242,414,233,135,109,208,199,1561
84,Mike Evans\evansmi01,SG,29,DEN,81,0,1437,323,661,.489,57,157,.363,266,504,.528,.532,113,131,.863,26,93,119,231,65,12,130,174,816
85,Kenny Fields\fieldke01,SF,22,MIL,51,1,535,84,191,.440,0,0,,84,191,.440,.440,27,36,.750,41,43,84,38,9,10,32,84,195
86,Vern Fleming\flemive01,PG,22,IND,80,65,2486,433,922,.470,0,4,.000,433,918,.472,.470,260,339,.767,148,175,323,247,99,8,197,232,1126
87,Sleepy Floyd\floydsl01,SG,24,GSW,82,82,2873,610,1372,.445,42,143,.294,568,1229,.462,.460,336,415,.810,62,140,202,406,134,41,251,226,1598
88,Phil Ford\fordph01,PG,28,HOU,25,1,290,14,47,.298,0,4,.000,14,43,.326,.298,16,18,.889,3,24,27,61,6,1,17,33,44
89,Rod Foster\fostero01,PG,24,PHO,79,1,1318,286,636,.450,41,126,.325,245,510,.480,.482,83,110,.755,27,53,80,186,61,0,117,171,696
90,World B. Free\freewo01,SG,31,CLE,71,50,2249,609,1328,.459,71,193,.368,538,1135,.474,.485,308,411,.749,61,150,211,320,75,16,139,163,1597
91,Bill Garnett\garnebi02,PF,24,IND,65,13,1123,149,310,.481,0,2,.000,149,308,.484,.481,120,174,.690,98,188,286,67,28,15,92,196,418
92,George Gervin*\gervige01,SG,32,SAS,72,69,2091,600,1182,.508,0,10,.000,600,1172,.512,.508,324,384,.844,79,155,234,178,66,48,198,208,1524
93,Artis Gilmore*\gilmoar01,C,35,SAS,81,81,2756,532,854,.623,0,2,.000,532,852,.624,.623,484,646,.749,231,615,846,131,40,173,241,306,1548
94,Mike Glenn\glennmi01,SG,29,ATL,60,5,1126,228,388,.588,0,2,.000,228,386,.591,.588,62,76,.816,20,61,81,122,27,0,55,74,518
95,Mike Gminski\gminsmi01,C,25,NJN,81,54,2418,380,818,.465,0,1,.000,380,817,.465,.465,276,328,.841,229,404,633,158,38,92,136,135,1036
96,Lancaster Gordon\gordola01,SG,22,LAC,63,1,682,110,287,.383,2,9,.222,108,278,.388,.387,37,49,.755,26,35,61,88,33,6,69,61,259
97,Stewart Granger\grangst01,PG,23,ATL,9,1,92,6,17,.353,0,1,.000,6,16,.375,.353,4,8,.500,1,5,6,12,2,0,12,13,16
98,Butch Graves\gravebu01,SG,23,CLE,4,0,11,2,6,.333,0,1,.000,2,5,.400,.333,1,5,.200,0,2,2,1,1,0,1,4,5
99,Stuart Gray\grayst01,C,21,IND,52,0,391,35,92,.380,0,0,,35,92,.380,.380,32,47,.681,29,94,123,15,9,14,51,82,102
100,Rickey Green\greenri01,PG,30,UTA,77,77,2431,381,798,.477,6,20,.300,375,778,.482,.481,232,267,.869,37,152,189,597,132,3,177,131,1000
101,Sidney Green\greensi02,PF,24,CHI,48,1,740,108,250,.432,0,4,.000,108,246,.439,.432,79,98,.806,72,174,246,29,11,14,68,102,295
102,Dave Greenwood\greenda01,PF,27,CHI,61,28,1523,152,332,.458,0,1,.000,152,331,.459,.458,67,94,.713,108,280,388,78,34,18,63,190,371
103,Kevin Grevey\greveke01,SF,31,MIL,78,6,1182,190,424,.448,8,33,.242,182,391,.465,.458,88,107,.822,27,76,103,94,30,2,55,85,476
104,Darrell Griffith\griffda01,SG,26,UTA,78,78,2776,728,1593,.457,92,257,.358,636,1336,.476,.486,216,298,.725,124,220,344,243,133,30,247,178,1764
105,Ernie Grunfeld\grunfer01,SF,29,NYK,69,0,1061,188,384,.490,2,8,.250,186,376,.495,.492,77,104,.740,41,110,151,105,50,7,40,129,455
106,Bob Hansen\hansebo01,SG,24,UTA,54,4,646,110,225,.489,1,7,.143,109,218,.500,.491,40,72,.556,20,50,70,75,25,1,49,88,261
107,Bill Hanzlik\hanzlbi01,SF,27,DEN,80,1,1673,220,522,.421,1,15,.067,219,507,.432,.422,180,238,.756,88,119,207,210,84,26,115,291,621
108,Derek Harper\harpede01,PG,23,DAL,82,1,2218,329,633,.520,21,61,.344,308,572,.538,.536,111,154,.721,47,152,199,360,144,37,123,194,790
109,Scott Hastings\hastisc01,PF,24,ATL,64,1,825,89,188,.473,0,0,,89,188,.473,.473,63,81,.778,59,100,159,46,24,23,50,135,241
110,Steve Hayes\hayesst01,C,29,PHI,11,0,101,10,18,.556,0,0,,10,18,.556,.556,2,4,.500,11,23,34,1,1,4,2,19,22
111,Gerald Henderson\hendege01,PG,29,SEA,79,78,2648,427,891,.479,9,38,.237,418,853,.490,.484,199,255,.780,71,119,190,559,140,9,231,196,1062
112,Rod Higgins\higgiro01,SF,25,CHI,68,5,942,119,270,.441,10,37,.270,109,233,.468,.459,60,90,.667,55,92,147,73,21,13,49,91,308
113,Roy Hinson\hinsoro01,PF,23,CLE,76,75,2344,465,925,.503,0,3,.000,465,922,.504,.503,271,376,.721,186,410,596,68,51,173,171,311,1201
114,Craig Hodges\hodgecr01,SG,24,MIL,82,63,2496,359,732,.490,47,135,.348,312,597,.523,.523,106,130,.815,74,112,186,349,96,1,135,262,871
115,Lionel Hollins\hollili01,PG,31,HOU,80,60,1950,249,540,.461,3,13,.231,246,527,.467,.464,108,136,.794,33,140,173,417,78,10,170,187,609
116,Mike Holton\holtomi01,SG,23,PHO,74,59,1761,257,576,.446,14,45,.311,243,531,.458,.458,96,118,.814,30,102,132,198,59,6,123,141,624
117,Phil Hubbard\hubbaph01,SF,28,CLE,76,55,2249,415,822,.505,0,4,.000,415,818,.507,.505,371,494,.751,214,265,479,114,81,9,178,258,1201
118,Jay Humphries\humphja01,SG,22,PHO,80,39,2062,279,626,.446,4,20,.200,275,606,.454,.449,141,170,.829,32,132,164,350,107,8,167,209,703
119,Geoff Huston\hustoge01,PG,27,CLE,8,0,93,12,25,.480,0,0,,12,25,.480,.480,2,3,.667,0,1,1,23,0,0,8,8,26
120,Marc Iavaroni\iavarma01,PF,28,TOT,69,43,1334,162,354,.458,0,4,.000,162,350,.463,.458,87,128,.680,95,209,304,119,35,35,119,217,411
121,Dan Issel*\isselda01,C,36,DEN,77,9,1684,363,791,.459,1,7,.143,362,784,.462,.460,257,319,.806,80,251,331,137,65,31,93,171,984
122,Ralph Jackson\jacksra01,PG,22,IND,1,0,12,1,3,.333,0,0,,1,3,.333,.333,0,0,,1,0,1,4,2,0,1,1,2
123,Clemon Johnson\johnscl01,C,28,PHI,58,0,875,117,235,.498,0,1,.000,117,234,.500,.498,36,49,.735,92,129,221,33,15,44,43,112,270
124,Dennis Johnson*\johnsde01,PG,30,BOS,80,77,2976,493,1066,.462,7,26,.269,486,1040,.467,.466,261,306,.853,91,226,317,543,96,39,212,224,1254
125,Eddie Johnson\johnsed02,SG,29,ATL,73,66,2367,453,946,.479,22,72,.306,431,874,.493,.490,265,332,.798,38,154,192,566,43,7,244,184,1193
126,Eddie Johnson\johnsed03,SF,25,KCK,82,81,3029,769,1565,.491,13,54,.241,756,1511,.500,.496,325,373,.871,151,256,407,273,83,22,225,237,1876
127,Frank Johnson\johnsfr01,PG,26,WSB,46,1,925,175,358,.489,6,17,.353,169,341,.496,.497,72,96,.750,23,40,63,143,43,3,59,72,428
128,George Johnson\johnsge02,C,36,NJN,65,0,800,42,79,.532,1,1,1.000,41,78,.526,.538,22,27,.815,74,111,185,22,19,78,39,151,107
129,George Johnson\johnsge03,SF,28,PHI,55,3,756,107,263,.407,1,10,.100,106,253,.419,.409,49,56,.875,48,116,164,38,31,16,49,99,264
130,Magic Johnson*\johnsma02,PG,25,LAL,77,77,2781,504,899,.561,7,37,.189,497,862,.577,.565,391,464,.843,90,386,476,968,113,25,305,155,1406
131,Marques Johnson\johnsma01,SF,28,LAC,72,68,2448,494,1094,.452,3,13,.231,491,1081,.454,.453,190,260,.731,188,240,428,248,72,30,176,193,1181
132,Mickey Johnson\johnsmi01,PF,32,GSW,66,9,1565,304,714,.426,7,30,.233,297,684,.434,.431,260,316,.823,149,247,396,149,70,35,142,221,875
133,Steve Johnson\johnsst03,C,27,CHI,74,54,1659,281,516,.545,0,3,.000,281,513,.548,.545,181,252,.718,146,291,437,64,37,62,151,265,743
134,Vinnie Johnson\johnsvi01,SG,28,DET,82,16,2093,428,942,.454,5,27,.185,423,915,.462,.457,190,247,.769,134,118,252,325,71,20,135,205,1051
135,Bobby Jones\jonesbo01,PF,33,PHI,80,8,1633,207,385,.538,0,4,.000,207,381,.543,.538,186,216,.861,105,192,297,155,84,50,118,183,600
136,Caldwell Jones\jonesca01,C,34,CHI,42,32,885,53,115,.461,0,2,.000,53,113,.469,.461,36,47,.766,49,162,211,34,12,31,40,125,142
137,Charles Jones\jonesch02,C,23,PHO,78,14,1565,236,454,.520,0,4,.000,236,450,.524,.520,182,281,.648,139,255,394,128,45,61,143,149,654
138,Charles Jones\jonesch01,C-PF,27,TOT,31,4,667,67,127,.528,0,0,,67,127,.528,.528,40,58,.690,71,113,184,26,22,79,25,107,174
139,Earl Jones\jonesea01,C,24,LAL,2,0,7,0,1,.000,0,0,,0,1,.000,.000,0,0,,0,0,0,0,0,0,1,0,0
140,Edgar Jones\jonesed01,PF,28,TOT,44,5,769,130,275,.473,0,4,.000,130,271,.480,.473,82,111,.739,50,121,171,29,20,29,61,123,342
141,Major Jones\jonesma01,PF,31,DET,47,0,418,48,87,.552,0,0,,48,87,.552,.552,33,51,.647,48,80,128,15,9,14,35,58,129
142,Ozell Jones\jonesoz01,C,24,SAS,67,6,888,106,180,.589,0,1,.000,106,179,.592,.589,33,83,.398,65,173,238,56,30,57,61,139,245
143,Michael Jordan*\jordami01,SG,21,CHI,82,82,3144,837,1625,.515,9,52,.173,828,1573,.526,.518,630,746,.845,167,367,534,481,196,69,291,285,2313
144,Rich Kelley\kelleri01,C,31,UTA,77,34,1276,103,216,.477,0,2,.000,103,214,.481,.477,84,112,.750,118,232,350,120,42,30,124,227,290
145,Clark Kellogg\kellocl01,PF,23,IND,77,65,2449,562,1112,.505,7,14,.500,555,1098,.505,.509,301,396,.760,224,500,724,244,86,26,231,247,1432
146,Greg Kelser\kelsegr01,SF,27,IND,10,0,114,21,53,.396,0,1,.000,21,52,.404,.396,20,28,.714,6,13,19,13,7,0,12,16,62
147,Jerome Kersey\kerseje01,SF,22,POR,77,0,958,178,372,.478,0,3,.000,178,369,.482,.478,117,181,.646,95,111,206,63,49,29,66,147,473
148,Albert King\kingal01,SF,25,NJN,42,7,860,226,460,.491,0,8,.000,226,452,.500,.491,85,104,.817,70,89,159,58,41,9,65,110,537
149,Bernard King*\kingbe01,SF,28,NYK,55,55,2063,691,1303,.530,1,10,.100,690,1293,.534,.531,426,552,.772,114,203,317,204,71,15,204,191,1809
150,Reggie King\kingre01,SF,27,SEA,60,5,860,63,149,.423,0,0,,63,149,.423,.423,41,59,.695,44,78,122,53,28,11,42,74,167
151,Greg Kite\kitegr01,C,23,BOS,55,4,424,33,88,.375,0,0,,33,88,.375,.375,22,32,.688,38,51,89,17,3,10,29,84,88
152,Billy Knight\knighbi01,SF-SG,32,TOT,68,1,800,156,354,.441,11,25,.440,145,329,.441,.456,64,73,.877,50,68,118,80,16,2,70,62,387
153,Joe Kopicki\kopicjo01,PF,24,DEN,42,0,308,50,95,.526,2,3,.667,48,92,.522,.537,43,54,.796,29,57,86,29,13,1,28,58,145
154,Mitch Kupchak\kupchmi01,PF,30,LAL,58,3,716,123,244,.504,0,0,,123,244,.504,.504,60,91,.659,68,116,184,21,19,20,48,104,306
155,Tom LaGarde\lagarto01,C,29,NJN,1,0,8,0,1,.000,0,0,,0,1,.000,.000,1,2,.500,1,1,2,0,0,0,1,2,1
156,Bill Laimbeer\laimbbi01,C,27,DET,82,82,2892,595,1177,.506,4,18,.222,591,1159,.510,.507,244,306,.797,295,718,1013,154,69,71,129,308,1438
157,Allen Leavell\leaveal01,PG,27,HOU,42,0,536,88,209,.421,8,37,.216,80,172,.465,.440,44,57,.772,8,29,37,102,23,4,51,61,228
158,Ronnie Lester\lestero01,PG,26,LAL,32,1,278,34,82,.415,0,1,.000,34,81,.420,.415,21,31,.677,4,22,26,80,15,3,32,25,89
159,Fat Lever\leverfa01,PG,24,DEN,82,82,2559,424,985,.430,6,24,.250,418,961,.435,.434,197,256,.770,147,264,411,613,202,30,203,226,1051
160,Cliff Levingston\levincl01,PF,24,ATL,74,53,2017,291,552,.527,0,2,.000,291,550,.529,.527,145,222,.653,230,336,566,104,70,69,133,231,727
161,Alton Lister\listeal01,C,26,MIL,81,80,2091,322,598,.538,0,1,.000,322,597,.539,.538,154,262,.588,219,428,647,127,49,167,183,287,798
162,Lewis Lloyd\lloydle01,SG,25,HOU,82,58,2128,457,869,.526,2,8,.250,455,861,.528,.527,161,220,.732,98,133,231,280,73,28,177,196,1077
163,John Long\longjo01,SG,28,DET,66,55,1820,431,885,.487,5,15,.333,426,870,.490,.490,106,123,.862,81,109,190,130,71,14,98,139,973
164,Sidney Lowe\lowesi01,PG,25,TOT,21,0,190,10,27,.370,0,1,.000,10,26,.385,.370,8,8,1.000,4,12,16,50,11,0,13,28,28
165,John Lucas\lucasjo01,PG,31,HOU,47,21,1158,206,446,.462,21,66,.318,185,380,.487,.485,103,129,.798,21,64,85,318,62,2,102,78,536
166,Maurice Lucas\lucasma01,PF,32,PHO,63,22,1670,346,727,.476,0,4,.000,346,723,.479,.476,150,200,.750,138,419,557,145,39,17,151,183,842
167,Kyle Macy\macyky01,PG,27,PHO,65,52,2018,282,582,.485,23,85,.271,259,497,.521,.504,127,140,.907,33,146,179,380,85,3,111,128,714
168,Rick Mahorn\mahorri01,PF,26,WSB,77,63,2072,206,413,.499,0,0,,206,413,.499,.499,71,104,.683,150,458,608,121,59,104,133,308,483
169,Jeff Malone\malonje01,SG,23,WSB,76,61,2613,605,1213,.499,15,72,.208,590,1141,.517,.505,211,250,.844,60,146,206,184,52,9,107,176,1436
170,Moses Malone*\malonmo01,C,29,PHI,79,79,2957,602,1284,.469,0,2,.000,602,1282,.470,.469,737,904,.815,385,646,1031,130,67,123,286,216,1941
171,Pace Mannion\mannipa01,SF,24,UTA,34,0,190,27,63,.429,0,1,.000,27,62,.435,.429,16,23,.696,12,11,23,27,16,3,18,17,70
172,Wes Matthews\matthwe01,PG,25,CHI,78,38,1523,191,386,.495,2,16,.125,189,370,.511,.497,59,85,.694,16,51,67,354,73,12,124,133,443
173,Cedric Maxwell\maxwece01,SF,29,BOS,57,51,1495,201,377,.533,0,2,.000,201,375,.536,.533,231,278,.831,98,144,242,102,36,15,98,140,633
174,Bob McAdoo*\mcadobo01,C,33,LAL,66,0,1254,284,546,.520,0,1,.000,284,545,.521,.520,122,162,.753,79,216,295,67,18,53,95,170,690
175,Tim McCormick\mccorti01,C,22,SEA,78,27,1584,269,483,.557,0,1,.000,269,482,.558,.557,188,263,.715,146,252,398,78,18,33,114,207,726
176,Rodney McCray\mccraro01,SF,23,HOU,82,82,3001,476,890,.535,0,6,.000,476,884,.538,.535,231,313,.738,201,338,539,355,90,75,178,215,1183
177,Scooter McCray\mccrasc01,PF,24,SEA,6,0,93,6,10,.600,0,0,,6,10,.600,.600,3,4,.750,6,11,17,7,1,3,10,13,15
178,Hank McDowell\mcdowha01,PF,25,HOU,34,0,132,20,42,.476,0,1,.000,20,41,.488,.476,7,10,.700,7,15,22,9,3,5,8,22,47
179,Mike McGee\mcgeemi01,SF,25,LAL,76,3,1170,329,612,.538,22,61,.361,307,551,.557,.556,94,160,.588,97,68,165,71,39,7,81,147,774
180,Kevin McHale*\mchalke01,PF,27,BOS,79,31,2653,605,1062,.570,0,6,.000,605,1056,.573,.570,355,467,.760,229,483,712,141,28,120,157,234,1565
181,Kevin McKenna\mckenke01,SG,26,NJN,29,7,535,61,134,.455,5,13,.385,56,121,.463,.474,38,43,.884,20,29,49,58,30,7,32,63,165
182,Tom McMillen\mcmilto01,C,32,WSB,69,21,1547,252,534,.472,0,5,.000,252,529,.476,.472,112,135,.830,64,146,210,52,8,17,44,163,616
183,Mark McNamara\mcnamma01,C,25,TOT,45,0,273,40,76,.526,0,0,,40,76,.526,.526,32,62,.516,31,43,74,6,7,8,19,27,112
184,Joe Meriweather\meriwjo01,C,31,KCK,76,4,1061,121,243,.498,1,2,.500,120,241,.498,.500,96,124,.774,94,169,263,27,17,28,50,181,339
185,Larry Micheaux\michela01,PF,24,TOT,57,0,565,91,157,.580,0,3,.000,91,154,.591,.580,29,43,.674,62,81,143,30,20,21,36,75,211
186,Mike Mitchell\mitchmi01,SF,29,SAS,82,82,2853,775,1558,.497,5,23,.217,770,1535,.502,.499,269,346,.777,145,272,417,151,61,27,144,219,1824
187,Paul Mokeski\mokespa01,C,28,MIL,79,6,1586,205,429,.478,0,2,.000,205,427,.480,.478,81,116,.698,107,303,410,99,28,35,85,266,491
188,Sidney Moncrief\moncrsi01,PG,27,MIL,73,72,2734,561,1162,.483,9,33,.273,552,1129,.489,.487,454,548,.828,149,242,391,382,117,39,184,197,1585
189,Johnny Moore\moorejo01,PG,26,SAS,82,82,2689,416,910,.457,25,89,.281,391,821,.476,.471,189,248,.762,94,284,378,816,229,18,236,247,1046
190,Jay Murphy\murphja01,PF,22,LAC,23,0,149,8,50,.160,0,1,.000,8,49,.163,.160,12,21,.571,6,35,41,4,1,2,8,21,28
191,Larry Nance\nancela01,PF,25,PHO,61,55,2202,515,877,.587,1,2,.500,514,875,.587,.588,180,254,.709,195,341,536,159,88,104,136,185,1211
192,Calvin Natt\nattca01,PF,28,DEN,78,76,2657,685,1255,.546,0,3,.000,685,1252,.547,.546,447,564,.793,209,401,610,238,75,33,190,182,1817
193,Kenny Natt\nattke01,SG,26,TOT,8,0,29,2,6,.333,0,0,,2,6,.333,.333,2,4,.500,2,1,3,3,2,0,3,3,6
194,Ed Nealy\nealyed01,PF,24,KCK,22,0,225,26,44,.591,0,0,,26,44,.591,.591,10,19,.526,15,29,44,18,3,1,12,26,62
195,Chuck Nevitt\nevitch01,C,25,LAL,11,0,59,5,17,.294,0,0,,5,17,.294,.294,2,8,.250,5,15,20,3,0,15,10,20,12
196,Kurt Nimphius\nimphku01,C,26,DAL,82,40,2010,196,434,.452,0,6,.000,196,428,.458,.452,108,140,.771,136,272,408,183,30,126,95,262,500
197,Norm Nixon\nixonno01,PG,29,LAC,81,81,2894,596,1281,.465,33,99,.333,563,1182,.476,.478,170,218,.780,55,163,218,711,95,4,273,175,1395
198,Audie Norris\norriau01,C,24,POR,78,13,1117,133,245,.543,0,3,.000,133,242,.550,.543,135,203,.665,90,160,250,47,42,33,100,221,401
199,Mike O'Koren\okoremi01,SF,26,NJN,43,29,1119,194,393,.494,8,21,.381,186,372,.500,.504,42,67,.627,46,120,166,102,32,16,51,115,438
200,Hakeem Olajuwon*\olajuha01,C,22,HOU,82,82,2914,677,1258,.538,0,0,,677,1258,.538,.538,338,551,.613,440,534,974,111,99,220,234,344,1692
201,Mark Olberding\olberma01,PF,28,KCK,81,62,2277,265,528,.502,0,3,.000,265,525,.505,.502,293,352,.832,139,374,513,243,56,11,185,298,823
202,Jawann Oldham\oldhaja01,C,27,CHI,63,0,993,89,192,.464,0,1,.000,89,191,.466,.464,34,50,.680,79,157,236,31,11,127,58,166,212
203,Louis Orr\orrlo01,PF,26,NYK,79,31,2452,372,766,.486,1,10,.100,371,756,.491,.486,262,334,.784,171,220,391,134,100,27,138,195,1007
204,Robert Parish*\parisro01,C,31,BOS,79,78,2850,551,1016,.542,0,0,,551,1016,.542,.542,292,393,.743,263,577,840,125,56,101,186,223,1394
205,Billy Paultz\paultbi01,C,36,UTA,62,0,370,32,87,.368,0,0,,32,87,.368,.368,18,28,.643,24,72,96,16,6,11,30,51,82
206,Jim Paxson\paxsoji02,SG,27,POR,68,57,2253,508,988,.514,6,39,.154,502,949,.529,.517,196,248,.790,69,153,222,264,101,5,108,115,1218
207,John Paxson\paxsojo01,PG,24,SAS,78,1,1259,196,385,.509,10,34,.294,186,351,.530,.522,84,100,.840,19,49,68,215,45,3,81,117,486
208,Sam Perkins\perkisa01,PF,23,DAL,82,42,2317,347,736,.471,9,36,.250,338,700,.483,.478,200,244,.820,189,416,605,135,63,63,102,236,903
209,Jim Petersen\peterji01,PF,22,HOU,60,0,714,70,144,.486,0,0,,70,144,.486,.486,50,66,.758,44,103,147,29,14,32,71,125,190
210,Ricky Pierce\piercri01,SG,25,MIL,44,3,882,165,307,.537,1,4,.250,164,303,.541,.539,102,124,.823,49,68,117,94,34,5,63,117,433
211,Charles Pittman\pittmch01,SF,26,PHO,68,3,1001,107,227,.471,0,2,.000,107,225,.476,.471,109,146,.747,90,137,227,69,20,21,100,144,323
212,Gary Plummer\plummga01,PF,22,GSW,66,0,702,92,232,.397,1,4,.250,91,228,.399,.399,65,92,.707,54,80,134,26,15,14,50,127,250
213,David Pope\popeda01,SF,22,KCK,22,0,129,17,53,.321,0,1,.000,17,52,.327,.321,7,13,.538,9,9,18,5,3,3,7,30,41
214,Ben Poquette\poquebe01,PF,29,CLE,79,6,1656,210,457,.460,3,17,.176,207,440,.470,.463,109,137,.796,148,325,473,79,47,58,70,220,532
215,Paul Pressey\presspa01,SF,26,MIL,80,80,2876,480,928,.517,7,20,.350,473,908,.521,.521,317,418,.758,149,280,429,543,129,56,247,258,1284
216,Kurt Rambis\rambiku01,PF,26,LAL,82,46,1617,181,327,.554,0,0,,181,327,.554,.554,68,103,.660,164,364,528,69,82,47,97,211,430
217,Kelvin Ransey\ranseke01,PG,26,NJN,81,29,1689,300,654,.459,2,11,.182,298,643,.463,.460,122,142,.859,40,90,130,355,87,7,113,134,724
218,Leo Rautins\rautile01,SF,24,ATL,4,0,12,0,2,.000,0,0,,0,2,.000,.000,0,0,,1,1,2,3,0,0,1,3,0
219,Robert Reid\reidro01,SF,29,HOU,82,0,1763,312,648,.481,1,16,.063,311,632,.492,.482,88,126,.698,81,192,273,171,48,22,101,196,713
220,Clint Richardson\richacl01,SG,28,PHI,74,20,1531,183,404,.453,1,3,.333,182,401,.454,.454,76,89,.854,60,95,155,157,37,15,78,143,443
221,Micheal Ray Richardson\richami01,PG,29,NJN,82,82,3127,690,1470,.469,29,115,.252,661,1355,.488,.479,240,313,.767,156,301,457,669,243,22,249,277,1649
222,Doc Rivers\riverdo01,PG,23,ATL,69,58,2126,334,701,.476,15,36,.417,319,665,.480,.487,291,378,.770,66,148,214,410,163,53,176,250,974
223,Fred Roberts\roberfr01,PF,24,TOT,74,0,1178,208,418,.498,1,1,1.000,207,417,.496,.499,150,182,.824,78,108,186,87,28,22,89,141,567
224,Alvin Robertson\roberal01,SG,22,SAS,79,9,1685,299,600,.498,4,11,.364,295,589,.501,.502,124,169,.734,116,149,265,275,127,24,167,217,726
225,Rick Robey\robeyri01,C,29,PHO,4,0,48,2,9,.222,0,0,,2,9,.222,.222,1,2,.500,3,5,8,5,2,0,8,7,5
226,Cliff Robinson\robincl01,PF,24,WSB,60,37,1870,422,896,.471,1,3,.333,421,893,.471,.472,158,213,.742,141,405,546,149,51,47,161,187,1003
227,Truck Robinson\robintr01,PF,33,NYK,2,1,35,2,5,.400,0,0,,2,5,.400,.400,0,2,.000,6,3,9,3,2,3,5,3,4
228,Tree Rollins\rollitr01,C,29,ATL,70,60,1750,186,339,.549,0,0,,186,339,.549,.549,67,93,.720,113,329,442,52,35,167,80,213,439
229,Lorenzo Romar\romarlo01,PG,26,TOT,9,0,51,3,16,.188,0,3,.000,3,13,.231,.188,5,5,1.000,0,0,0,12,4,0,5,7,11
230,Dan Roundfield\roundda01,PF,31,DET,56,43,1492,236,505,.467,0,2,.000,236,503,.469,.467,139,178,.781,175,278,453,102,26,54,123,147,611
231,Jeff Ruland\rulanje01,C,26,WSB,37,36,1436,250,439,.569,0,2,.000,250,437,.572,.569,200,292,.685,127,283,410,162,31,27,179,128,700
232,Campy Russell\russeca02,SF,33,CLE,3,0,24,2,7,.286,0,1,.000,2,6,.333,.286,2,3,.667,0,5,5,3,0,0,5,3,6
233,Walker Russell\russewa01,PG,24,ATL,21,2,377,34,63,.540,1,1,1.000,33,62,.532,.548,14,17,.824,8,32,40,66,17,4,40,37,83
234,Ralph Sampson*\sampsra01,PF,24,HOU,82,82,3086,753,1499,.502,0,6,.000,753,1493,.504,.502,303,448,.676,227,626,853,224,81,168,326,306,1809
235,Mike Sanders\sandemi01,SF,24,PHO,21,11,418,85,175,.486,0,0,,85,175,.486,.486,45,59,.763,38,51,89,29,23,4,34,59,215
236,Wayne Sappleton\sapplwa01,PF,24,NJN,33,0,298,41,87,.471,0,0,,41,87,.471,.471,14,34,.412,28,47,75,7,7,4,21,50,96
237,Danny Schayes\schayda01,C,25,DEN,56,0,542,60,129,.465,0,0,,60,129,.465,.465,79,97,.814,48,96,144,38,20,25,44,98,199
238,Tom Scheffler\schefto01,C,30,POR,39,0,268,21,51,.412,0,0,,21,51,.412,.412,10,20,.500,18,58,76,11,8,11,15,48,52
239,John Schweitz\schwejo01,SG,24,SEA,19,0,110,25,74,.338,0,4,.000,25,70,.357,.338,7,10,.700,6,15,21,18,0,1,14,12,57
240,Alvin Scott\scottal01,SF,29,PHO,77,18,1238,111,259,.429,1,5,.200,110,254,.433,.431,53,74,.716,46,115,161,127,39,25,60,125,276
241,Byron Scott\scottby01,SG,23,LAL,81,65,2305,541,1003,.539,26,60,.433,515,943,.546,.552,187,228,.820,57,153,210,244,100,17,138,197,1295
242,Tom Sewell\sewelto01,SG,22,WSB,21,0,87,9,36,.250,0,2,.000,9,34,.265,.250,2,4,.500,2,2,4,6,3,1,7,13,20
243,Lonnie Shelton\sheltlo01,PF,29,CLE,57,14,1244,158,363,.435,0,5,.000,158,358,.441,.435,51,77,.662,82,185,267,96,44,18,74,187,367
244,Purvis Short\shortpu01,SF,27,GSW,78,77,3081,819,1780,.460,47,150,.313,772,1630,.474,.473,501,613,.817,157,241,398,234,116,27,241,255,2186
245,Jerry Sichting\sichtje01,PG,28,IND,70,25,1808,325,624,.521,9,37,.243,316,587,.538,.528,112,128,.875,24,90,114,264,47,4,102,116,771
246,Jack Sikma\sikmaja01,C,29,SEA,68,68,2402,461,943,.489,2,10,.200,459,933,.492,.490,335,393,.852,164,559,723,285,83,91,160,239,1259
247,Charlie Sitton\sittoch01,SF,22,DAL,43,0,304,39,94,.415,0,2,.000,39,92,.424,.415,13,25,.520,24,36,60,26,7,6,19,50,91
248,Tom Sluby\slubyto01,SG,22,DAL,31,0,151,30,58,.517,0,2,.000,30,56,.536,.517,13,21,.619,5,7,12,16,3,0,11,18,73
249,Derek Smith\smithde02,SG,23,LAC,80,80,2762,682,1271,.537,3,19,.158,679,1252,.542,.538,400,504,.794,174,253,427,216,77,52,230,317,1767
250,Larry Smith\smithla01,PF,27,GSW,80,78,2497,366,690,.530,0,0,,366,690,.530,.530,155,256,.605,405,464,869,96,78,54,160,285,887
251,Robert Smith\smithro01,PG,29,CLE,7,0,48,4,17,.235,0,4,.000,4,13,.308,.235,8,10,.800,0,4,4,7,2,0,3,6,16
252,Ricky Sobers\soberri01,SG,32,SEA,71,12,1490,280,628,.446,8,28,.286,272,600,.453,.452,132,162,.815,27,76,103,252,49,9,158,156,700
253,Rory Sparrow\sparrro01,PG,26,NYK,79,41,2292,326,662,.492,7,31,.226,319,631,.506,.498,122,141,.865,38,131,169,557,81,9,150,200,781
254,Larry Spriggs\sprigla01,PF,25,LAL,75,32,1292,194,354,.548,0,3,.000,194,351,.553,.548,112,146,.767,77,150,227,132,47,13,115,195,500
255,Terence Stansbury\stanste01,SG,23,IND,74,14,1278,210,458,.459,4,25,.160,206,433,.476,.463,102,126,.810,39,75,114,127,47,12,80,205,526
256,Brook Steppe\steppbr01,SG,25,DET,54,0,486,83,178,.466,0,1,.000,83,177,.469,.466,87,104,.837,25,32,57,36,16,4,43,61,253
257,Steve Stipanovich\stipast01,C,24,IND,82,66,2315,414,871,.475,1,11,.091,413,860,.480,.476,297,372,.798,141,473,614,199,71,78,184,265,1126
258,John Stockton*\stockjo01,PG,22,UTA,82,5,1490,157,333,.471,2,11,.182,155,322,.481,.474,142,193,.736,26,79,105,415,109,11,150,203,458
259,Jon Sundvold\sundvjo01,PG,23,SEA,73,1,1150,170,400,.425,12,38,.316,158,362,.436,.440,48,59,.814,17,53,70,206,36,1,85,87,400
260,Dane Suttle\suttlda01,SG,23,KCK,6,0,24,6,13,.462,0,1,.000,6,12,.500,.462,2,2,1.000,0,3,3,2,1,0,1,3,14
261,Terry Teagle\teaglte01,SG,24,TOT,21,3,349,74,137,.540,2,4,.500,72,133,.541,.547,25,35,.714,22,21,43,14,13,5,15,36,175
262,Reggie Theus\theusre01,SG,27,KCK,82,80,2543,501,1029,.487,5,38,.132,496,991,.501,.489,334,387,.863,106,164,270,656,95,18,307,250,1341
263,Peter Thibeaux\thibepe01,SF,23,GSW,51,1,461,94,195,.482,0,2,.000,94,193,.487,.482,43,67,.642,29,40,69,17,11,17,34,85,231
264,David Thirdkill\thirdda01,SF,24,TOT,18,3,183,20,38,.526,0,1,.000,20,37,.541,.526,11,19,.579,10,7,17,4,5,3,14,22,51
265,Isiah Thomas*\thomais01,PG,23,DET,81,81,3089,646,1410,.458,29,113,.257,617,1297,.476,.468,399,493,.809,114,247,361,1123,187,25,302,288,1720
266,Jim Thomas\thomaji01,SG,24,IND,80,52,2059,347,726,.478,8,42,.190,339,684,.496,.483,183,234,.782,74,187,261,234,76,5,131,195,885
267,Bernard Thompson\thompbe01,SF,22,POR,59,0,535,79,212,.373,0,8,.000,79,204,.387,.373,39,51,.765,37,39,76,52,31,10,35,79,197
268,LaSalle Thompson\thompla01,C,23,KCK,82,77,2458,369,695,.531,0,0,,369,695,.531,.531,227,315,.721,274,580,854,130,98,128,202,328,965
269,Mychal Thompson\thompmy01,PF,30,POR,79,55,2616,572,1111,.515,0,0,,572,1111,.515,.515,307,449,.684,211,407,618,205,78,104,231,216,1451
270,Paul Thompson\thomppa01,SF,23,TOT,49,27,942,189,459,.412,6,30,.200,183,429,.427,.418,69,87,.793,57,101,158,78,56,25,57,119,453
271,Otis Thorpe\thorpot01,PF,22,KCK,82,23,1918,411,685,.600,0,2,.000,411,683,.602,.600,230,371,.620,187,369,556,111,34,37,187,256,1052
272,Sedale Threatt\threase01,PG,23,PHI,82,0,1304,188,416,.452,4,22,.182,184,394,.467,.457,66,90,.733,21,78,99,175,80,16,99,171,446
273,Andrew Toney\toneyan01,SG,27,PHI,70,65,2237,450,914,.492,39,105,.371,411,809,.508,.514,306,355,.862,35,142,177,363,65,24,224,211,1245
274,Linton Townes\towneli01,SF,25,SAS,1,0,8,0,6,.000,0,0,,0,6,.000,.000,2,2,1.000,1,0,1,0,0,0,0,1,2
275,Kelly Tripucka\tripuke01,SF,25,DET,55,43,1675,396,831,.477,2,5,.400,394,826,.477,.478,255,288,.885,66,152,218,135,49,14,118,118,1049
276,Trent Tucker\tucketr01,SG,25,NYK,77,46,1819,293,606,.483,29,72,.403,264,534,.494,.507,38,48,.792,74,114,188,199,75,15,64,195,653
277,Elston Turner\turneel01,SF,25,DEN,81,2,1491,181,388,.466,1,6,.167,180,382,.471,.468,51,65,.785,88,128,216,158,96,7,70,152,414
278,Jeff Turner\turneje01,PF,22,NJN,72,36,1429,171,377,.454,0,3,.000,171,374,.457,.454,79,92,.859,88,130,218,108,29,7,90,243,421
279,Melvin Turpin\turpime01,C,24,CLE,79,45,1949,363,711,.511,0,0,,363,711,.511,.511,109,139,.784,155,297,452,36,38,87,118,211,835
280,Terry Tyler\tylerte01,SF,28,DET,82,53,2004,422,855,.494,0,8,.000,422,847,.498,.494,106,148,.716,148,275,423,63,49,90,76,192,950
281,Darnell Valentine\valenda01,PG,25,POR,75,59,2278,321,679,.473,0,2,.000,321,677,.474,.473,230,290,.793,54,165,219,522,143,5,194,189,872
282,Kiki Vandeweghe\vandeki01,SF,26,POR,72,69,2502,618,1158,.534,11,33,.333,607,1125,.540,.538,369,412,.896,74,154,228,106,37,22,116,116,1616
283,Pete Verhoeven\verhope01,PF,25,KCK,54,0,366,51,108,.472,0,0,,51,108,.472,.472,21,25,.840,28,35,63,17,15,7,20,85,123
284,Jay Vincent\vinceja01,PF,25,DAL,79,47,2543,545,1138,.479,0,4,.000,545,1134,.481,.479,351,420,.836,185,519,704,169,48,22,170,226,1441
285,Danny Vranes\vraneda01,SF,26,SEA,76,70,2163,186,402,.463,1,4,.250,185,398,.465,.464,67,127,.528,154,282,436,152,76,57,119,256,440
286,Granville Waiters\waitegr01,C,24,IND,62,5,703,85,190,.447,0,1,.000,85,189,.450,.447,29,50,.580,57,113,170,30,16,44,55,107,199
287,Darrell Walker\walkeda01,PG,23,NYK,82,66,2489,430,989,.435,0,17,.000,430,972,.442,.435,243,347,.700,128,150,278,408,167,21,204,244,1103
288,Bill Walton*\waltobi01,C,32,LAC,67,37,1647,269,516,.521,0,2,.000,269,514,.523,.521,138,203,.680,168,432,600,156,50,140,174,184,676
289,Bryan Warrick\warribr01,PG,25,LAC,58,1,713,85,173,.491,1,4,.250,84,169,.497,.494,44,57,.772,10,48,58,153,23,6,70,85,215
290,Scott Wedman\wedmasc01,SF,32,BOS,78,5,1127,220,460,.478,17,34,.500,203,426,.477,.497,42,55,.764,57,102,159,94,23,10,47,111,499
291,Mark West\westma01,C,24,TOT,66,25,888,106,194,.546,0,1,.000,106,193,.549,.546,43,87,.494,90,161,251,15,13,49,59,197,255
292,Ennis Whatley\whatlen01,PG,22,CHI,70,44,1385,140,313,.447,1,9,.111,139,304,.457,.449,68,86,.791,34,67,101,381,66,10,144,141,349
293,Rory White\whitero01,PF,25,LAC,80,14,1106,144,279,.516,0,0,,144,279,.516,.516,90,130,.692,94,101,195,34,35,20,87,115,378
294,Willie White\whitewi01,SG,22,DEN,39,0,234,52,124,.419,4,11,.364,48,113,.425,.435,21,31,.677,15,21,36,29,5,2,30,24,129
295,Jerome Whitehead\whiteje01,C,28,GSW,79,78,2536,421,825,.510,0,0,,421,825,.510,.510,184,235,.783,219,403,622,53,45,43,141,322,1026
296,Mitchell Wiggins\wiggimi01,SG,25,HOU,82,24,1575,318,657,.484,6,23,.261,312,634,.492,.489,96,131,.733,110,125,235,119,83,13,90,195,738
297,Jamaal Wilkes*\wilkeja01,SF,31,LAL,42,8,761,148,303,.488,0,1,.000,148,302,.490,.488,51,66,.773,35,59,94,41,19,3,49,65,347
298,Dominique Wilkins*\wilkido01,SF,25,ATL,81,81,3023,853,1891,.451,25,81,.309,828,1810,.457,.458,486,603,.806,226,331,557,200,135,54,225,170,2217
299,Eddie Lee Wilkins\wilkied01,C,22,NYK,54,16,917,116,233,.498,0,2,.000,116,231,.502,.498,66,122,.541,86,176,262,16,21,16,64,155,298
300,Jeff Wilkins\wilkije01,C,29,UTA,79,0,1505,285,582,.490,0,1,.000,285,581,.491,.490,61,80,.763,78,288,366,81,35,18,91,173,631
301,Dale Wilkinson\wilkida01,SF-PF,24,TOT,12,0,45,4,16,.250,0,1,.000,4,15,.267,.250,6,7,.857,1,3,4,2,0,0,4,10,14
302,Buck Williams\willibu01,PF,24,NJN,82,82,3182,577,1089,.530,1,4,.250,576,1085,.531,.530,336,538,.625,323,682,1005,167,63,110,238,293,1491
303,Gus Williams\willigu01,PG,31,WSB,79,78,2960,638,1483,.430,51,176,.290,587,1307,.449,.447,251,346,.725,72,123,195,608,178,32,213,159,1578
304,Guy Williams\willigu02,SF,24,WSB,21,0,119,29,63,.460,1,4,.250,28,59,.475,.468,2,5,.400,15,12,27,9,5,2,8,17,61
305,Herb Williams\willihe01,C,26,IND,75,70,2557,575,1211,.475,1,9,.111,574,1202,.478,.475,224,341,.657,154,480,634,252,54,134,265,218,1375
306,Kevin Williams\willike01,SG,23,CLE,46,4,413,58,134,.433,0,5,.000,58,129,.450,.433,47,64,.734,19,44,63,61,22,4,49,86,163
307,Ray Williams\willira01,PG,30,BOS,23,5,459,55,143,.385,6,23,.261,49,120,.408,.406,31,46,.674,16,41,57,90,30,5,42,56,147
308,Sam Williams\willisa02,PF,25,PHI,46,8,488,58,148,.392,0,1,.000,58,147,.395,.392,28,47,.596,38,68,106,11,26,26,44,92,144
309,Sly Williams\willisl01,SF,27,ATL,34,20,867,167,380,.439,4,15,.267,163,365,.447,.445,79,123,.642,45,123,168,94,28,8,78,83,417
310,Kevin Willis\willike02,PF,22,ATL,82,19,1785,322,690,.467,2,9,.222,320,681,.470,.468,119,181,.657,177,345,522,36,31,49,104,226,765
311,Michael Wilson\wilsomi01,SG,25,TOT,19,0,267,36,77,.468,0,0,,36,77,.468,.468,27,36,.750,14,17,31,35,14,5,20,21,99
312,Othell Wilson\wilsoot01,PG,23,GSW,74,23,1260,134,291,.460,3,16,.188,131,275,.476,.466,54,76,.711,35,96,131,217,77,12,95,122,325
313,Randy Wittman\wittmra01,SG,25,ATL,41,22,1168,187,352,.531,2,7,.286,185,345,.536,.534,30,41,.732,16,57,73,125,28,7,57,58,406
314,Al Wood\woodal01,SG,26,SEA,80,79,2545,515,1061,.485,7,33,.212,508,1028,.494,.489,166,214,.776,99,180,279,236,84,52,120,187,1203
315,Leon Wood\woodle01,PG,22,PHI,38,1,269,50,134,.373,4,30,.133,46,104,.442,.388,18,26,.692,3,15,18,45,8,0,25,17,122
316,Mike Woodson\woodsmi01,SG,26,KCK,78,3,1998,530,1068,.496,5,21,.238,525,1047,.501,.499,264,330,.800,69,129,198,143,117,28,139,216,1329
317,Orlando Woolridge\woolror01,SF,25,CHI,77,76,2816,679,1225,.554,0,5,.000,679,1220,.557,.554,409,521,.785,158,277,435,135,58,38,178,185,1767
318,James Worthy*\worthja01,SF,23,LAL,80,76,2696,610,1066,.572,0,7,.000,610,1059,.576,.572,190,245,.776,169,342,511,201,87,67,198,196,1410
319,Danny Young\youngda01,PG,22,SEA,3,0,26,2,10,.200,0,1,.000,2,9,.222,.200,0,0,,0,3,3,2,3,0,2,2,4
320,Michael Young\youngmi01,SF,24,PHO,2,0,11,2,6,.333,0,1,.000,2,5,.400,.333,0,0,,1,1,2,0,0,0,0,0,4