
Rk,Player,Pos,Age,Tm,G,GS,MP,FG,FGA,FG%,3P,3PA,3P%,2P,2PA,2P%,eFG%,FT,FTA,FT%,ORB,DRB,TRB,AST,STL,BLK,TOV,PF,PTS
1,Kareem Abdul-Jabbar*\abdulka01,C,40,LAL,80,80,2308,480,903,.532,0,1,.000,480,902,.532,.532,205,269,.762,118,360,478,135,48,92,159,216,1165
2,Mark Acres\acresma01,C,25,BOS,79,5,1151,108,203,.532,0,0,,108,203,.532,.532,71,111,.640,105,165,270,42,29,27,54,198,287
3,Alvan Adams\adamsal01,C,33,PHO,82,25,1646,251,506,.496,1,2,.500,250,504,.496,.497,108,128,.844,118,247,365,183,82,41,140,245,611
4,Michael Adams\adamsmi01,PG,25,DEN,82,75,2778,416,927,.449,139,379,.367,277,548,.505,.524,166,199,.834,40,183,223,503,168,16,144,138,1137
5,Mark Aguirre\aguirma01,SF,28,DAL,77,77,2610,746,1571,.475,52,172,.302,694,1399,.496,.491,388,504,.770,182,252,434,278,70,57,203,223,1932
6,Danny Ainge\aingeda01,SG,28,BOS,81,81,3018,482,982,.491,148,357,.415,334,625,.534,.566,158,180,.878,59,190,249,503,115,17,153,203,1270
7,Mark Alarie\alarima01,PF,24,WSB,63,0,769,144,300,.480,4,18,.222,140,282,.496,.487,35,49,.714,70,90,160,39,10,12,50,107,327
8,Steve Alford\alforst01,PG,23,DAL,28,0,197,21,55,.382,1,8,.125,20,47,.426,.391,16,17,.941,3,20,23,23,17,3,12,23,59
9,Greg Anderson\andergr01,PF,23,SAS,82,45,1984,379,756,.501,1,5,.200,378,751,.503,.502,198,328,.604,161,352,513,79,54,122,143,228,957
10,Richard Anderson\anderri01,PF,27,TOT,74,3,1350,171,439,.390,48,150,.320,123,289,.426,.444,58,77,.753,91,212,303,112,51,16,61,137,448
11,Ron Anderson\anderro01,SF,29,IND,74,1,1097,217,436,.498,0,2,.000,217,434,.500,.498,108,141,.766,89,127,216,78,41,6,73,98,542
12,Joe Arlauckas\arlaujo01,SF,22,SAC,9,0,85,14,43,.326,0,0,,14,43,.326,.326,6,8,.750,6,7,13,8,3,4,4,16,34
13,Vincent Askew\askewvi01,SG,21,PHI,14,2,234,22,74,.297,0,0,,22,74,.297,.297,8,11,.727,6,16,22,33,10,6,12,12,52
14,John Bagley\baglejo01,PG,27,NJN,82,74,2774,393,896,.439,47,161,.292,346,735,.471,.465,148,180,.822,61,196,257,479,110,10,201,162,981
15,James Bailey\baileja01,PF,30,PHO,65,0,869,109,241,.452,0,4,.000,109,237,.460,.452,70,89,.787,73,137,210,42,17,28,70,180,288
16,Thurl Bailey\baileth01,SF,26,UTA,82,10,2804,633,1286,.492,1,3,.333,632,1283,.493,.493,337,408,.826,134,397,531,158,49,125,190,186,1604
17,Charles Barkley*\barklch01,PF,24,PHI,80,80,3170,753,1283,.587,44,157,.280,709,1126,.630,.604,714,951,.751,385,566,951,254,100,103,304,278,2264
18,John Battle\battljo01,SG,25,ATL,67,1,1227,278,613,.454,16,41,.390,262,572,.458,.467,141,188,.750,26,87,113,158,31,5,75,84,713
19,William Bedford\bedfowi01,C,24,DET,38,0,298,44,101,.436,0,0,,44,101,.436,.436,13,23,.565,27,38,65,4,8,17,19,47,101
20,Benoit Benjamin\benjabe01,C,23,LAC,66,59,2171,340,693,.491,0,8,.000,340,685,.496,.491,180,255,.706,112,418,530,172,50,225,223,203,860
21,Kent Benson\bensoke01,C,33,CLE,2,0,12,2,2,1.000,0,0,,2,2,1.000,1.000,1,2,.500,0,1,1,0,1,1,2,2,5
22,Walter Berry\berrywa01,SF,23,SAS,73,56,1922,540,960,.563,0,0,,540,960,.563,.563,192,320,.600,176,219,395,110,55,63,162,207,1272
23,Larry Bird*\birdla01,SF,31,BOS,76,75,2965,881,1672,.527,98,237,.414,783,1435,.546,.556,415,453,.916,108,595,703,467,125,57,213,157,2275
24,Otis Birdsong\birdsot01,SG,32,NJN,67,59,1882,337,736,.458,9,25,.360,328,711,.461,.464,47,92,.511,73,94,167,222,54,11,129,143,730
25,Uwe Blab\blabuw01,C,25,DAL,73,1,658,58,132,.439,0,0,,58,132,.439,.439,46,65,.708,52,82,134,35,8,29,49,108,162
26,Rolando Blackman\blackro01,SG,28,DAL,71,69,2580,497,1050,.473,0,5,.000,497,1045,.476,.473,331,379,.873,82,164,246,262,64,18,144,112,1325
27,Nate Blackwell\blackna01,PG,22,SAS,10,0,112,15,41,.366,2,11,.182,13,30,.433,.390,5,6,.833,2,4,6,18,3,0,8,16,37
28,Muggsy Bogues\boguemu01,PG,23,WSB,79,14,1628,166,426,.390,3,16,.188,163,410,.398,.393,58,74,.784,35,101,136,404,127,3,101,138,393
29,Manute Bol\bolma01,C,25,WSB,77,4,1136,75,165,.455,0,1,.000,75,164,.457,.455,26,49,.531,72,203,275,13,11,208,35,160,176
30,Dudley Bradley\bradldu01,SG,30,TOT,65,15,1437,156,365,.427,37,102,.363,119,263,.452,.478,74,97,.763,25,102,127,151,114,43,88,172,423
31,Adrian Branch\brancad01,SF,24,NJN,20,3,308,56,134,.418,1,5,.200,55,129,.426,.422,20,23,.870,20,28,48,16,16,11,29,41,133
32,Randy Breuer\breuera01,C,27,MIL,81,73,2258,390,788,.495,0,0,,390,788,.495,.495,188,286,.657,191,360,551,103,46,107,107,198,968
33,Frank Brickowski\brickfr01,C,28,SAS,70,68,2227,425,805,.528,1,5,.200,424,800,.530,.529,268,349,.768,167,316,483,266,74,36,207,275,1119
34,Michael Brooks\brookmi01,SF,29,DEN,16,0,133,20,49,.408,0,0,,20,49,.408,.408,3,4,.750,19,25,44,13,4,1,12,21,43
35,Mike Brown\brownmi01,C,24,CHI,46,27,591,78,174,.448,0,1,.000,78,173,.451,.448,41,71,.577,66,93,159,28,11,4,38,85,197
36,Steve Burtt\burttst01,SG,25,LAC,19,0,312,62,138,.449,0,4,.000,62,134,.463,.449,47,69,.681,6,21,27,38,10,5,40,56,171
37,Michael Cage\cagemi01,PF,26,LAC,72,70,2660,360,766,.470,0,1,.000,360,765,.471,.470,326,474,.688,371,567,938,110,91,58,160,194,1046
38,Tony Campbell\campbto01,SF,25,LAL,13,1,242,57,101,.564,1,3,.333,56,98,.571,.569,28,39,.718,8,19,27,15,11,2,26,41,143
39,Rick Carlisle\carliri01,SG,28,NYK,26,0,204,29,67,.433,6,17,.353,23,50,.460,.478,10,11,.909,6,7,13,32,11,4,22,39,74
40,Antoine Carr\carran01,PF,26,ATL,80,2,1483,281,517,.544,1,4,.250,280,513,.546,.544,142,182,.780,94,195,289,103,38,83,116,272,705
41,Joe Barry Carroll\carrojo01,C,29,TOT,77,30,2004,402,924,.435,0,2,.000,402,922,.436,.435,172,225,.764,131,358,489,113,50,106,164,195,976
42,Bill Cartwright\cartwbi01,C,30,NYK,82,4,1676,287,528,.544,0,0,,287,528,.544,.544,340,426,.798,127,257,384,85,43,43,135,234,914
43,Terry Catledge\catlete01,PF,24,WSB,70,40,1610,296,585,.506,0,2,.000,296,583,.508,.506,154,235,.655,180,217,397,63,33,9,101,172,746
44,Tom Chambers\chambto01,PF,28,SEA,82,82,2680,611,1364,.448,33,109,.303,578,1255,.461,.460,419,519,.807,135,355,490,212,87,53,209,297,1674
45,Maurice Cheeks*\cheekma01,PG,31,PHI,79,79,2871,428,865,.495,3,22,.136,425,843,.504,.497,227,275,.825,59,194,253,635,167,22,160,116,1086
46,Ben Coleman\colembe01,PF,26,TOT,70,24,1498,226,453,.499,0,3,.000,226,450,.502,.499,141,185,.762,116,234,350,62,43,41,127,230,593
47,Norris Coleman\colemno01,SF,26,LAC,29,11,431,66,191,.346,1,2,.500,65,189,.344,.348,20,36,.556,36,45,81,13,11,6,16,51,153
48,Steve Colter\coltest01,PG,25,TOT,68,53,1513,203,441,.460,3,10,.300,200,431,.464,.464,75,95,.789,58,115,173,261,62,14,88,132,484
49,Dallas Comegys\comegda01,PF,23,NJN,75,17,1122,156,363,.430,0,1,.000,156,362,.431,.430,106,150,.707,54,164,218,65,36,70,116,175,418
50,Lester Conner\connele01,PG,28,HOU,52,3,399,50,108,.463,0,7,.000,50,101,.495,.463,32,41,.780,20,18,38,59,38,1,33,31,132
51,Jeff Cook\cookje01,PF,31,PHO,33,0,359,14,59,.237,0,1,.000,14,58,.241,.237,23,28,.821,37,69,106,14,9,8,14,64,51
52,Michael Cooper\coopemi01,SG,31,LAL,61,8,1793,189,482,.392,57,178,.320,132,304,.434,.451,97,113,.858,50,178,228,289,66,26,101,136,532
53,Wayne Cooper\coopewa01,C,31,DEN,45,32,865,118,270,.437,0,1,.000,118,269,.439,.437,50,67,.746,98,172,270,30,12,94,59,145,286
54,Tyrone Corbin\corbity01,SF,25,TOT,84,5,1739,257,525,.490,1,6,.167,256,519,.493,.490,110,138,.797,127,223,350,115,72,18,104,181,625
55,Dave Corzine\corzida01,C,31,CHI,80,32,2328,344,715,.481,1,9,.111,343,706,.486,.482,115,153,.752,170,357,527,154,36,95,109,149,804
56,Winston Crite\critewi01,SF,22,PHO,29,0,258,34,68,.500,0,0,,34,68,.500,.500,19,25,.760,27,37,64,15,5,8,25,42,87
57,Pat Cummings\cummipa01,PF,31,NYK,62,9,946,140,307,.456,0,1,.000,140,306,.458,.456,59,80,.738,82,153,235,37,20,10,65,143,339
58,Terry Cummings\cummite01,PF,26,MIL,76,76,2629,675,1392,.485,1,3,.333,674,1389,.485,.485,270,406,.665,184,369,553,181,78,46,170,274,1621
59,Earl Cureton\curetea01,PF,30,LAC,69,11,1128,133,310,.429,0,3,.000,133,307,.433,.429,33,63,.524,97,174,271,63,32,36,58,135,299
60,Dell Curry\curryde01,SG,23,CLE,79,8,1499,340,742,.458,28,81,.346,312,661,.472,.477,79,101,.782,43,123,166,149,94,22,108,128,787
61,Quintin Dailey\dailequ01,SG,27,LAC,67,7,1282,328,755,.434,2,12,.167,326,743,.439,.436,243,313,.776,62,92,154,109,69,4,123,128,901
62,Adrian Dantley*\dantlad01,SF,31,DET,69,50,2144,444,863,.514,0,2,.000,444,861,.516,.514,492,572,.860,84,143,227,171,39,10,135,144,1380
63,Brad Daugherty\daughbr01,C,22,CLE,79,78,2957,551,1081,.510,0,2,.000,551,1079,.511,.510,378,528,.716,151,514,665,333,48,56,267,235,1480
64,Brad Davis\davisbr01,PG,32,DAL,75,12,1480,208,415,.501,30,74,.405,178,341,.522,.537,91,108,.843,18,84,102,303,51,18,91,149,537
65,Charles Davis\davisch02,SF,29,TOT,21,0,226,48,115,.417,1,17,.059,47,98,.480,.422,7,10,.700,16,25,41,20,2,4,18,29,104
66,Walter Davis\daviswa03,SF,33,PHO,68,48,1951,488,1031,.473,36,96,.375,452,935,.483,.491,205,231,.887,32,127,159,278,86,3,126,131,1217
67,Darryl Dawkins\dawkida01,C,31,TOT,6,0,33,2,9,.222,0,0,,2,9,.222,.222,6,15,.400,2,3,5,2,0,2,7,14,10
68,Johnny Dawkins\dawkijo01,PG,24,SAS,65,61,2179,405,835,.485,19,61,.311,386,774,.499,.496,198,221,.896,66,138,204,480,88,2,154,95,1027
69,Darren Daye\dayeda01,SF,27,BOS,47,8,655,112,217,.516,0,1,.000,112,216,.519,.516,59,87,.678,30,46,76,71,29,4,44,68,283
70,James Donaldson\donalja01,C,30,DAL,81,81,2523,212,380,.558,0,0,,212,380,.558,.558,147,189,.778,247,508,755,66,40,104,113,175,571
71,Billy Donovan\donovbi01,PG,22,NYK,44,0,364,44,109,.404,0,7,.000,44,102,.431,.404,17,21,.810,5,20,25,87,16,1,42,33,105
72,Greg Dreiling\dreilgr01,C,25,IND,20,0,74,8,17,.471,0,0,,8,17,.471,.471,18,26,.692,3,14,17,5,2,4,11,19,34
73,Larry Drew\drewla01,PG,29,LAC,74,51,2024,328,720,.456,26,90,.289,302,630,.479,.474,83,108,.769,21,98,119,383,65,0,152,114,765
74,Clyde Drexler*\drexlcl01,SG,25,POR,81,80,3060,849,1679,.506,11,52,.212,838,1627,.515,.509,476,587,.811,261,272,533,467,203,52,236,250,2185
75,Kevin Duckworth\duckwke01,C,23,POR,78,50,2223,450,907,.496,0,0,,450,907,.496,.496,331,430,.770,224,352,576,66,31,32,177,280,1231
76,Chris Dudley\dudlech02,C,22,CLE,55,1,513,65,137,.474,0,0,,65,137,.474,.474,40,71,.563,74,70,144,23,13,19,31,87,170
77,Joe Dumars*\dumarjo01,SG,24,DET,82,82,2732,453,960,.472,4,19,.211,449,941,.477,.474,251,308,.815,63,137,200,387,87,15,172,155,1161
78,T.R. Dunn\dunntr01,SG,32,DEN,82,1,1534,70,156,.449,0,1,.000,70,155,.452,.449,40,52,.769,110,130,240,87,101,11,26,152,180
79,Mark Eaton\eatonma01,C,31,UTA,82,82,2731,226,541,.418,0,0,,226,541,.418,.418,119,191,.623,230,487,717,55,41,304,131,320,571
80,Franklin Edwards\edwarfr01,PG,28,SAC,16,11,414,54,115,.470,0,2,.000,54,113,.478,.470,24,32,.750,4,15,19,92,10,1,47,10,132
81,James Edwards\edwarja01,C,32,TOT,69,44,1705,302,643,.470,0,1,.000,302,642,.470,.470,210,321,.654,119,293,412,78,16,37,130,216,814
82,Craig Ehlo\ehlocr01,SG,26,CLE,79,27,1709,226,485,.466,22,64,.344,204,421,.485,.489,89,132,.674,86,188,274,206,82,30,107,182,563
83,Dale Ellis\ellisda01,SG,27,SEA,75,73,2790,764,1519,.503,107,259,.413,657,1260,.521,.538,303,395,.767,167,173,340,197,74,11,172,221,1938
84,Chris Engler\englech01,C,28,NJN,54,0,399,36,88,.409,0,0,,36,88,.409,.409,31,35,.886,32,66,98,15,9,6,29,73,103
85,Alex English*\englial01,SF,34,DEN,80,80,2818,843,1704,.495,0,6,.000,843,1698,.496,.495,314,379,.828,166,207,373,377,70,23,181,193,2000
86,Mike Evans\evansmi01,PG,32,DEN,56,0,656,139,307,.453,36,91,.396,103,216,.477,.511,30,37,.811,9,39,48,81,34,6,43,78,344
87,Patrick Ewing*\ewingpa01,C,25,NYK,82,82,2546,656,1183,.555,0,3,.000,656,1180,.556,.555,341,476,.716,245,431,676,125,104,245,287,332,1653
88,Jim Farmer\farmeji01,SG,23,DAL,30,0,157,26,69,.377,0,6,.000,26,63,.413,.377,9,10,.900,9,9,18,16,3,1,22,18,61
89,Dave Feitl\feitlda01,C,25,GSW,70,19,1128,182,404,.450,0,4,.000,182,400,.455,.450,94,134,.701,83,252,335,53,15,9,87,146,458
90,Kenny Fields\fieldke01,SF,25,LAC,7,0,154,16,36,.444,0,0,,16,36,.444,.444,20,26,.769,13,16,29,10,5,2,19,17,52
91,Vern Fleming\flemive01,PG,25,IND,80,80,2733,442,845,.523,0,13,.000,442,832,.531,.523,227,283,.802,106,258,364,568,115,11,175,225,1111
92,Sleepy Floyd\floydsl01,PG,27,TOT,77,73,2514,420,969,.433,14,72,.194,406,897,.453,.441,301,354,.850,77,219,296,544,95,12,223,190,1155
93,Tellis Frank\frankte01,PF,22,GSW,78,29,1597,242,565,.428,0,1,.000,242,564,.429,.428,150,207,.725,95,235,330,111,53,23,109,267,634
94,World B. Free\freewo01,SG,34,HOU,58,0,682,143,350,.409,8,35,.229,135,315,.429,.420,80,100,.800,14,30,44,60,20,3,49,74,374
95,Kevin Gamble\gamblke01,SF,22,POR,9,0,19,0,3,.000,0,1,.000,0,2,.000,.000,0,0,,2,1,3,1,2,0,2,2,0
96,Winston Garland\garlawi01,PG,23,GSW,67,62,2122,340,775,.439,13,39,.333,327,736,.444,.447,138,157,.879,68,159,227,429,116,7,167,188,831
97,Armen Gilliam\gilliar01,PF,23,PHO,55,53,1807,342,720,.475,0,0,,342,720,.475,.475,131,193,.679,134,300,434,72,58,29,123,143,815
98,Artis Gilmore*\gilmoar01,C,38,TOT,71,27,893,99,181,.547,0,0,,99,181,.547,.547,67,128,.523,69,142,211,21,15,30,67,148,265
99,Mike Gminski\gminsmi01,C,28,TOT,81,81,2961,505,1126,.448,0,2,.000,505,1124,.449,.448,355,392,.906,245,569,814,139,64,118,177,176,1365
100,Lancaster Gordon\gordola01,SG,25,LAC,8,0,65,11,31,.355,0,0,,11,31,.355,.355,6,6,1.000,2,2,4,7,1,2,4,8,28
101,Horace Grant\grantho01,PF,22,CHI,81,6,1827,254,507,.501,0,2,.000,254,505,.503,.501,114,182,.626,155,292,447,89,51,53,86,221,622
102,Stuart Gray\grayst01,C,24,IND,74,0,807,90,193,.466,0,1,.000,90,192,.469,.466,44,73,.603,70,180,250,44,11,32,50,152,224
103,A.C. Green\greenac01,PF,24,LAL,82,64,2636,322,640,.503,0,2,.000,322,638,.505,.503,293,379,.773,245,465,710,93,87,45,120,204,937
104,Rickey Green\greenri01,PG,33,UTA,81,3,1116,157,370,.424,4,19,.211,153,351,.436,.430,75,83,.904,14,66,80,300,57,1,94,83,393
105,Sidney Green\greensi02,PF,27,NYK,82,65,2049,258,585,.441,0,2,.000,258,583,.443,.441,126,190,.663,221,421,642,93,65,32,148,318,642
106,Dave Greenwood\greenda01,PF,30,SAS,45,40,1236,151,328,.460,0,2,.000,151,326,.463,.460,83,111,.748,92,208,300,97,33,22,74,134,385
107,Claude Gregory\gregocl01,PF,29,LAC,23,2,313,61,134,.455,0,1,.000,61,133,.459,.455,12,36,.333,37,58,95,16,9,13,22,37,134
108,Darrell Griffith\griffda01,SG,29,UTA,52,11,1052,251,585,.429,28,102,.275,223,483,.462,.453,59,92,.641,36,91,127,91,52,5,67,102,589
109,Petur Gudmundsson\gudmupe01,C,29,SAS,69,9,1017,139,280,.496,0,1,.000,139,279,.498,.496,117,145,.807,93,230,323,86,18,61,103,197,395
110,Bob Hansen\hansebo01,SG,27,UTA,81,51,1796,316,611,.517,32,97,.330,284,514,.553,.543,113,152,.743,64,123,187,175,65,5,91,193,777
111,Bill Hanzlik\hanzlbi01,SF,30,DEN,77,0,1334,109,287,.380,3,16,.188,106,271,.391,.385,129,163,.791,39,132,171,166,64,17,95,185,350
112,Derek Harper\harpede01,PG,26,DAL,82,82,3032,536,1167,.459,60,192,.313,476,975,.488,.485,261,344,.759,71,175,246,634,168,35,190,164,1393
113,Ron Harper\harpero01,SG,24,CLE,57,52,1830,340,732,.464,3,20,.150,337,712,.473,.467,196,278,.705,64,159,223,281,122,52,158,157,879
114,Steve Harris\harrist01,SG,24,TOT,58,26,1084,223,487,.458,0,7,.000,223,480,.465,.458,89,113,.788,53,73,126,87,50,8,56,89,535
115,Scott Hastings\hastisc01,PF,27,ATL,55,0,403,40,82,.488,5,12,.417,35,70,.500,.518,25,27,.926,27,70,97,16,8,10,14,67,110
116,Dave Henderson\hendeda01,SG,23,PHI,22,1,351,47,116,.405,0,1,.000,47,115,.409,.405,32,47,.681,11,24,35,34,12,5,40,41,126
117,Gerald Henderson\hendege01,PG,32,TOT,75,5,1505,194,453,.428,69,163,.423,125,290,.431,.504,138,170,.812,27,80,107,231,69,5,133,187,595
118,Kevin Henderson\hendeke01,SG,23,TOT,17,2,190,21,53,.396,0,1,.000,21,52,.404,.396,15,26,.577,9,12,21,23,8,0,17,26,57
119,Conner Henry\henryco01,SG,24,TOT,39,2,433,62,150,.413,20,45,.444,42,105,.400,.480,39,47,.830,13,36,49,67,12,5,39,37,183
120,Rod Higgins\higgiro01,SF,28,GSW,68,67,2188,381,725,.526,19,39,.487,362,686,.528,.539,273,322,.848,94,199,293,188,70,31,111,188,1054
121,Roy Hinson\hinsoro01,SF,26,TOT,77,57,2592,453,930,.487,0,2,.000,453,928,.488,.487,272,351,.775,159,358,517,99,69,140,169,275,1178
122,Craig Hodges\hodgecr01,SG,27,TOT,66,0,1445,242,523,.463,86,175,.491,156,348,.448,.545,59,71,.831,19,59,78,153,46,2,77,118,629
123,Mike Holton\holtomi01,PG,26,POR,82,2,1279,163,353,.462,3,15,.200,160,338,.473,.466,107,129,.829,50,99,149,211,41,10,86,154,436
124,Dave Hoppen\hoppeda01,C,23,TOT,39,8,642,84,183,.459,0,1,.000,84,182,.462,.459,54,62,.871,58,116,174,32,13,6,37,87,222
125,Dennis Hopson\hopsode01,SG,22,NJN,61,19,1365,222,549,.404,12,45,.267,210,504,.417,.415,131,177,.740,63,80,143,118,57,25,119,145,587
126,Jeff Hornacek\hornaje01,SG,24,PHO,82,49,2243,306,605,.506,17,58,.293,289,547,.528,.520,152,185,.822,71,191,262,540,107,10,156,151,781
127,Phil Hubbard\hubbaph01,SF,31,CLE,78,59,1631,237,485,.489,0,5,.000,237,480,.494,.489,182,243,.749,117,164,281,81,50,7,118,167,656
128,Eddie Hughes\hugheed01,PG,27,UTA,11,0,42,5,13,.385,1,6,.167,4,7,.571,.423,6,6,1.000,3,1,4,8,0,0,6,5,17
129,Jay Humphries\humphja01,PG,25,TOT,68,33,1809,284,538,.528,3,18,.167,281,520,.540,.531,112,153,.732,49,125,174,395,81,5,127,177,683
130,Marc Iavaroni\iavarma01,PF,31,UTA,81,71,1238,143,308,.464,0,2,.000,143,306,.467,.464,78,99,.788,94,174,268,67,23,25,83,162,364
131,Mark Jackson\jacksma01,PG,22,NYK,82,80,3249,438,1013,.432,32,126,.254,406,887,.458,.448,206,266,.774,120,276,396,868,205,6,258,244,1114
132,Michael Jackson\jacksmi02,PG,23,SAC,58,0,760,64,171,.374,6,25,.240,58,146,.397,.392,23,32,.719,17,42,59,179,20,5,58,81,157
133,Buck Johnson\johnsbu01,SF,24,HOU,70,2,879,155,298,.520,1,8,.125,154,290,.531,.522,67,91,.736,77,91,168,49,30,26,54,127,378
134,Clemon Johnson\johnscl01,C,31,SEA,74,26,723,49,105,.467,0,0,,49,105,.467,.467,22,32,.688,66,108,174,17,13,24,29,104,120
135,Dennis Johnson*\johnsde01,PG,33,BOS,77,74,2670,352,803,.438,12,46,.261,340,757,.449,.446,255,298,.856,62,178,240,598,93,29,195,204,971
136,Eddie Johnson\johnsed03,SF,28,PHO,73,59,2177,533,1110,.480,24,94,.255,509,1016,.501,.491,204,240,.850,121,197,318,180,33,9,139,190,1294
137,Frank Johnson\johnsfr01,PG,29,WSB,75,17,1258,216,498,.434,1,9,.111,215,489,.440,.435,121,149,.812,39,82,121,188,70,4,99,120,554
138,Kannard Johnson\johnska01,SF,22,CLE,4,0,12,1,3,.333,0,0,,1,3,.333,.333,0,0,,0,0,0,0,1,0,2,1,2
139,Kevin Johnson\johnske02,PG,21,TOT,80,28,1917,275,596,.461,5,24,.208,270,572,.472,.466,177,211,.839,36,155,191,437,103,24,146,155,732
140,Magic Johnson*\johnsma02,PG,28,LAL,72,70,2637,490,996,.492,11,56,.196,479,940,.510,.497,417,489,.853,88,361,449,858,114,13,269,147,1408
141,Steve Johnson\johnsst03,C,30,POR,43,33,1050,258,488,.529,0,1,.000,258,487,.530,.529,146,249,.586,84,158,242,57,17,32,122,151,662
142,Vinnie Johnson\johnsvi01,SG,31,DET,82,1,1935,425,959,.443,5,24,.208,420,935,.449,.446,147,217,.677,90,141,231,267,58,18,152,164,1002
143,Caldwell Jones\jonesca01,C,37,POR,79,77,1778,128,263,.487,0,4,.000,128,259,.494,.487,78,106,.736,105,303,408,81,29,99,82,251,334
144,Charles Jones\jonesch01,PF,30,WSB,69,49,1313,72,177,.407,0,1,.000,72,176,.409,.407,53,75,.707,106,219,325,59,53,113,57,226,197
145,Charles Jones\jonesch02,PF,26,POR,37,0,186,16,40,.400,0,1,.000,16,39,.410,.400,19,33,.576,11,20,31,8,3,6,12,28,51
146,Michael Jordan*\jordami01,SG,24,CHI,82,82,3311,1069,1998,.535,7,53,.132,1062,1945,.546,.537,723,860,.841,139,310,449,485,259,131,252,270,2868
147,Jerome Kersey\kerseje01,SF,25,POR,79,75,2888,611,1225,.499,3,15,.200,608,1210,.502,.500,291,396,.735,211,446,657,243,127,65,161,302,1516
148,Albert King\kingal01,SF,28,PHI,72,44,1593,211,540,.391,17,49,.347,194,491,.395,.406,78,103,.757,71,145,216,109,39,18,93,219,517
149,Bernard King*\kingbe01,SF,31,WSB,69,38,2044,470,938,.501,1,6,.167,469,932,.503,.502,247,324,.762,86,194,280,192,49,10,211,202,1188
150,Greg Kite\kitegr01,C,26,TOT,53,19,1063,92,205,.449,0,1,.000,92,204,.451,.449,40,79,.506,85,179,264,47,19,58,73,153,224
151,Joe Kleine\kleinjo01,C,26,SAC,82,60,1999,324,686,.472,0,0,,324,686,.472,.472,153,188,.814,179,400,579,93,28,59,107,228,801
152,Bart Kofoed\kofoeba01,SG,23,UTA,36,0,225,18,48,.375,2,7,.286,16,41,.390,.396,8,13,.615,4,11,15,23,6,1,18,42,46
153,Jon Koncak\koncajo01,C,24,ATL,49,22,1073,98,203,.483,0,2,.000,98,201,.488,.483,83,136,.610,103,230,333,19,36,56,53,161,279
154,Larry Krystkowiak\krystla01,PF,23,MIL,50,7,1050,128,266,.481,0,3,.000,128,263,.487,.481,103,127,.811,88,143,231,50,18,8,57,137,359
155,Bill Laimbeer\laimbbi01,C,30,DET,82,82,2897,455,923,.493,13,39,.333,442,884,.500,.500,187,214,.874,165,667,832,199,66,78,136,284,1110
156,Jeff Lamp\lampje01,SF,28,LAL,3,0,7,0,0,,0,0,,0,0,,,2,2,1.000,0,0,0,0,0,0,0,1,2
157,Allen Leavell\leaveal01,SG,30,HOU,80,54,2150,291,666,.437,19,88,.216,272,578,.471,.451,218,251,.869,22,126,148,405,124,9,130,162,819
158,Fat Lever\leverfa01,SG,27,DEN,82,82,3061,643,1360,.473,12,57,.211,631,1303,.484,.477,248,316,.785,203,462,665,639,223,21,182,214,1546
159,Cliff Levingston\levincl01,PF,27,ATL,82,32,2135,314,564,.557,1,2,.500,313,562,.557,.558,190,246,.772,228,276,504,71,52,84,94,287,819
160,Ralph Lewis\lewisra01,SG,24,DET,50,0,310,27,87,.310,0,1,.000,27,86,.314,.310,29,48,.604,17,34,51,14,13,4,19,36,83
161,Reggie Lewis\lewisre01,SG,22,BOS,49,0,405,90,193,.466,0,4,.000,90,189,.476,.466,40,57,.702,28,35,63,26,16,15,30,54,220
162,Alton Lister\listeal01,C,29,SEA,82,55,1812,173,343,.504,1,2,.500,172,341,.504,.506,114,188,.606,200,427,627,58,27,140,90,319,461
163,Brad Lohaus\lohaubr01,PF,23,BOS,70,4,718,122,246,.496,3,13,.231,119,233,.511,.502,50,62,.806,46,92,138,49,20,41,59,123,297
164,John Long\longjo01,SG,31,IND,81,81,2022,417,879,.474,34,77,.442,383,802,.478,.494,166,183,.907,72,157,229,173,84,11,127,164,1034
165,John Lucas\lucasjo01,PG,34,MIL,81,22,1766,281,631,.445,51,151,.338,230,480,.479,.486,130,162,.802,29,130,159,392,88,3,125,102,743
166,Maurice Lucas\lucasma01,PF,35,POR,73,0,1191,168,373,.450,0,3,.000,168,370,.454,.450,109,148,.736,101,214,315,94,33,10,73,188,445
167,Rick Mahorn\mahorri01,PF,29,DET,67,64,1963,276,481,.574,1,2,.500,275,479,.574,.575,164,217,.756,159,406,565,60,43,42,119,262,717
168,Jeff Malone\malonje01,SG,26,WSB,80,80,2655,648,1360,.476,10,24,.417,638,1336,.478,.480,335,380,.882,44,162,206,237,51,13,172,198,1641
169,Karl Malone*\malonka01,PF,24,UTA,82,82,3198,858,1650,.520,0,5,.000,858,1645,.522,.520,552,789,.700,277,709,986,199,117,50,325,296,2268
170,Moses Malone*\malonmo01,C,32,WSB,79,78,2692,531,1090,.487,2,7,.286,529,1083,.488,.488,543,689,.788,372,512,884,112,59,72,249,160,1607
171,Pace Mannion\mannipa01,SF,27,MIL,35,1,477,48,118,.407,2,12,.167,46,106,.434,.415,25,37,.676,17,34,51,55,13,7,24,53,123
172,Bill Martin\martibi01,SF,25,PHO,10,0,101,16,51,.314,0,1,.000,16,50,.320,.314,8,13,.615,9,18,27,6,5,0,9,16,40
173,Maurice Martin\martima01,SF,23,DEN,26,0,136,23,61,.377,1,4,.250,22,57,.386,.385,10,21,.476,13,11,24,14,6,3,10,21,57
174,Wes Matthews\matthwe01,PG,28,LAL,51,8,706,114,248,.460,7,30,.233,107,218,.491,.474,54,65,.831,16,50,66,138,25,3,69,65,289
175,Cedric Maxwell\maxwece01,SF,32,HOU,71,0,848,80,171,.468,0,2,.000,80,169,.473,.468,110,143,.769,74,105,179,60,22,12,54,75,270
176,Tim McCormick\mccorti01,C,25,TOT,70,55,2114,348,648,.537,0,2,.000,348,646,.539,.537,145,215,.674,146,321,467,118,32,23,111,234,841
177,Rodney McCray\mccraro01,SF,26,HOU,81,80,2689,359,746,.481,0,4,.000,359,742,.484,.481,288,367,.785,232,399,631,264,57,51,144,166,1006
178,Xavier McDaniel\mcdanxa01,SF,24,SEA,78,77,2703,687,1407,.488,14,50,.280,673,1357,.496,.493,281,393,.715,206,312,518,263,96,52,223,230,1669
179,Ben McDonald\mcdonbe01,PF,25,GSW,81,41,2039,258,552,.467,9,35,.257,249,517,.482,.476,87,111,.784,133,202,335,138,39,8,93,246,612
180,Mike McGee\mcgeemi01,SF-SG,28,TOT,48,0,1003,223,530,.421,53,160,.331,170,370,.459,.471,76,102,.745,55,73,128,71,52,6,65,81,575
181,Kevin McHale*\mchalke01,PF,30,BOS,64,63,2390,550,911,.604,0,0,,550,911,.604,.604,346,434,.797,159,377,536,171,27,92,141,179,1446
182,Kevin McKenna\mckenke01,SG,29,NJN,31,2,393,43,109,.394,16,50,.320,27,59,.458,.468,24,25,.960,4,27,31,40,15,2,19,55,126
183,Derrick McKey\mckeyde01,SF,21,SEA,82,4,1706,255,519,.491,11,30,.367,244,489,.499,.502,173,224,.772,115,213,328,107,70,63,108,237,694
184,Nate McMillan\mcmilna01,PG,23,SEA,82,82,2453,235,496,.474,9,24,.375,226,472,.479,.483,145,205,.707,117,221,338,702,169,47,189,238,624
185,Mark McNamara\mcnamma01,C,28,PHI,42,18,581,52,133,.391,0,0,,52,133,.391,.391,48,66,.727,66,91,157,18,4,12,26,67,152
186,Chris McNealy\mcneach01,PF,26,NYK,19,0,265,23,74,.311,0,0,,23,74,.311,.311,21,31,.677,24,40,64,23,16,2,17,50,67
187,Reggie Miller*\millere01,SG,22,IND,82,1,1840,306,627,.488,61,172,.355,245,455,.538,.537,149,186,.801,95,95,190,132,53,19,101,157,822
188,Dirk Minniefield\minnidi01,PG,27,TOT,72,6,1070,108,221,.489,4,16,.250,104,205,.507,.498,41,55,.745,30,66,96,228,59,3,93,133,261
189,Mike Mitchell\mitchmi01,SF,32,SAS,68,20,1501,378,784,.482,3,12,.250,375,772,.486,.484,160,194,.825,54,144,198,68,31,13,52,101,919
190,Paul Mokeski\mokespa01,C,31,MIL,60,0,848,100,210,.476,0,4,.000,100,206,.485,.476,51,72,.708,70,151,221,22,27,27,49,194,251
191,Sidney Moncrief\moncrsi01,SG,30,MIL,56,51,1428,217,444,.489,5,31,.161,212,413,.513,.494,164,196,.837,58,122,180,204,41,14,86,109,603
192,Andre Moore\moorean01,PF-SF,23,TOT,10,0,50,9,27,.333,0,0,,9,27,.333,.333,6,8,.750,6,8,14,6,2,1,4,6,24
193,Johnny Moore\moorejo01,PG,29,TOT,5,0,61,4,10,.400,0,1,.000,4,9,.444,.400,0,0,,2,4,6,12,3,0,7,1,8
194,Ron Moore\moorero01,C,26,TOT,14,0,59,9,29,.310,0,0,,9,29,.310,.310,6,8,.750,2,6,8,1,5,0,4,21,24
195,Chris Mullin*\mullich01,SF,24,GSW,60,55,2033,470,926,.508,34,97,.351,436,829,.526,.526,239,270,.885,58,147,205,290,113,32,156,136,1213
196,Jay Murphy\murphja01,PF,25,WSB,9,0,46,8,23,.348,0,0,,8,23,.348,.348,4,5,.800,4,12,16,1,0,0,5,5,20
197,Ronnie Murphy\murphro01,SF,23,POR,18,0,89,14,49,.286,1,4,.250,13,45,.289,.296,7,11,.636,5,6,11,6,5,1,8,14,36
198,Tod Murphy\murphto01,PF,24,LAC,1,0,19,1,1,1.000,0,0,,1,1,1.000,1.000,3,4,.750,1,1,2,2,1,0,0,2,5
199,Pete Myers\myerspe01,SG,24,SAS,22,0,328,43,95,.453,0,4,.000,43,91,.473,.453,26,39,.667,11,26,37,48,17,6,33,30,112
200,Larry Nance\nancela01,PF,28,TOT,67,60,2383,487,920,.529,2,6,.333,485,914,.531,.530,304,390,.779,193,414,607,207,63,159,155,242,1280
201,Calvin Natt\nattca01,PF,31,DEN,27,7,533,102,208,.490,0,1,.000,102,207,.493,.490,54,73,.740,35,61,96,47,13,3,30,43,258
202,Ed Nealy\nealyed01,PF,27,SAS,68,1,837,50,109,.459,1,2,.500,49,107,.458,.463,41,63,.651,82,140,222,49,29,5,27,94,142
203,Martin Nessley\nesslma01,C,22,TOT,44,0,336,20,52,.385,0,0,,20,52,.385,.385,8,18,.444,23,59,82,16,8,12,23,89,48
204,Chuck Nevitt\nevitch01,C,28,DET,17,0,63,7,21,.333,0,0,,7,21,.333,.333,3,6,.500,4,14,18,0,1,5,2,12,17
205,Johnny Newman\newmajo01,SF,24,NYK,77,25,1589,270,620,.435,26,93,.280,244,527,.463,.456,207,246,.841,87,72,159,62,72,11,103,204,773
206,Kurt Nimphius\nimphku01,C,29,SAS,72,7,919,128,257,.498,0,1,.000,128,256,.500,.498,60,83,.723,62,91,153,53,22,56,49,141,316
207,Ken Norman\normake01,SF,23,LAC,66,28,1435,241,500,.482,0,10,.000,241,490,.492,.482,87,170,.512,100,163,263,78,44,34,103,123,569
208,Mike O'Koren\okoremi01,SF,29,NJN,4,0,52,9,16,.563,0,1,.000,9,15,.600,.563,0,4,.000,1,3,4,2,3,2,0,2,18
209,Charles Oakley\oaklech01,PF,24,CHI,82,82,2816,375,776,.483,3,12,.250,372,764,.487,.485,261,359,.727,326,740,1066,248,68,28,241,272,1014
210,Hakeem Olajuwon*\olajuha01,C,25,HOU,79,79,2825,712,1385,.514,0,4,.000,712,1381,.516,.514,381,548,.695,302,657,959,163,162,214,243,324,1805
211,Jawann Oldham\oldhaja01,C,30,SAC,54,13,946,119,250,.476,0,0,,119,250,.476,.476,59,87,.678,82,222,304,33,12,110,62,143,297
212,Louis Orr\orrlo01,SF,29,NYK,29,0,180,16,50,.320,0,1,.000,16,49,.327,.320,8,16,.500,13,21,34,9,6,0,14,27,40
213,Robert Parish*\parisro01,C,34,BOS,74,73,2312,442,750,.589,0,1,.000,442,749,.590,.589,177,241,.734,173,455,628,115,55,84,154,198,1061
214,Jim Paxson\paxsoji02,SG,30,TOT,45,3,801,137,298,.460,5,21,.238,132,277,.477,.468,68,79,.861,15,30,45,76,30,5,39,73,347
215,John Paxson\paxsojo01,PG,27,CHI,81,30,1888,287,582,.493,33,95,.347,254,487,.522,.521,33,45,.733,16,88,104,303,49,1,64,154,640
216,Sam Perkins\perkisa01,PF,26,DAL,75,75,2499,394,876,.450,5,30,.167,389,846,.460,.453,273,332,.822,201,400,601,118,74,54,119,227,1066
217,Chuck Person\persoch01,SF,23,IND,79,71,2807,575,1252,.459,59,177,.333,516,1075,.480,.483,132,197,.670,171,365,536,309,73,8,210,266,1341
218,Jim Petersen\peterji01,PF,25,HOU,69,50,1793,249,488,.510,1,6,.167,248,482,.515,.511,114,153,.745,145,291,436,106,36,40,119,203,613
219,Michael Phelps\phelpmi01,SG,26,LAC,2,0,23,3,7,.429,0,0,,3,7,.429,.429,3,4,.750,0,2,2,3,5,0,2,1,9
220,Ricky Pierce\piercri01,SG,28,MIL,37,0,965,248,486,.510,3,14,.214,245,472,.519,.513,107,122,.877,30,53,83,73,21,7,57,94,606
221,Ed Pinckney\pincked01,PF,24,SAC,79,7,1177,179,343,.522,0,2,.000,179,341,.525,.522,133,178,.747,94,136,230,66,39,32,77,118,491
222,Scottie Pippen*\pippesc01,SF,22,CHI,79,0,1650,261,564,.463,4,23,.174,257,541,.475,.466,99,172,.576,115,183,298,169,91,52,131,214,625
223,Olden Polynice\polynol01,C,23,SEA,82,0,1080,118,254,.465,0,2,.000,118,252,.468,.465,101,158,.639,122,208,330,33,32,26,81,215,337
224,Terry Porter\portete01,PG,24,POR,82,82,2991,462,890,.519,24,69,.348,438,821,.533,.533,274,324,.846,65,313,378,831,150,16,244,204,1222
225,Paul Pressey\presspa01,SG,29,MIL,75,75,2484,345,702,.491,8,39,.205,337,663,.508,.497,285,357,.798,130,245,375,523,112,34,198,233,983
226,Harold Pressley\pressha01,SF,24,SAC,80,49,2029,318,702,.453,36,110,.327,282,592,.476,.479,103,130,.792,139,230,369,185,84,55,135,211,775
227,Mark Price\pricema01,PG,23,CLE,80,79,2626,493,974,.506,72,148,.486,421,826,.510,.543,221,252,.877,54,126,180,480,99,12,184,119,1279
228,Kurt Rambis\rambiku01,PF,29,LAL,70,20,845,102,186,.548,0,0,,102,186,.548,.548,73,93,.785,103,165,268,54,39,13,59,103,277
229,Blair Rasmussen\rasmubl01,C,25,DEN,79,45,1779,435,884,.492,0,0,,435,884,.492,.492,132,170,.776,130,307,437,78,22,81,73,241,1002
230,Robert Reid\reidro01,SG,32,HOU,62,31,980,165,356,.463,13,34,.382,152,322,.472,.482,50,63,.794,38,87,125,67,27,5,41,118,393
231,Richard Rellford\rellfri01,SF,23,SAS,4,0,42,5,8,.625,0,0,,5,8,.625,.625,6,8,.750,2,5,7,1,0,3,4,3,16
232,Jerry Reynolds\reynoje01,SF,25,MIL,62,21,1161,188,419,.449,3,7,.429,185,412,.449,.452,119,154,.773,70,90,160,104,74,32,104,97,498
233,Doc Rivers\riverdo01,PG,26,ATL,80,80,2502,403,890,.453,9,33,.273,394,857,.460,.458,319,421,.758,83,283,366,747,140,41,210,272,1134
234,Fred Roberts\roberfr01,PF,27,BOS,74,14,1032,161,330,.488,0,6,.000,161,324,.497,.488,128,165,.776,60,102,162,81,16,15,68,118,450
235,Alvin Robertson\roberal01,SG,25,SAS,82,82,2978,655,1408,.465,27,95,.284,628,1313,.478,.475,273,365,.748,165,333,498,557,243,69,251,300,1610
236,Cliff Robinson\robincl01,SF,27,PHI,62,51,2110,483,1041,.464,2,9,.222,481,1032,.466,.465,210,293,.717,116,289,405,131,79,39,161,192,1178
237,Dennis Rodman*\rodmade01,SF,26,DET,82,32,2147,398,709,.561,5,17,.294,393,692,.568,.565,152,284,.535,318,397,715,110,75,45,156,273,953
238,Johnny Rogers\rogerjo01,PF,24,CLE,24,0,168,26,61,.426,0,2,.000,26,59,.441,.426,10,13,.769,8,19,27,3,4,3,10,23,62
239,Tree Rollins\rollitr01,C,32,ATL,76,59,1765,133,260,.512,0,0,,133,260,.512,.512,70,80,.875,142,317,459,20,31,132,51,229,336
240,Scott Roth\rothsc01,SF,24,UTA,26,0,201,30,74,.405,2,11,.182,28,63,.444,.419,22,30,.733,7,21,28,16,12,0,11,37,84
241,Brian Rowsom\rowsobr01,PF,22,IND,4,0,16,0,6,.000,0,0,,0,6,.000,.000,6,6,1.000,1,4,5,1,1,0,1,3,6
242,Walker Russell\russewa01,PG,27,DET,1,0,1,0,1,.000,0,1,.000,0,0,,.000,0,0,,0,0,0,1,0,0,0,0,0
243,John Salley\sallejo01,C,23,DET,82,16,2003,258,456,.566,0,0,,258,456,.566,.566,185,261,.709,166,236,402,113,53,137,120,294,701
244,Ralph Sampson*\sampsra01,C-PF,27,TOT,48,44,1663,299,682,.438,2,11,.182,297,671,.443,.440,149,196,.760,140,322,462,122,41,88,171,164,749
245,Mike Sanders\sandemi01,SF,27,TOT,59,16,883,153,303,.505,0,1,.000,153,302,.507,.505,59,76,.776,38,71,109,56,31,9,50,131,365
246,Danny Schayes\schayda01,PF,28,DEN,81,74,2166,361,668,.540,0,2,.000,361,666,.542,.540,407,487,.836,200,462,662,106,62,92,155,323,1129
247,Russ Schoene\schoeru01,PF,27,SEA,81,2,973,208,454,.458,17,58,.293,191,396,.482,.477,51,63,.810,78,120,198,53,39,13,57,151,484
248,Detlef Schrempf\schrede01,SF,25,DAL,82,4,1587,246,539,.456,5,32,.156,241,507,.475,.461,201,266,.756,102,177,279,159,42,32,108,189,698
249,Byron Scott\scottby01,SG,26,LAL,81,81,3048,710,1348,.527,62,179,.346,648,1169,.554,.550,272,317,.858,76,257,333,335,155,27,161,204,1754
250,Carey Scurry\scurrca01,SF,25,TOT,33,0,455,55,118,.466,3,8,.375,52,110,.473,.479,27,39,.692,30,54,84,50,49,23,43,81,140
251,Brad Sellers\sellebr01,SF,25,CHI,82,76,2212,326,714,.457,1,7,.143,325,707,.460,.457,124,157,.790,107,143,250,141,34,66,91,174,777
252,Purvis Short\shortpu01,SG,30,HOU,81,11,1949,474,986,.481,5,21,.238,469,965,.486,.483,206,240,.858,71,151,222,162,58,14,118,197,1159
253,Jerry Sichting\sichtje01,PG,31,TOT,52,1,694,93,172,.541,10,22,.455,83,150,.553,.570,17,23,.739,9,27,36,93,21,0,22,60,213
254,Jack Sikma\sikmaja01,C,32,MIL,82,82,2923,514,1058,.486,3,14,.214,511,1044,.489,.487,321,348,.922,195,514,709,279,93,80,157,316,1352
255,Scott Skiles\skilesc01,PG,23,IND,51,2,760,86,209,.411,6,20,.300,80,189,.423,.426,45,54,.833,11,55,66,180,22,3,76,97,223
256,Derek Smith\smithde02,SG,26,SAC,35,18,899,174,364,.478,8,23,.348,166,341,.487,.489,87,113,.770,35,68,103,89,21,17,48,108,443
257,Kenny Smith\smithke01,PG,22,SAC,61,60,2170,331,694,.477,12,39,.308,319,655,.487,.486,167,204,.819,40,98,138,434,92,8,184,140,841
258,Larry Smith\smithla01,PF,30,GSW,20,10,499,58,123,.472,0,1,.000,58,122,.475,.472,11,27,.407,79,103,182,25,12,11,36,63,127
259,Otis Smith\smithot01,SG,24,TOT,72,18,1549,325,662,.491,13,41,.317,312,621,.502,.501,178,229,.777,126,121,247,155,91,42,107,160,841
260,Mike Smrek\smrekmi01,C,25,LAL,48,2,421,44,103,.427,0,0,,44,103,.427,.427,44,66,.667,27,58,85,8,7,42,30,105,132
261,Rory Sparrow\sparrro01,PG,29,TOT,58,25,1044,117,293,.399,2,13,.154,115,280,.411,.403,24,33,.727,15,57,72,167,41,3,58,79,260
262,Steve Stipanovich\stipast01,C,27,IND,80,80,2692,411,828,.496,3,15,.200,408,813,.502,.498,254,314,.809,157,505,662,183,90,69,156,302,1079
263,John Stockton*\stockjo01,PG,25,UTA,82,79,2842,454,791,.574,24,67,.358,430,724,.594,.589,272,324,.840,54,183,237,1128,242,16,262,247,1204
264,John Stroeder\stroejo01,PF,29,MIL,41,0,271,29,79,.367,0,2,.000,29,77,.377,.367,20,30,.667,24,47,71,20,3,12,24,48,78
265,Jon Sundvold\sundvjo01,PG,26,SAS,52,12,1024,176,379,.464,26,64,.406,150,315,.476,.499,43,48,.896,14,34,48,183,27,2,57,54,421
266,Roy Tarpley\tarplro01,PF,23,DAL,81,9,2307,444,888,.500,0,5,.000,444,883,.503,.500,205,277,.740,360,599,959,86,103,86,172,313,1093
267,Terry Teagle\teaglte01,SG,27,GSW,47,4,958,248,546,.454,1,9,.111,247,537,.460,.455,97,121,.802,41,40,81,61,32,4,80,95,594
268,Reggie Theus\theusre01,SG,30,SAC,73,73,2653,619,1318,.470,16,59,.271,603,1259,.479,.476,320,385,.831,72,160,232,463,59,16,234,173,1574
269,Isiah Thomas*\thomais01,PG,26,DET,81,81,2927,621,1341,.463,30,97,.309,591,1244,.475,.474,305,394,.774,64,214,278,678,141,17,273,217,1577
270,Bernard Thompson\thompbe01,SF,25,PHO,37,7,566,74,159,.465,0,2,.000,74,157,.471,.465,43,60,.717,40,36,76,51,21,1,21,75,191
271,Billy Thompson\thompbi01,SF,24,LAL,9,0,38,3,13,.231,0,0,,3,13,.231,.231,8,10,.800,2,7,9,1,1,0,6,11,14
272,LaSalle Thompson\thompla01,C,26,SAC,69,9,1257,215,456,.471,2,5,.400,213,451,.472,.474,118,164,.720,138,289,427,68,54,73,109,217,550
273,Mychal Thompson\thompmy01,C,33,LAL,80,0,2007,370,722,.512,0,3,.000,370,719,.515,.512,185,292,.634,198,291,489,66,38,79,113,251,925
274,Bob Thornton\thornbo01,PF,25,TOT,48,2,593,65,130,.500,0,2,.000,65,128,.508,.500,34,55,.618,46,66,112,15,11,3,35,103,164
275,Otis Thorpe\thorpot01,PF,25,SAC,82,82,3072,622,1226,.507,0,6,.000,622,1220,.510,.507,460,609,.755,279,558,837,266,62,56,228,264,1704
276,Sedale Threatt\threase01,PG,26,TOT,71,0,1055,216,425,.508,3,27,.111,213,398,.535,.512,57,71,.803,23,65,88,160,60,8,63,100,492
277,Wayman Tisdale\tisdawa01,PF,23,IND,79,57,2378,511,998,.512,0,2,.000,511,996,.513,.512,246,314,.783,168,323,491,103,54,34,145,274,1268
278,Ray Tolbert\tolbera01,PF,29,TOT,25,0,259,35,69,.507,0,0,,35,69,.507,.507,19,30,.633,23,32,55,10,8,5,21,39,89
279,Andrew Toney\toneyan01,SG,30,PHI,29,15,522,72,171,.421,9,27,.333,63,144,.438,.447,58,72,.806,8,39,47,108,11,6,50,35,211
280,Sedric Toney\toneyse01,PG,25,NYK,21,0,139,21,48,.438,5,14,.357,16,34,.471,.490,10,11,.909,3,5,8,24,9,1,12,20,57
281,Kelly Tripucka\tripuke01,SF,28,UTA,49,21,976,139,303,.459,31,74,.419,108,229,.472,.510,59,68,.868,30,87,117,105,34,4,68,68,368
282,Trent Tucker\tucketr01,SG,28,NYK,71,4,1248,193,455,.424,69,167,.413,124,288,.431,.500,51,71,.718,32,87,119,117,53,6,47,158,506
283,Andre Turner\turnean01,PG,23,HOU,12,0,99,12,34,.353,1,7,.143,11,27,.407,.368,10,14,.714,4,4,8,23,7,1,12,13,35
284,Elston Turner\turneel01,SF,28,CHI,17,0,98,8,30,.267,0,0,,8,30,.267,.267,1,2,.500,8,2,10,9,8,0,10,5,17
285,Melvin Turpin\turpime01,C,27,UTA,79,0,1011,199,389,.512,1,3,.333,198,386,.513,.513,71,98,.724,88,148,236,32,26,68,71,157,470
286,Terry Tyler\tylerte01,SF,31,SAC,74,28,1185,184,407,.452,1,7,.143,183,400,.458,.453,41,64,.641,87,155,242,56,43,47,43,85,410
287,Darnell Valentine\valenda01,PG,28,LAC,79,31,1636,223,533,.418,15,33,.455,208,500,.416,.432,101,136,.743,37,119,156,382,122,8,148,135,562
288,Kiki Vandeweghe\vandeki01,SF,29,POR,37,7,1038,283,557,.508,22,58,.379,261,499,.523,.528,159,181,.878,36,73,109,71,21,7,48,68,747
289,Jay Vincent\vinceja01,SF,28,DEN,73,8,1755,446,958,.466,1,4,.250,445,954,.466,.466,231,287,.805,80,229,309,143,46,26,137,198,1124
290,Sam Vincent\vincesa01,PG,24,TOT,72,27,1501,210,461,.456,8,21,.381,202,440,.459,.464,145,167,.868,35,117,152,381,55,16,136,145,573
291,Danny Vranes\vraneda01,SF,29,PHI,57,5,772,53,121,.438,0,3,.000,53,118,.449,.438,15,35,.429,45,72,117,36,27,33,25,100,121
292,Mark Wade\wadema01,PG,22,GSW,11,0,123,3,20,.150,0,2,.000,3,18,.167,.150,2,4,.500,3,12,15,34,7,1,13,13,8
293,Milt Wagner\wagnemi01,SG,24,LAL,40,4,380,62,147,.422,2,10,.200,60,137,.438,.429,26,29,.897,4,24,28,61,6,4,22,42,152
294,Granville Waiters\waitegr01,C,27,CHI,22,0,114,9,29,.310,0,1,.000,9,28,.321,.310,0,2,.000,9,19,28,1,2,15,6,26,18
295,Darrell Walker\walkeda01,SG,26,WSB,52,0,940,114,291,.392,0,6,.000,114,285,.400,.392,82,105,.781,43,84,127,100,62,10,69,105,310
296,Kenny Walker\walkeke01,SF,23,NYK,82,61,2139,344,728,.473,0,1,.000,344,727,.473,.473,138,178,.775,192,197,389,86,63,59,83,290,826
297,Jamie Waller\walleja01,SG,23,NJN,9,0,91,16,40,.400,0,2,.000,16,38,.421,.400,10,18,.556,9,4,13,3,4,1,11,13,42
298,Chris Washburn\washbch01,C,22,TOT,37,0,260,36,81,.444,0,0,,36,81,.444,.444,18,31,.581,28,47,75,6,5,8,17,29,90
299,Duane Washington\washidu01,SG,23,NJN,15,0,156,18,42,.429,2,4,.500,16,38,.421,.452,16,20,.800,5,17,22,34,12,0,9,23,54
300,Kermit Washington\washike01,PF,36,GSW,6,1,56,7,14,.500,0,0,,7,14,.500,.500,2,2,1.000,9,10,19,0,4,4,4,13,16
301,Pearl Washington\washipe01,PG,24,NJN,68,10,1379,245,547,.448,11,49,.224,234,498,.470,.458,132,189,.698,54,64,118,206,91,4,141,163,633
302,Spud Webb\webbsp01,PG,24,ATL,82,1,1347,191,402,.475,1,19,.053,190,383,.496,.476,107,131,.817,16,130,146,337,63,12,131,125,490
303,Chris Welp\welpch01,C,24,PHI,10,0,132,18,31,.581,0,0,,18,31,.581,.581,12,18,.667,11,13,24,5,5,5,9,25,48
304,Bill Wennington\wennibi01,C,24,DAL,30,0,125,25,49,.510,1,2,.500,24,47,.511,.520,12,19,.632,14,25,39,4,5,9,9,33,63
305,Mark West\westma01,C,27,TOT,83,41,2098,316,573,.551,0,1,.000,316,572,.552,.551,170,285,.596,165,358,523,74,47,147,173,265,802
306,Ennis Whatley\whatlen01,PG,25,ATL,5,0,24,4,9,.444,0,0,,4,9,.444,.444,3,4,.750,0,4,4,2,2,0,4,3,11
307,Clinton Wheeler\wheelcl01,PG,28,IND,59,0,513,62,132,.470,0,0,,62,132,.470,.470,25,34,.735,19,21,40,103,36,2,52,37,149
308,Eric White\whiteer01,SF,22,LAC,17,4,352,66,124,.532,1,1,1.000,65,123,.528,.536,45,57,.789,31,31,62,9,7,3,21,32,178
309,Tony White\whiteto01,PG,22,TOT,49,0,581,111,249,.446,0,6,.000,111,243,.457,.446,39,54,.722,12,19,31,59,20,2,47,57,261
310,Jerome Whitehead\whiteje01,C,31,GSW,72,27,1221,174,360,.483,0,0,,174,360,.483,.483,59,82,.720,109,212,321,39,32,21,49,209,407
311,Dominique Wilkins*\wilkido01,SF,28,ATL,78,76,2948,909,1957,.464,38,129,.295,871,1828,.476,.474,541,655,.826,211,291,502,224,103,47,218,162,2397
312,Gerald Wilkins\wilkige01,SG,24,NYK,81,78,2703,591,1324,.446,39,129,.302,552,1195,.462,.461,191,243,.786,106,164,270,326,90,22,212,183,1412
313,Buck Williams\willibu01,PF,27,NJN,70,70,2637,466,832,.560,1,1,1.000,465,831,.560,.561,346,518,.668,298,536,834,109,68,44,189,266,1279
314,Herb Williams\willihe01,C,29,IND,75,37,1966,311,732,.425,0,6,.000,311,726,.428,.425,126,171,.737,116,353,469,98,37,146,119,244,748
315,Hot Rod Williams\williho01,PF,25,CLE,77,50,2106,316,663,.477,0,1,.000,316,662,.477,.477,211,279,.756,159,347,506,103,61,145,104,203,843
316,John Williams\willijo02,SF,21,WSB,82,37,2428,427,910,.469,5,38,.132,422,872,.484,.472,188,256,.734,127,317,444,232,117,34,145,217,1047
317,Kevin Williams\willike01,SG,26,SEA,80,9,1084,199,450,.442,1,7,.143,198,443,.447,.443,103,122,.844,61,66,127,96,62,7,68,207,502
318,Reggie Williams\willire01,SF,23,LAC,35,14,857,152,427,.356,13,58,.224,139,369,.377,.371,48,66,.727,55,63,118,58,29,21,63,108,365
319,Kevin Willis\willike02,PF,25,ATL,75,55,2091,356,687,.518,0,2,.000,356,685,.520,.518,159,245,.649,235,312,547,28,68,41,138,240,871
320,Nikita Wilson\wilsoni01,SF,23,POR,15,0,54,7,23,.304,0,0,,7,23,.304,.304,5,6,.833,2,9,11,3,0,0,5,7,19
321,Ricky Wilson\wilsori02,PG,23,TOT,24,1,420,43,110,.391,10,26,.385,33,84,.393,.436,29,40,.725,2,25,27,69,23,3,25,40,125
322,David Wingate\wingada01,SG,24,PHI,61,22,1419,218,545,.400,10,40,.250,208,505,.412,.409,99,132,.750,44,57,101,119,47,22,104,125,545
323,Rickie Winslow\winslri01,SF,23,MIL,7,0,45,3,13,.231,0,1,.000,3,12,.250,.231,1,2,.500,3,4,7,2,1,0,4,9,7
324,Randy Wittman\wittmra01,SG,28,ATL,82,82,2412,376,787,.478,0,0,,376,787,.478,.478,71,89,.798,39,131,170,302,50,18,82,117,823
325,Joe Wolf\wolfjo01,C,23,LAC,42,26,1137,136,334,.407,3,15,.200,133,319,.417,.412,45,54,.833,51,136,187,98,38,16,76,139,320
326,Leon Wood\woodle01,PG,25,TOT,52,8,909,136,312,.436,52,127,.409,84,185,.454,.519,76,99,.768,17,40,57,174,26,1,39,50,400
327,Mike Woodson\woodsmi01,SG,29,LAC,80,77,2534,562,1263,.445,18,78,.231,544,1185,.459,.452,296,341,.868,64,126,190,273,109,26,186,210,1438
328,Orlando Woolridge\woolror01,SF,28,NJN,19,12,622,110,247,.445,0,2,.000,110,245,.449,.445,92,130,.708,31,60,91,71,13,20,48,73,312
329,James Worthy*\worthja01,SF,26,LAL,75,72,2655,617,1161,.531,2,16,.125,615,1145,.537,.532,242,304,.796,129,245,374,289,72,55,155,175,1478
330,Brad Wright\wrighbr01,PF,25,DEN,2,0,7,1,5,.200,0,0,,1,5,.200,.200,0,0,,0,1,1,0,0,0,2,3,2
331,Danny Young\youngda01,PG,25,SEA,77,0,949,89,218,.408,22,77,.286,67,141,.475,.459,43,53,.811,18,57,75,218,52,2,37,69,243
332,Phil Zevenbergen\zevenph01,C,23,SAS,8,0,58,15,27,.556,0,0,,15,27,.556,.556,0,2,.000,4,9,13,3,3,1,4,12,30