
Rk,Player,Pos,Age,Tm,G,GS,MP,FG,FGA,FG%,3P,3PA,3P%,2P,2PA,2P%,eFG%,FT,FTA,FT%,ORB,DRB,TRB,AST,STL,BLK,TOV,PF,PTS
1,Alaa Abdelnaby\abdelal01,PF,26,TOT,54,0,506,118,231,.511,0,2,.000,118,229,.515,.511,20,35,.571,37,77,114,13,15,12,45,104,256
2,Mahmoud Abdul-Rauf\abdulma02,PG,25,DEN,73,43,2082,472,1005,.470,83,215,.386,389,790,.492,.511,138,156,.885,32,105,137,263,77,9,119,126,1165
3,Michael Adams\adamsmi01,PG,32,CHH,29,0,443,67,148,.453,29,81,.358,38,67,.567,.551,25,30,.833,6,23,29,95,23,1,26,41,188
4,Rafael Addison\addisra01,SF,30,DET,79,16,1776,279,586,.476,24,83,.289,255,503,.507,.497,74,99,.747,67,175,242,109,53,25,76,236,656
5,Danny Ainge\aingeda01,SG,35,PHO,74,1,1374,194,422,.460,78,214,.364,116,208,.558,.552,105,130,.808,25,84,109,210,46,7,79,155,571
6,Victor Alexander\alexavi01,C,25,GSW,50,29,1237,230,447,.515,6,25,.240,224,422,.531,.521,36,60,.600,87,204,291,60,28,29,76,145,502
7,Derrick Alston\alstode01,C,22,PHI,64,1,1032,120,258,.465,0,4,.000,120,254,.472,.465,59,120,.492,98,121,219,33,39,35,53,107,299
8,Greg Anderson\andergr01,PF,30,ATL,51,0,622,57,104,.548,0,0,,57,104,.548,.548,34,71,.479,62,126,188,17,23,32,32,103,148
9,Kenny Anderson\anderke01,PG,24,NJN,72,70,2689,411,1031,.399,97,294,.330,314,737,.426,.446,348,414,.841,73,177,250,680,103,14,225,184,1267
10,Nick Anderson\anderni01,SG,27,ORL,76,76,2588,439,923,.476,179,431,.415,260,492,.528,.573,143,203,.704,85,250,335,314,125,22,141,124,1200
11,Willie Anderson\anderwi01,SG,28,SAS,38,11,556,76,162,.469,3,19,.158,73,143,.510,.478,30,41,.732,15,40,55,52,26,10,38,71,185
12,Greg Anthony\anthogr01,PG,27,NYK,61,2,943,128,293,.437,56,155,.361,72,138,.522,.532,60,76,.789,7,57,64,160,50,7,57,99,372
13,B.J. Armstrong\armstbj01,PG,27,CHI,82,82,2577,418,894,.468,108,253,.427,310,641,.484,.528,206,233,.884,25,161,186,244,84,8,103,159,1150
14,Darrell Armstrong\armstda01,PG,26,ORL,3,0,8,3,8,.375,2,6,.333,1,2,.500,.500,2,2,1.000,1,0,1,3,1,0,1,3,10
15,Vincent Askew\askewvi01,SG,28,SEA,71,1,1721,248,504,.492,31,94,.330,217,410,.529,.523,176,238,.739,65,116,181,176,49,13,85,191,703
16,Keith Askins\askinke01,SF,27,MIA,50,5,854,81,207,.391,21,78,.269,60,129,.465,.442,46,57,.807,86,112,198,39,35,17,25,109,229
17,Stacey Augmon\augmost01,SG,26,ATL,76,76,2362,397,876,.453,7,26,.269,390,850,.459,.457,252,346,.728,157,211,368,197,100,47,152,163,1053
18,Anthony Avent\aventan01,PF,25,ORL,71,3,1066,105,244,.430,0,0,,105,244,.430,.430,48,75,.640,97,196,293,41,28,50,53,170,258
19,Vin Baker\bakervi01,PF,23,MIL,82,82,3361,594,1229,.483,7,24,.292,587,1205,.487,.486,256,432,.593,289,557,846,296,86,116,221,277,1451
20,Charles Barkley*\barklch01,PF,31,PHO,68,66,2382,554,1141,.486,74,219,.338,480,922,.521,.518,379,507,.748,203,553,756,276,110,45,150,201,1561
21,Dana Barros\barroda01,PG,27,PHI,82,82,3318,571,1165,.490,197,425,.464,374,740,.505,.575,347,386,.899,27,247,274,619,149,4,242,159,1686
22,Jon Barry\barryjo01,SG,25,MIL,52,0,602,57,134,.425,16,48,.333,41,86,.477,.485,61,80,.763,15,34,49,85,30,4,41,54,191
23,John Battle\battljo01,SG,32,CLE,28,0,280,43,114,.377,11,31,.355,32,83,.386,.425,19,26,.731,3,8,11,37,8,1,17,28,116
24,Sergei Bazarevich\bazarse01,PG,29,ATL,10,0,74,11,22,.500,1,6,.167,10,16,.625,.523,7,9,.778,1,6,7,14,1,1,7,10,30
25,Benoit Benjamin\benjabe01,C,30,NJN,61,57,1598,271,531,.510,0,0,,271,531,.510,.510,133,175,.760,94,346,440,38,23,64,125,151,675
26,Elmer Bennett\benneel01,PG,24,CLE,4,0,18,6,11,.545,0,2,.000,6,9,.667,.545,3,4,.750,0,1,1,3,4,0,3,3,15
27,Tony Bennett\benneto01,PG,25,CHH,3,0,46,6,13,.462,2,9,.222,4,4,1.000,.538,0,0,,0,2,2,4,0,0,3,6,14
28,David Benoit\benoida01,SF,26,UTA,71,67,1841,285,587,.486,38,115,.330,247,472,.523,.518,132,157,.841,96,272,368,58,45,47,75,183,740
29,James Blackwell\blackja01,PG,26,TOT,13,0,80,8,13,.615,0,0,,8,13,.615,.615,2,3,.667,2,9,11,11,4,0,5,8,18
30,Mookie Blaylock\blaylmo01,PG,27,ATL,80,80,3069,509,1198,.425,199,555,.359,310,643,.482,.508,156,214,.729,117,276,393,616,200,26,242,164,1373
31,Corie Blount\blounco01,PF,26,CHI,68,9,889,100,210,.476,0,2,.000,100,208,.481,.476,38,67,.567,107,133,240,60,26,33,59,146,238
32,Muggsy Bogues\boguemu01,PG,30,CHH,78,78,2629,348,730,.477,6,30,.200,342,700,.489,.481,160,180,.889,51,206,257,675,103,0,132,151,862
33,Manute Bol\bolma01,C,32,GSW,5,2,81,6,10,.600,3,5,.600,3,5,.600,.750,0,0,,1,11,12,0,0,9,1,10,15
34,Walter Bond\bondwa01,SG,25,TOT,23,0,290,39,84,.464,15,41,.366,24,43,.558,.554,14,20,.700,8,24,32,24,6,4,17,47,107
35,Anthony Bonner\bonnean01,PF,26,NYK,58,23,1126,88,193,.456,1,5,.200,87,188,.463,.459,44,67,.657,113,149,262,80,48,23,79,159,221
36,Anthony Bowie\bowiean01,SG,31,ORL,77,4,1261,177,369,.480,12,40,.300,165,329,.502,.496,61,73,.836,54,85,139,159,47,21,86,138,427
37,Sam Bowie\bowiesa01,C,33,LAL,67,10,1225,118,267,.442,2,11,.182,116,256,.453,.446,68,89,.764,72,216,288,118,21,80,91,182,306
38,Shawn Bradley\bradlsh01,C,22,PHI,82,59,2365,315,693,.455,0,3,.000,315,690,.457,.455,148,232,.638,243,416,659,53,54,274,142,338,778
39,Terrell Brandon\brandte01,PG,24,CLE,67,41,1961,341,762,.448,48,121,.397,293,641,.457,.479,159,186,.855,35,151,186,363,107,14,144,118,889
40,Tim Breaux\breauti01,SF,24,HOU,42,2,340,45,121,.372,6,25,.240,39,96,.406,.397,32,49,.653,16,18,34,15,11,4,16,25,128
41,Scott Brooks\brooksc01,PG,29,TOT,59,0,808,126,275,.458,25,69,.362,101,206,.490,.504,64,79,.810,14,52,66,116,34,4,47,56,341
42,Chucky Brown\brownch01,SF,26,HOU,41,14,814,105,174,.603,1,3,.333,104,171,.608,.606,38,62,.613,64,125,189,30,11,14,29,105,249
43,Dee Brown\brownde01,SG,26,BOS,79,69,2792,437,977,.447,126,327,.385,311,650,.478,.512,236,277,.852,63,186,249,301,110,49,146,181,1236
44,Mike Brown\brownmi01,C,31,MIN,27,0,213,10,40,.250,0,1,.000,10,39,.256,.250,15,27,.556,9,36,45,10,7,0,16,35,35
45,P.J. Brown\brownpj01,C,25,NJN,80,63,2466,254,570,.446,4,24,.167,250,546,.458,.449,139,207,.671,178,309,487,135,69,135,80,262,651
46,Randy Brown\brownra02,PG,26,SAC,67,2,1086,124,287,.432,14,47,.298,110,240,.458,.456,55,82,.671,24,84,108,133,99,19,78,153,317
47,Mark Bryant\bryanma01,PF,29,POR,49,0,658,101,192,.526,1,2,.500,100,190,.526,.529,41,63,.651,55,106,161,28,19,16,39,109,244
48,Jud Buechler\buechju01,SF,26,CHI,57,0,605,90,183,.492,15,48,.313,75,135,.556,.533,22,39,.564,36,62,98,50,24,12,30,64,217
49,Scott Burrell\burresc01,SF,24,CHH,65,62,2014,277,593,.467,96,235,.409,181,358,.506,.548,100,144,.694,96,272,368,161,75,40,85,187,750
50,Willie Burton\burtowi01,SF,26,PHI,53,31,1564,243,606,.401,106,275,.385,137,331,.414,.488,220,267,.824,49,115,164,96,32,19,122,167,812
51,Mitchell Butler\butlemi02,SG,24,WSB,76,5,1554,214,508,.421,46,141,.326,168,367,.458,.467,123,185,.665,43,127,170,91,61,10,106,155,597
52,Michael Cage\cagemi01,C,33,CLE,82,21,2040,177,340,.521,0,2,.000,177,338,.524,.521,53,88,.602,203,361,564,56,61,67,56,149,407
53,Adrian Caldwell\caldwad01,PF,28,HOU,7,0,30,1,4,.250,0,0,,1,4,.250,.250,3,6,.500,1,9,10,0,1,0,1,6,5
54,Elden Campbell\campbel01,PF,26,LAL,73,59,2076,360,785,.459,0,1,.000,360,784,.459,.459,193,290,.666,168,277,445,92,69,132,98,246,913
55,Tony Campbell\campbto01,SF,32,CLE,78,0,1128,161,392,.411,15,42,.357,146,350,.417,.430,132,159,.830,60,93,153,69,32,8,65,122,469
56,Antoine Carr\carran01,C,33,UTA,78,4,1677,290,546,.531,1,4,.250,289,542,.533,.532,165,201,.821,81,184,265,67,24,68,87,253,746
57,Bill Cartwright\cartwbi01,C,37,SEA,29,19,430,27,69,.391,0,0,,27,69,.391,.391,15,24,.625,25,62,87,10,6,3,18,70,69
58,Sam Cassell\cassesa01,PG,25,HOU,82,1,1882,253,593,.427,63,191,.330,190,402,.473,.480,214,254,.843,38,173,211,405,94,14,167,209,783
59,Duane Causwell\causwdu01,C,26,SAC,58,24,820,76,147,.517,0,1,.000,76,146,.521,.517,57,98,.582,57,117,174,15,14,80,33,146,209
60,Cedric Ceballos\cebalce01,SF,25,LAL,58,54,2029,497,977,.509,58,146,.397,439,831,.528,.538,209,292,.716,169,295,464,105,60,19,143,131,1261
61,Tom Chambers\chambto01,PF,35,UTA,81,4,1240,195,427,.457,4,24,.167,191,403,.474,.461,109,135,.807,66,147,213,73,25,30,52,173,503
62,Rex Chapman\chapmre01,SG,27,WSB,45,29,1468,254,639,.397,86,274,.314,168,365,.460,.465,137,159,.862,23,90,113,128,67,15,62,85,731
63,Calbert Cheaney\cheanca01,SG,23,WSB,78,71,2651,512,1129,.453,96,283,.339,416,846,.492,.496,173,213,.812,105,216,321,177,80,21,151,215,1293
64,Pete Chilcutt\chilcpe01,PF,26,HOU,68,17,1347,146,328,.445,35,86,.407,111,242,.459,.498,31,42,.738,106,211,317,66,25,43,61,117,358
65,Chris Childs\childch01,PG,27,NJN,53,11,1021,106,279,.380,41,125,.328,65,154,.422,.453,55,73,.753,14,55,69,219,42,3,76,116,308
66,Doug Christie\chrisdo01,SG,24,NYK,12,0,79,5,22,.227,1,7,.143,4,15,.267,.250,4,5,.800,3,10,13,8,2,1,13,18,15
67,Derrick Coleman\colemde01,PF,27,NJN,56,54,2103,371,875,.424,28,120,.233,343,755,.454,.440,376,490,.767,167,424,591,187,35,94,172,162,1146
68,Bimbo Coles\colesbi01,PG,26,MIA,68,65,2207,261,607,.430,16,76,.211,245,531,.461,.443,141,174,.810,46,145,191,416,99,13,156,185,679
69,Steve Colter\coltest01,PG,32,CLE,57,7,752,67,169,.396,8,35,.229,59,134,.440,.420,54,71,.761,13,46,59,101,30,6,36,53,196
70,Marty Conlon\conloma01,C,27,MIL,82,3,2064,344,647,.532,8,29,.276,336,618,.544,.538,119,194,.613,160,266,426,110,42,18,123,218,815
71,Lester Conner\connele01,SG,35,LAL,2,0,5,0,0,,0,0,,0,0,,,2,2,1.000,0,0,0,0,1,0,0,3,2
72,Tyrone Corbin\corbity01,SF,32,ATL,81,4,1389,205,464,.442,14,56,.250,191,408,.468,.457,78,114,.684,98,164,262,67,55,16,74,161,502
73,John Crotty\crottjo01,PG,25,UTA,80,0,1019,93,231,.403,11,36,.306,82,195,.421,.426,98,121,.810,27,70,97,205,39,6,70,105,295
74,Corey Crowder\crowdco01,SF,25,SAS,7,0,29,2,10,.200,0,4,.000,2,6,.333,.200,2,6,.333,1,2,3,1,1,0,2,1,6
75,Terry Cummings\cummite01,PF,33,SAS,76,20,1273,224,464,.483,0,0,,224,464,.483,.483,72,123,.585,138,240,378,59,36,19,95,188,520
76,Bill Curley\curlebi01,PF,22,DET,53,1,595,58,134,.433,0,0,,58,134,.433,.433,27,36,.750,54,70,124,25,21,21,25,128,143
77,Dell Curry\curryde01,SG,30,CHH,69,0,1718,343,778,.441,154,361,.427,189,417,.453,.540,95,111,.856,41,127,168,113,55,18,98,144,935
78,Lloyd Daniels\daniell01,SG,27,TOT,30,14,604,80,209,.383,26,100,.260,54,109,.495,.445,22,27,.815,29,34,63,40,22,10,31,48,208
79,Yinka Dare\dareyi01,C,22,NJN,1,0,3,0,1,.000,0,0,,0,1,.000,.000,0,0,,0,1,1,0,0,0,1,2,0
80,Antonio Davis\davisan01,PF,26,IND,44,1,1030,109,245,.445,0,0,,109,245,.445,.445,117,174,.672,105,175,280,25,19,29,64,134,335
81,Dale Davis\davisda01,PF,25,IND,74,70,2346,324,576,.563,0,1,.000,324,575,.563,.563,138,259,.533,259,437,696,58,72,116,124,222,786
82,Hubert Davis\davishu01,SG,24,NYK,82,4,1697,296,617,.480,131,288,.455,165,329,.502,.586,97,120,.808,30,80,110,150,35,11,87,146,820
83,Terry Davis\daviste01,PF,27,DAL,46,2,580,49,113,.434,0,2,.000,49,111,.441,.434,42,66,.636,63,93,156,10,6,3,30,76,140
84,Johnny Dawkins\dawkijo01,PG,31,DET,50,9,1170,125,270,.463,25,73,.342,100,197,.508,.509,50,55,.909,28,85,113,205,52,1,86,74,325
85,Tony Dawson\dawsoto01,SF,27,BOS,2,0,13,3,8,.375,1,3,.333,2,5,.400,.438,1,1,1.000,0,3,3,1,0,0,2,4,8
86,Todd Day\dayto01,SG,25,MIL,82,81,2717,445,1049,.424,163,418,.390,282,631,.447,.502,257,341,.754,95,227,322,134,104,63,157,283,1310
87,Terry Dehere\deherte01,PG,23,LAC,80,28,1774,279,685,.407,48,163,.294,231,522,.443,.442,229,292,.784,35,117,152,225,45,7,157,200,835
88,Vinny Del Negro\delnevi01,SG,28,SAS,75,71,2360,372,766,.486,66,162,.407,306,604,.507,.529,128,162,.790,28,164,192,226,61,14,56,179,938
89,Bison Dele\delebi01,C,25,DEN,63,10,1261,196,333,.589,0,0,,196,333,.589,.589,106,162,.654,98,200,298,53,38,43,114,210,498
90,Vlade Divac\divacvl01,C,26,LAL,80,80,2807,485,957,.507,10,53,.189,475,904,.525,.512,297,382,.777,261,568,829,329,109,174,205,305,1277
91,James Donaldson\donalja01,C,37,UTA,43,40,613,44,74,.595,0,0,,44,74,.595,.595,22,31,.710,19,88,107,14,6,28,22,66,110
92,Sherman Douglas\douglsh01,PG,28,BOS,65,43,2048,365,769,.475,20,82,.244,345,687,.502,.488,204,296,.689,48,122,170,446,80,2,162,152,954
93,Greg Dreiling\dreilgr01,C,32,CLE,58,3,483,42,102,.412,0,0,,42,102,.412,.412,26,41,.634,32,84,116,22,6,22,25,108,110
94,Clyde Drexler*\drexlcl01,SG,32,TOT,76,75,2728,571,1238,.461,147,408,.360,424,830,.511,.521,364,442,.824,152,328,480,362,136,45,186,206,1653
95,Kevin Duckworth\duckwke01,C,30,WSB,40,22,818,118,267,.442,2,10,.200,116,257,.451,.446,45,70,.643,65,130,195,20,21,24,59,110,283
96,Chris Dudley\dudlech02,C,29,POR,82,82,2245,181,446,.406,0,1,.000,181,445,.407,.406,85,183,.464,325,439,764,34,43,126,81,286,447
97,Joe Dumars*\dumarjo01,SG,31,DET,67,67,2544,417,970,.430,103,338,.305,314,632,.497,.483,277,344,.805,47,111,158,368,72,7,219,153,1214
98,Richard Dumas\dumasri02,SF,25,PHO,15,1,167,37,73,.507,0,1,.000,37,72,.514,.507,8,16,.500,18,11,29,7,10,2,9,22,82
99,Tony Dumas\dumasto01,SG,22,DAL,58,0,613,96,250,.384,22,73,.301,74,177,.418,.428,50,77,.649,32,30,62,57,13,4,50,78,264
100,Pat Durham\durhapa01,SF,27,MIN,59,2,852,117,237,.494,5,26,.192,112,211,.531,.504,63,96,.656,37,57,94,53,36,32,45,114,302
101,Ledell Eackles\eacklle01,SG,28,MIA,54,6,898,143,326,.439,18,41,.439,125,285,.439,.466,91,126,.722,33,62,95,72,19,2,53,88,395
102,Acie Earl\earlac01,C,24,BOS,30,3,208,26,68,.382,0,0,,26,68,.382,.382,14,29,.483,19,26,45,2,6,8,14,39,66
103,Blue Edwards\edwarbl01,SF,29,TOT,67,7,1112,181,393,.461,22,75,.293,159,318,.500,.489,75,90,.833,50,80,130,77,43,16,81,143,459
104,Doug Edwards\edwardo01,PF,24,ATL,38,0,212,22,48,.458,0,1,.000,22,47,.468,.458,23,32,.719,19,29,48,13,5,4,22,30,67
105,James Edwards\edwarja01,C,39,POR,28,0,266,32,83,.386,0,0,,32,83,.386,.386,11,17,.647,10,33,43,8,5,8,14,44,75
106,Kevin Edwards\edwarke01,SG,29,NJN,14,14,466,69,154,.448,18,45,.400,51,109,.468,.506,40,42,.952,10,27,37,27,19,5,35,42,196
107,Craig Ehlo\ehlocr01,SG,33,ATL,49,0,1166,191,422,.453,51,134,.381,140,288,.486,.513,44,71,.620,55,92,147,113,46,6,73,86,477
108,Howard Eisley\eisleho01,PG,22,TOT,49,4,552,40,122,.328,9,37,.243,31,85,.365,.365,31,40,.775,12,36,48,95,18,6,50,81,120
109,Mario Elie\eliema01,SF,31,HOU,81,13,1896,243,487,.499,80,201,.398,163,286,.570,.581,144,171,.842,50,146,196,189,65,12,104,158,710
110,Sean Elliott\elliose01,SF,26,SAS,81,81,2858,502,1072,.468,136,333,.408,366,739,.495,.532,326,404,.807,63,224,287,206,78,38,151,216,1466
111,Dale Ellis\ellisda01,SF,34,DEN,81,3,1996,351,774,.453,106,263,.403,245,511,.479,.522,110,127,.866,56,166,222,57,37,9,81,142,918
112,Harold Ellis\ellisha01,SF,24,LAC,69,7,656,91,189,.481,1,13,.077,90,176,.511,.484,69,117,.590,56,32,88,40,67,12,49,102,252
113,LaPhonso Ellis\ellisla01,PF,24,DEN,6,0,58,9,25,.360,0,0,,9,25,.360,.360,6,6,1.000,7,10,17,4,1,5,5,12,24
114,Pervis Ellison\ellispe01,C,27,BOS,55,11,1083,152,300,.507,0,2,.000,152,298,.510,.507,71,99,.717,124,185,309,34,22,54,76,179,375
115,Jo Jo English\englijo01,SG,24,CHI,8,0,127,15,39,.385,3,12,.250,12,27,.444,.423,10,13,.769,1,2,3,7,7,1,6,19,43
116,Patrick Ewing*\ewingpa01,C,32,NYK,79,79,2920,730,1452,.503,6,21,.286,724,1431,.506,.505,420,560,.750,157,710,867,212,68,159,256,272,1886
117,Duane Ferrell\ferredu01,SF,29,IND,56,1,607,83,173,.480,1,6,.167,82,167,.491,.483,64,85,.753,50,38,88,31,26,6,43,79,231
118,Danny Ferry\ferryda01,PF,28,CLE,82,6,1290,223,500,.446,94,233,.403,129,267,.483,.540,74,84,.881,30,113,143,96,27,22,59,131,614
119,Matt Fish\fishma01,C,25,LAC,26,8,370,49,103,.476,0,1,.000,49,102,.480,.476,25,37,.676,32,52,84,17,16,7,28,70,123
120,Vern Fleming\flemive01,PG,32,IND,55,1,686,93,188,.495,0,7,.000,93,181,.514,.495,65,90,.722,20,68,88,109,27,1,43,80,251
121,Sleepy Floyd\floydsl01,SG,34,NJN,48,1,831,71,212,.335,25,88,.284,46,124,.371,.394,30,43,.698,8,46,54,126,13,6,51,73,197
122,Alphonso Ford\fordal01,SG,23,PHI,5,0,98,9,39,.231,0,9,.000,9,30,.300,.231,1,2,.500,8,12,20,9,1,0,8,5,19
123,Greg Foster\fostegr01,PF,26,TOT,78,3,1144,150,318,.472,7,23,.304,143,295,.485,.483,78,111,.703,85,174,259,39,15,28,71,183,385
124,Rick Fox\foxri01,SF,25,BOS,53,7,1039,169,351,.481,31,75,.413,138,276,.500,.526,95,123,.772,61,94,155,139,52,19,78,154,464
125,Corey Gaines\gaineco01,SG,29,PHI,11,8,280,24,51,.471,2,15,.133,22,36,.611,.490,5,11,.455,1,17,18,33,8,1,14,23,55
126,Kevin Gamble\gamblke01,SF,29,MIA,77,0,1223,220,450,.489,39,98,.398,181,352,.514,.532,87,111,.784,29,93,122,119,52,10,49,130,566
127,Winston Garland\garlawi01,PG,30,MIN,73,58,1931,170,410,.415,19,75,.253,151,335,.451,.438,89,112,.795,48,120,168,318,71,13,105,184,448
128,Chris Gatling\gatlich01,PF,27,GSW,58,22,1470,324,512,.633,0,1,.000,324,511,.634,.633,148,250,.592,144,299,443,51,39,52,117,184,796
129,Kenny Gattison\gattike01,PF,30,CHH,21,0,409,47,100,.470,0,1,.000,47,99,.475,.470,31,51,.608,21,54,75,17,7,15,22,64,125
130,Matt Geiger\geigema01,C,25,MIA,74,43,1712,260,485,.536,4,10,.400,256,475,.539,.540,93,143,.650,146,267,413,55,41,51,113,245,617
131,Tate George\georgta01,SG,26,MIL,3,0,8,1,3,.333,0,1,.000,1,2,.500,.333,2,2,1.000,1,0,1,0,0,0,2,1,4
132,Kendall Gill\gillke01,SG,26,SEA,73,58,2125,392,858,.457,63,171,.368,329,687,.479,.494,155,209,.742,99,191,290,192,117,28,138,186,1002
133,Armen Gilliam\gilliar01,PF,30,NJN,82,30,2472,455,905,.503,0,2,.000,455,903,.504,.503,302,392,.770,192,421,613,99,67,89,152,171,1212
134,Greg Graham\grahagr01,SG,24,PHI,50,7,775,95,223,.426,6,28,.214,89,195,.456,.439,55,73,.753,19,43,62,66,29,6,48,76,251
135,Ron Grandison\grandro01,PF,30,NYK,2,0,8,1,4,.250,0,0,,1,4,.250,.250,0,0,,3,2,5,2,0,0,0,2,2
136,Brian Grant\grantbr01,PF,22,SAC,80,59,2289,413,809,.511,1,4,.250,412,805,.512,.511,231,363,.636,207,391,598,99,49,116,163,276,1058
137,Gary Grant\grantga01,PG,29,LAC,33,2,470,78,166,.470,4,16,.250,74,150,.493,.482,45,55,.818,8,27,35,93,29,3,44,66,205
138,Greg Grant\grantgr01,PG,28,DEN,14,0,151,10,33,.303,2,7,.286,8,26,.308,.333,9,12,.750,2,7,9,43,6,2,14,20,31
139,Harvey Grant\grantha01,PF,29,POR,75,14,1771,286,621,.461,8,26,.308,278,595,.467,.467,103,146,.705,103,181,284,82,56,53,62,163,683
140,Horace Grant\grantho01,PF,29,ORL,74,74,2693,401,707,.567,0,8,.000,401,699,.574,.567,146,211,.692,223,492,715,173,76,88,85,203,948
141,Jeff Grayer\grayeje01,SG,29,PHI,47,25,1098,163,381,.428,5,15,.333,158,366,.432,.434,58,83,.699,58,91,149,74,27,4,56,80,389
142,A.C. Green\greenac01,SF,31,PHO,82,52,2687,311,617,.504,43,127,.339,268,490,.547,.539,251,343,.732,194,475,669,127,55,31,114,146,916
143,Tom Gugliotta\guglito01,PF-SF,25,TOT,77,63,2568,371,837,.443,60,186,.323,311,651,.478,.479,174,252,.690,165,407,572,279,132,62,189,203,976
144,Andres Guibert\guibean01,PF,26,MIN,17,0,167,16,47,.340,0,4,.000,16,43,.372,.340,13,19,.684,16,29,45,10,8,1,12,29,45
145,Jack Haley\haleyja01,PF,31,SAS,31,0,117,26,61,.426,0,1,.000,26,60,.433,.426,21,32,.656,8,19,27,2,3,5,13,31,73
146,Geert Hammink\hammige01,C,25,ORL,1,0,7,1,3,.333,0,0,,1,3,.333,.333,2,2,1.000,0,2,2,1,0,0,0,1,4
147,Tom Hammonds\hammoto01,PF,27,DEN,70,5,956,139,260,.535,0,1,.000,139,259,.537,.535,132,177,.746,55,167,222,36,11,14,56,132,410
148,Darrin Hancock\hancoda01,SF,23,CHH,46,7,424,68,121,.562,1,3,.333,67,118,.568,.566,16,39,.410,14,39,53,30,19,4,30,48,153
149,Anfernee Hardaway\hardaan01,PG,23,ORL,77,77,2901,585,1142,.512,87,249,.349,498,893,.558,.550,356,463,.769,139,197,336,551,130,26,258,158,1613
150,Tim Hardaway\hardati01,PG,28,GSW,62,62,2321,430,1007,.427,168,444,.378,262,563,.465,.510,219,288,.760,46,144,190,578,88,12,214,155,1247
151,Jerome Harmon\harmoje01,SG,25,PHI,10,0,158,21,53,.396,1,1,1.000,20,52,.385,.406,3,6,.500,9,14,23,12,9,0,7,12,46
152,Derek Harper\harpede01,PG,33,NYK,80,80,2716,337,756,.446,106,292,.363,231,464,.498,.516,139,192,.724,31,163,194,458,79,10,151,219,919
153,Ron Harper\harpero01,SG,31,CHI,77,53,1536,209,491,.426,31,110,.282,178,381,.467,.457,81,131,.618,51,129,180,157,97,27,100,132,530
154,Lucious Harris\harrilu01,SG,24,DAL,79,31,1695,280,610,.459,55,142,.387,225,468,.481,.504,136,170,.800,85,135,220,132,58,14,77,105,751
155,Tony Harris\harrito01,SG,27,BOS,3,0,18,3,8,.375,0,1,.000,3,7,.429,.375,8,9,.889,0,0,0,0,0,0,1,2,14
156,Antonio Harvey\harvean01,PF,24,LAL,59,8,572,77,176,.438,1,1,1.000,76,175,.434,.440,24,45,.533,39,63,102,23,15,41,25,87,179
157,Hersey Hawkins\hawkihe01,SG,28,CHH,82,82,2731,390,809,.482,131,298,.440,259,511,.507,.563,261,301,.867,60,254,314,262,122,18,150,178,1172
158,Steve Henson\hensost01,PG,26,POR,37,0,380,37,86,.430,23,52,.442,14,34,.412,.564,22,25,.880,3,23,26,85,9,0,30,52,119
159,Carl Herrera\herreca01,PF,28,HOU,61,26,1331,171,327,.523,0,2,.000,171,325,.526,.523,73,117,.624,98,180,278,44,40,38,71,136,415
160,Rod Higgins\higgiro01,SF,35,GSW,5,2,46,3,12,.250,1,6,.167,2,6,.333,.292,3,4,.750,4,3,7,3,1,1,1,7,10
161,Sean Higgins\higgise01,SF,26,NJN,57,7,735,105,273,.385,23,78,.295,82,195,.421,.427,35,40,.875,25,52,77,29,10,9,35,93,268
162,Grant Hill*\hillgr01,SF,22,DET,70,69,2678,508,1064,.477,4,27,.148,504,1037,.486,.479,374,511,.732,125,320,445,353,124,62,202,203,1394
163,Tyrone Hill\hillty01,C,26,CLE,70,67,2397,350,694,.504,0,1,.000,350,693,.505,.504,263,397,.662,269,496,765,55,55,41,151,245,963
164,Donald Hodge\hodgedo01,C,25,DAL,54,0,633,83,204,.407,4,14,.286,79,190,.416,.417,39,51,.765,40,82,122,41,10,14,39,107,209
165,Jeff Hornacek\hornaje01,SG,31,UTA,81,81,2696,482,937,.514,89,219,.406,393,718,.547,.562,284,322,.882,53,157,210,347,129,17,145,181,1337
166,Robert Horry\horryro01,PF,24,HOU,64,61,2074,240,537,.447,86,227,.379,154,310,.497,.527,86,113,.761,81,243,324,216,94,76,122,161,652
167,Allan Houston\houstal01,SG,23,DET,76,39,1996,398,859,.463,158,373,.424,240,486,.494,.555,147,171,.860,29,138,167,164,61,14,113,182,1101
168,Byron Houston\houstby01,PF,25,SEA,39,0,258,49,107,.458,6,22,.273,43,85,.506,.486,28,38,.737,20,35,55,6,13,5,20,50,132
169,Tom Hovasse\hovasto01,SF,28,ATL,2,0,4,0,1,.000,0,1,.000,0,0,,.000,0,0,,0,0,0,0,1,0,0,1,0
170,Juwan Howard\howarju01,PF,21,WSB,65,52,2348,455,931,.489,0,7,.000,455,924,.492,.489,194,292,.664,184,361,545,165,52,15,166,236,1104
171,Jay Humphries\humphja01,SG-PG,32,TOT,18,0,201,8,34,.235,2,4,.500,6,30,.200,.265,2,4,.500,4,9,13,19,9,0,17,35,20
172,Lindsey Hunter\hunteli01,PG,24,DET,42,26,944,119,318,.374,36,108,.333,83,210,.395,.431,40,55,.727,24,51,75,159,51,7,79,94,314
173,Bobby Hurley\hurlebo01,PG,23,SAC,68,6,1105,103,284,.363,21,76,.276,82,208,.394,.400,58,76,.763,14,56,70,226,29,0,110,79,285
174,Jaren Jackson\jacksja01,SG,27,PHI,21,1,257,25,68,.368,4,15,.267,21,53,.396,.397,16,24,.667,18,24,42,19,9,5,17,33,70
175,Jim Jackson\jacksji01,SG,24,DAL,51,51,1982,484,1026,.472,35,110,.318,449,916,.490,.489,306,380,.805,120,140,260,191,28,12,160,92,1309
176,Mark Jackson\jacksma01,PG,29,IND,82,67,2402,239,566,.422,27,87,.310,212,479,.443,.446,119,153,.778,73,233,306,616,105,16,210,148,624
177,Keith Jennings\jennike01,PG,26,GSW,80,24,1722,190,425,.447,75,204,.368,115,221,.520,.535,134,153,.876,26,122,148,373,95,2,120,133,589
178,Avery Johnson\johnsav01,PG,29,SAS,82,82,3011,448,863,.519,3,22,.136,445,841,.529,.521,202,295,.685,49,159,208,670,114,13,207,154,1101
179,Ervin Johnson\johnser02,C,27,SEA,64,30,907,85,192,.443,0,1,.000,85,191,.445,.443,29,46,.630,101,188,289,16,17,67,54,163,199
180,Kevin Johnson\johnske02,PG,28,PHO,47,35,1352,246,523,.470,4,26,.154,242,497,.487,.474,234,289,.810,32,83,115,360,47,18,105,88,730
181,Larry Johnson\johnsla02,PF,25,CHH,81,81,3234,585,1219,.480,81,210,.386,504,1009,.500,.513,274,354,.774,190,395,585,369,78,28,207,174,1525
182,Askia Jones\jonesas01,SG,23,MIN,11,0,139,15,44,.341,2,12,.167,13,32,.406,.364,13,16,.813,6,5,11,16,6,0,9,19,45
183,Charles Jones\jonesch01,PF,37,HOU,3,0,36,1,3,.333,0,0,,1,3,.333,.333,1,2,.500,2,5,7,0,0,1,0,8,3
184,Eddie Jones\jonesed02,SG,23,LAL,64,58,1981,342,744,.460,91,246,.370,251,498,.504,.521,122,169,.722,79,170,249,128,131,41,75,175,897
185,Popeye Jones\jonespo01,PF,24,DAL,80,80,2385,372,839,.443,1,12,.083,371,827,.449,.444,80,124,.645,329,515,844,163,35,27,124,267,825
186,Michael Jordan*\jordami01,SG,31,CHI,17,17,668,166,404,.411,16,32,.500,150,372,.403,.431,109,136,.801,25,92,117,90,30,13,35,47,457
187,Adam Keefe\keefead01,SF,24,UTA,75,0,1270,172,298,.577,0,0,,172,298,.577,.577,117,173,.676,135,192,327,30,36,25,62,141,461
188,Shawn Kemp\kempsh01,PF,25,SEA,82,79,2679,545,997,.547,2,7,.286,543,990,.548,.548,438,585,.749,318,575,893,149,102,122,259,337,1530
189,Steve Kerr\kerrst01,PG,29,CHI,82,0,1839,261,495,.527,89,170,.524,172,325,.529,.617,63,81,.778,20,99,119,151,44,3,48,114,674
190,Jerome Kersey\kerseje01,SF,32,POR,63,0,1143,203,489,.415,7,27,.259,196,462,.424,.422,95,124,.766,93,163,256,82,52,35,64,173,508
191,Randolph Keys\keysra01,SF,28,LAL,6,0,83,9,26,.346,0,9,.000,9,17,.529,.346,2,2,1.000,6,11,17,2,1,2,2,16,20
192,Jason Kidd*\kiddja01,PG,21,DAL,79,79,2668,330,857,.385,70,257,.272,260,600,.433,.426,192,275,.698,152,278,430,607,151,24,250,146,922
193,Rich King\kingri01,C,25,SEA,2,0,6,0,2,.000,0,0,,0,2,.000,.000,0,2,.000,0,0,0,0,0,0,0,1,0
194,Stacey King\kingst01,PF,28,MIN,50,10,792,99,212,.467,0,1,.000,99,211,.469,.467,68,102,.667,54,111,165,26,24,20,64,126,266
195,Greg Kite\kitegr01,C,33,TOT,11,0,77,3,17,.176,0,0,,3,17,.176,.176,2,10,.200,12,10,22,1,0,0,6,15,8
196,Joe Kleine\kleinjo01,C,33,PHO,75,42,968,119,265,.449,0,2,.000,119,263,.452,.449,42,49,.857,82,177,259,39,14,18,35,174,280
197,Negele Knight\knighne01,PG,27,TOT,47,17,708,85,214,.397,11,28,.393,74,186,.398,.423,18,25,.720,21,40,61,127,21,5,49,70,199
198,Jon Koncak\koncajo01,C,31,ATL,62,20,943,77,187,.412,12,36,.333,65,151,.430,.444,13,24,.542,23,161,184,52,36,46,20,137,179
199,Larry Krystkowiak\krystla01,PF,30,CHI,19,14,287,28,72,.389,0,0,,28,72,.389,.389,27,30,.900,19,40,59,26,9,2,25,34,83
200,Toni Kukoc\kukocto01,SF,26,CHI,81,55,2584,487,967,.504,62,198,.313,425,769,.553,.536,235,314,.748,155,285,440,372,102,16,165,163,1271
201,Christian Laettner\laettch01,C,25,MIN,81,80,2770,450,920,.489,13,40,.325,437,880,.497,.496,409,500,.818,164,449,613,234,101,87,225,302,1322
202,Andrew Lang\langan01,C,28,ATL,82,63,2340,320,677,.473,2,3,.667,318,674,.472,.474,152,188,.809,154,302,456,72,45,144,108,271,794
203,Antonio Lang\langan02,SF,22,PHO,12,0,53,4,10,.400,0,0,,4,10,.400,.400,3,4,.750,3,1,4,1,0,2,5,11,11
204,Eric Leckner\leckner01,C,28,DET,57,11,623,87,165,.527,0,2,.000,87,163,.534,.527,51,72,.708,47,127,174,14,15,15,39,122,225
205,Doug Lee\leedo01,SG,30,SAC,22,0,75,9,25,.360,7,18,.389,2,7,.286,.500,18,21,.857,0,5,5,5,6,3,5,18,43
206,Tim Legler\legleti01,SG,28,GSW,24,0,371,60,115,.522,26,50,.520,34,65,.523,.635,30,34,.882,12,28,40,27,12,1,20,33,176
207,Jim Les\lesji01,PG,31,ATL,24,0,188,11,38,.289,5,23,.217,6,15,.400,.355,23,27,.852,6,20,26,44,4,0,21,28,50
208,Cliff Levingston\levincl01,PF,34,DEN,57,0,469,55,130,.423,0,1,.000,55,129,.426,.423,19,45,.422,49,75,124,27,13,20,21,91,129
209,Alton Lister\listeal01,C,36,MIL,60,32,776,66,134,.493,0,1,.000,66,133,.496,.493,35,70,.500,67,169,236,12,16,57,38,146,167
210,Brad Lohaus\lohaubr01,PF,30,MIA,61,1,730,97,231,.420,63,155,.406,34,76,.447,.556,10,15,.667,28,74,102,43,20,25,29,85,267
211,Grant Long\longgr01,PF,28,TOT,81,79,2641,342,716,.478,11,31,.355,331,685,.483,.485,244,325,.751,191,415,606,131,109,34,155,243,939
212,Luc Longley\longllu01,C,26,CHI,55,0,1001,135,302,.447,0,2,.000,135,300,.450,.447,88,107,.822,82,181,263,73,24,45,86,177,358
213,Ryan Lorthridge\lorthry01,SG,22,GSW,37,2,672,106,223,.475,3,14,.214,103,209,.493,.482,57,88,.648,24,47,71,101,28,1,57,42,272
214,George Lynch\lynchge01,SF,24,LAL,56,15,953,138,295,.468,3,21,.143,135,274,.493,.473,62,86,.721,75,109,184,62,51,10,73,86,341
215,Don MacLean\macledo01,PF,25,WSB,39,20,1052,158,361,.438,10,40,.250,148,321,.461,.452,104,136,.765,46,119,165,51,15,3,44,97,430
216,Mark Macon\maconma01,SG,25,DET,55,6,721,101,265,.381,20,62,.323,81,203,.399,.419,54,68,.794,29,47,76,63,67,1,41,97,276
217,Gerald Madkins\madkige01,SG,25,CLE,7,0,28,2,6,.333,1,2,.500,1,4,.250,.417,3,4,.750,0,0,0,1,2,0,3,2,8
218,Rick Mahorn\mahorri01,PF,36,NJN,58,7,630,79,151,.523,1,3,.333,78,148,.527,.526,39,49,.796,45,117,162,26,11,12,34,93,198
219,Dan Majerle\majerda01,SF,29,PHO,82,46,3091,438,1031,.425,199,548,.363,239,483,.495,.521,206,282,.730,104,271,375,340,96,38,105,155,1281
220,Jeff Malone\malonje01,SG,33,PHI,19,19,660,144,284,.507,11,28,.393,133,256,.520,.526,51,59,.864,11,44,55,29,15,0,29,35,350
221,Karl Malone*\malonka01,PF,31,UTA,82,82,3126,830,1548,.536,11,41,.268,819,1507,.543,.540,516,695,.742,156,715,871,285,129,85,236,269,2187
222,Moses Malone*\malonmo01,C,39,SAS,17,0,149,13,35,.371,1,2,.500,12,33,.364,.386,22,32,.688,20,26,46,6,2,3,11,15,49
223,Danny Manning\mannida01,PF,28,PHO,46,19,1510,340,622,.547,6,21,.286,334,601,.556,.551,136,202,.673,97,179,276,154,41,57,121,176,822
224,Sarunas Marciulionis*\marcisa01,SG,30,SEA,66,4,1194,216,457,.473,35,87,.402,181,370,.489,.511,145,198,.732,17,51,68,110,72,3,98,126,612
225,Donyell Marshall\marshdo01,SF,21,TOT,72,31,2086,345,876,.394,69,243,.284,276,633,.436,.433,147,222,.662,137,268,405,105,45,88,115,157,906
226,Bob Martin\martibo01,C,25,LAC,1,0,14,1,5,.200,0,0,,1,5,.200,.200,0,0,,2,0,2,1,0,1,0,2,2
227,Darrick Martin\martida01,PG,23,MIN,34,9,803,95,233,.408,7,38,.184,88,195,.451,.423,57,65,.877,14,50,64,133,34,0,62,88,254
228,Jamal Mashburn\mashbja01,SF,22,DAL,80,80,2980,683,1566,.436,113,344,.328,570,1222,.466,.472,447,605,.739,116,215,331,298,82,8,235,190,1926
229,Anthony Mason\masonan01,PF,28,NYK,77,11,2496,287,507,.566,0,1,.000,287,506,.567,.566,191,298,.641,182,468,650,240,69,21,123,253,765
230,Tony Massenburg\masseto01,C,27,LAC,80,50,2127,282,601,.469,0,3,.000,282,598,.472,.469,177,235,.753,160,295,455,67,48,58,118,253,741
231,Vernon Maxwell\maxweve01,SG,29,HOU,64,54,2038,306,777,.394,143,441,.324,163,336,.485,.486,99,144,.688,18,146,164,274,75,13,137,157,854
232,Lee Mayberry\maybele01,PG,24,MIL,82,50,1744,172,408,.422,72,177,.407,100,231,.433,.510,58,83,.699,21,61,82,276,51,4,106,123,474
233,George McCloud\mccloge01,SF,27,DAL,42,3,802,144,328,.439,34,89,.382,110,239,.460,.491,80,96,.833,82,65,147,53,23,9,40,71,402
234,Xavier McDaniel\mcdanxa01,SF,31,BOS,68,15,1430,246,546,.451,6,21,.286,240,525,.457,.456,89,125,.712,94,206,300,108,30,20,89,146,587
235,Jim McIlvaine\mcilvji01,C,22,WSB,55,0,534,34,71,.479,0,0,,34,71,.479,.479,28,41,.683,40,65,105,10,10,60,19,95,96
236,Derrick McKey\mckeyde01,SF,28,IND,81,81,2805,411,833,.493,32,89,.360,379,744,.509,.513,221,297,.744,125,269,394,276,125,49,168,260,1075
237,Aaron McKie\mckieaa01,SG,22,POR,45,20,827,116,261,.444,11,28,.393,105,233,.451,.466,50,73,.685,35,94,129,89,36,16,39,97,293
238,Nate McMillan\mcmilna01,PG,30,SEA,80,18,2070,166,397,.418,53,155,.342,113,242,.467,.485,34,58,.586,65,237,302,421,165,53,126,275,419
239,Darnell Mee\meeda01,SG,23,DEN,2,0,8,1,5,.200,1,3,.333,0,2,.000,.300,0,0,,0,1,1,2,1,0,0,0,3
240,Anthony Miller\millean01,PF,23,LAL,46,1,527,70,132,.530,2,5,.400,68,127,.535,.538,47,76,.618,67,85,152,35,20,7,38,77,189
241,Oliver Miller\milleol01,PF,24,DET,64,22,1558,232,418,.555,3,13,.231,229,405,.565,.559,78,124,.629,162,313,475,93,60,116,115,217,545
242,Reggie Miller*\millere01,SG,29,IND,81,81,2665,505,1092,.462,195,470,.415,310,622,.498,.552,383,427,.897,30,180,210,242,98,16,151,157,1588
243,Chris Mills\millsch01,SF,25,CLE,80,79,2814,359,855,.420,94,240,.392,265,615,.431,.475,174,213,.817,99,267,366,154,59,35,120,242,986
244,Terry Mills\millste01,PF,27,DET,72,69,2514,417,933,.447,109,285,.382,308,648,.475,.505,175,219,.799,124,434,558,160,68,33,144,253,1118
245,Harold Miner\minerha01,PG,23,MIA,45,16,871,123,305,.403,14,49,.286,109,256,.426,.426,69,95,.726,38,79,117,69,15,6,77,85,329
246,Greg Minor\minorgr01,SG,23,BOS,63,8,945,155,301,.515,2,12,.167,153,289,.529,.518,65,78,.833,49,88,137,66,32,16,44,89,377
247,Sam Mitchell\mitchsa01,SF,31,IND,81,12,1377,201,413,.487,1,10,.100,200,403,.496,.488,126,174,.724,95,148,243,61,43,20,54,206,529
248,Eric Mobley\mobleer01,C,24,MIL,46,26,587,78,132,.591,2,2,1.000,76,130,.585,.598,22,45,.489,55,98,153,21,8,27,24,63,180
249,Eric Montross\montrer01,C,23,BOS,78,75,2315,307,575,.534,0,1,.000,307,574,.535,.534,167,263,.635,196,370,566,36,29,61,112,299,781
250,Chris Morris\morrich01,SF,29,NJN,71,49,2131,351,856,.410,106,317,.334,245,539,.455,.472,142,195,.728,181,221,402,147,86,51,117,155,950
251,Dwayne Morton\mortodw01,PG,23,GSW,41,6,395,50,129,.388,9,25,.360,41,104,.394,.422,58,85,.682,21,37,58,18,11,15,27,45,167
252,Alonzo Mourning*\mournal01,C,24,CHH,77,77,2941,571,1101,.519,11,34,.324,560,1067,.525,.524,490,644,.761,200,561,761,111,49,225,241,275,1643
253,Chris Mullin*\mullich01,SF,31,GSW,25,23,890,170,348,.489,42,93,.452,128,255,.502,.549,94,107,.879,25,90,115,125,38,19,93,53,476
254,Eric Murdock\murdoer01,PG,26,MIL,75,32,2158,338,814,.415,90,240,.375,248,574,.432,.471,211,267,.790,48,166,214,482,113,12,194,139,977
255,Gheorghe Muresan\muresgh01,C,23,WSB,73,58,1720,303,541,.560,0,0,,303,541,.560,.560,124,175,.709,179,309,488,38,48,127,115,259,730
256,Lamond Murray\murrala01,SF,21,LAC,81,61,2556,439,1093,.402,65,218,.298,374,875,.427,.431,199,264,.754,132,222,354,133,72,55,163,180,1142
257,Tracy Murray\murratr01,SF,23,TOT,54,3,516,95,233,.408,35,86,.407,60,147,.408,.483,33,42,.786,20,39,59,19,14,4,35,73,258
258,Dikembe Mutombo*\mutomdi01,C,28,DEN,82,82,3100,349,628,.556,0,0,,349,628,.556,.556,248,379,.654,319,710,1029,113,40,321,192,284,946
259,Pete Myers\myerspe01,SG,31,CHI,71,14,1270,119,287,.415,10,39,.256,109,248,.440,.432,70,114,.614,57,82,139,148,58,15,88,125,318
260,Ivano Newbill\newbiiv01,SF,24,DET,34,0,331,16,45,.356,0,0,,16,45,.356,.356,8,22,.364,40,41,81,17,12,11,12,60,40
261,Johnny Newman\newmajo01,SF,31,MIL,82,11,1896,226,488,.463,45,128,.352,181,360,.503,.509,137,171,.801,72,101,173,91,69,13,86,234,634
262,Ken Norman\normake01,SF,30,ATL,74,27,1879,388,856,.453,98,285,.344,290,571,.508,.511,64,140,.457,103,259,362,94,34,20,96,154,938
263,Julius Nwosu\nwosuju01,C,23,SAS,23,0,84,9,28,.321,0,0,,9,28,.321,.321,13,17,.765,11,13,24,3,0,3,9,20,31
264,Shaquille O'Neal*\onealsh01,C,22,ORL,79,79,2923,930,1594,.583,0,5,.000,930,1589,.585,.583,455,854,.533,328,573,901,214,73,192,204,258,2315
265,Charles Oakley\oaklech01,PF,31,NYK,50,49,1567,192,393,.489,3,12,.250,189,381,.496,.492,119,150,.793,155,290,445,126,60,7,103,179,506
266,Hakeem Olajuwon*\olajuha01,C,32,HOU,72,72,2853,798,1545,.517,3,16,.188,795,1529,.520,.517,406,537,.756,172,603,775,255,133,242,237,250,2005
267,Brian Oliver\olivebr01,SG,26,WSB,6,0,42,4,9,.444,0,0,,4,9,.444,.444,6,8,.750,0,4,4,4,0,0,3,8,14
268,Bo Outlaw\outlabo01,PF,23,LAC,81,31,1655,170,325,.523,0,5,.000,170,320,.531,.523,82,186,.441,121,192,313,84,90,151,78,227,422
269,Doug Overton\overtdo01,PG,25,WSB,82,20,1704,207,498,.416,53,125,.424,154,373,.413,.469,109,125,.872,26,117,143,246,53,2,104,126,576
270,Billy Owens\owensbi01,SG,25,MIA,70,60,2296,403,820,.491,2,22,.091,401,798,.503,.493,194,313,.620,203,299,502,246,80,30,204,205,1002
271,Robert Pack\packro01,PG,25,DEN,42,32,1144,170,395,.430,30,72,.417,140,323,.433,.468,137,175,.783,19,94,113,290,61,6,134,101,507
272,Robert Parish*\parisro01,C,41,CHH,81,4,1352,159,372,.427,0,0,,159,372,.427,.427,71,101,.703,93,257,350,44,27,36,66,132,389
273,Gary Payton*\paytoga01,PG,26,SEA,82,82,3015,685,1345,.509,70,232,.302,615,1113,.553,.535,249,348,.716,108,173,281,583,204,13,201,206,1689
274,Anthony Peeler\peelean01,SG,25,LAL,73,24,1559,285,659,.432,84,216,.389,201,443,.454,.496,102,128,.797,62,106,168,122,52,13,82,143,756
275,Mike Peplowski\peplomi01,C,24,DET,6,0,21,5,5,1.000,0,0,,5,5,1.000,1.000,1,2,.500,1,2,3,1,1,0,2,10,11
276,Will Perdue\perduwi01,C,29,CHI,78,78,1592,254,459,.553,0,1,.000,254,458,.555,.553,113,194,.582,211,311,522,90,26,56,116,220,621
277,Sam Perkins\perkisa01,C,33,SEA,82,37,2356,346,742,.466,136,343,.397,210,399,.526,.558,215,269,.799,96,302,398,135,72,45,77,186,1043
278,Elliot Perry\perryel01,PG,25,PHO,82,51,1977,306,588,.520,25,60,.417,281,528,.532,.542,158,195,.810,51,100,151,394,156,4,163,142,795
279,Tim Perry\perryti01,PF,29,PHI,42,1,446,27,78,.346,0,14,.000,27,64,.422,.346,22,40,.550,38,51,89,12,10,15,21,51,76
280,Chuck Person\persoch01,SF,30,SAS,81,1,2033,317,750,.423,172,445,.387,145,305,.475,.537,66,102,.647,49,209,258,106,45,12,102,198,872
281,Wesley Person\persowe01,SG,23,PHO,78,56,1800,309,638,.484,116,266,.436,193,372,.519,.575,80,101,.792,67,134,201,105,48,24,79,149,814
282,Derrick Phelps\phelpde01,PG,22,SAC,3,0,5,0,1,.000,0,0,,0,1,.000,.000,0,2,.000,0,0,0,1,0,0,0,3,0
283,Bobby Phills\phillbo01,SG,25,CLE,80,79,2500,338,816,.414,19,55,.345,319,761,.419,.426,183,235,.779,90,175,265,180,115,25,113,206,878
284,Eric Piatkowski\piatker01,SG,24,LAC,81,11,1208,201,456,.441,74,198,.374,127,258,.492,.522,90,115,.783,63,70,133,77,37,15,63,150,566
285,Ricky Pierce\piercri01,PG,35,GSW,27,6,673,111,254,.437,23,70,.329,88,184,.478,.482,93,106,.877,12,52,64,40,22,2,24,38,338
286,Ed Pinckney\pincked01,PF,31,MIL,62,17,835,48,97,.495,0,0,,48,97,.495,.495,44,62,.710,65,146,211,21,34,17,26,64,140
287,Scottie Pippen*\pippesc01,SF,29,CHI,79,79,3014,634,1320,.480,109,316,.345,525,1004,.523,.522,315,440,.716,175,464,639,409,232,89,271,238,1692
288,Olden Polynice\polynol01,C,30,SAC,81,81,2534,376,691,.544,1,1,1.000,375,690,.543,.545,124,194,.639,277,448,725,62,48,52,113,238,877
289,Terry Porter\portete01,PG,31,POR,35,9,770,105,267,.393,44,114,.386,61,153,.399,.476,58,82,.707,18,63,81,133,30,2,58,60,312
290,Mark Price\pricema01,PG,30,CLE,48,34,1375,253,612,.413,103,253,.407,150,359,.418,.498,148,162,.914,25,87,112,335,35,4,142,50,757
291,Kevin Pritchard\pritcke01,PG,27,TOT,19,0,194,13,32,.406,2,8,.250,11,24,.458,.438,16,21,.762,0,12,12,34,2,1,12,22,44
292,Dino Radja*\radjadi01,PF,27,BOS,66,48,2147,450,919,.490,0,1,.000,450,918,.490,.490,233,307,.759,149,424,573,111,60,86,159,232,1133
293,Kurt Rambis\rambiku01,PF,36,LAL,26,1,195,18,35,.514,0,0,,18,35,.514,.514,8,12,.667,10,24,34,16,3,9,8,35,44
294,Mark Randall\randama01,PF,27,DEN,8,0,39,3,10,.300,0,1,.000,3,9,.333,.300,0,0,,4,8,12,1,0,0,1,5,6
295,Eldridge Recasner\recasel01,SG,27,DEN,3,0,13,1,6,.167,0,1,.000,1,5,.200,.167,4,4,1.000,0,2,2,1,3,0,2,0,6
296,Khalid Reeves\reevekh01,PG,22,MIA,67,17,1462,206,465,.443,67,171,.392,139,294,.473,.515,140,196,.714,52,134,186,288,77,10,132,139,619
297,J.R. Reid\reidjr01,PF,26,SAS,81,37,1566,201,396,.508,1,2,.500,200,394,.508,.509,160,233,.687,120,273,393,55,60,32,113,230,563
298,Glen Rice\ricegl01,SF,27,MIA,82,82,3014,667,1403,.475,185,451,.410,482,952,.506,.541,312,365,.855,99,279,378,192,112,14,153,203,1831
299,Pooh Richardson\richapo01,PG,28,LAC,80,77,2864,353,897,.394,87,244,.357,266,653,.407,.442,81,125,.648,38,223,261,632,129,12,171,218,874
300,Mitch Richmond*\richmmi01,SG,29,SAC,82,82,3172,668,1497,.446,156,424,.368,512,1073,.477,.498,375,445,.843,69,288,357,311,91,29,234,227,1867
301,Isaiah Rider\rideris01,SG,23,MIN,75,67,2645,558,1249,.447,139,396,.351,419,853,.491,.502,277,339,.817,90,159,249,245,69,23,232,194,1532
302,Eric Riley\rileyer01,C,24,LAC,40,4,434,65,145,.448,0,1,.000,65,144,.451,.448,47,64,.734,45,67,112,11,17,35,31,78,177
303,Doc Rivers\riverdo01,PG,33,TOT,63,0,989,108,302,.358,45,127,.354,63,175,.360,.432,60,82,.732,15,94,109,162,65,21,60,150,321
304,Fred Roberts\roberfr01,SF,34,CLE,21,0,223,28,72,.389,4,11,.364,24,61,.393,.417,20,26,.769,13,21,34,8,6,3,7,26,80
305,Clifford Robinson\robincl02,SF,28,POR,75,73,2725,597,1320,.452,142,383,.371,455,937,.486,.506,265,382,.694,152,271,423,198,79,82,158,240,1601
306,David Robinson*\robinda01,C,29,SAS,81,81,3074,788,1487,.530,6,20,.300,782,1467,.533,.532,656,847,.774,234,643,877,236,134,262,233,230,2238
307,Glenn Robinson\robingl01,SF,22,MIL,80,76,2958,636,1410,.451,86,268,.321,550,1142,.482,.482,397,499,.796,169,344,513,197,115,22,313,234,1755
308,James Robinson\robinja02,PG,24,POR,71,25,1539,255,624,.409,76,223,.341,179,401,.446,.470,65,110,.591,42,90,132,180,48,13,127,142,651
309,Dennis Rodman*\rodmade01,PF,33,SAS,49,26,1568,137,240,.571,0,2,.000,137,238,.576,.571,75,111,.676,274,549,823,97,31,23,98,159,349
310,Carlos Rogers\rogerca01,C,23,GSW,49,18,1017,180,340,.529,2,14,.143,178,326,.546,.532,76,146,.521,108,170,278,37,22,52,84,124,438
311,Rodney Rogers\rogerro01,PF,23,DEN,80,77,2142,375,769,.488,50,148,.338,325,621,.523,.520,179,275,.651,132,253,385,161,95,46,173,281,979
312,Tree Rollins\rollitr01,C,39,ORL,51,3,478,20,42,.476,0,0,,20,42,.476,.476,21,31,.677,31,64,95,9,7,36,23,63,61
313,Sean Rooks\rooksse01,C,25,MIN,80,70,2405,289,615,.470,0,5,.000,289,610,.474,.470,290,381,.761,165,321,486,97,29,71,142,208,868
314,Jalen Rose\roseja01,SF,22,DEN,81,37,1798,227,500,.454,36,114,.316,191,386,.495,.490,173,234,.739,57,160,217,389,65,22,160,206,663
315,Donald Royal\royaldo01,SF,28,ORL,70,68,1841,206,434,.475,0,4,.000,206,430,.479,.475,223,299,.746,83,196,279,198,45,16,125,156,635
316,Clifford Rozier\roziecl01,C,22,GSW,66,34,1494,189,390,.485,2,7,.286,187,383,.488,.487,68,152,.447,200,286,486,45,35,39,89,196,448
317,Trevor Ruffin\ruffitr01,PG,24,PHO,49,1,319,84,197,.426,38,99,.384,46,98,.469,.523,27,38,.711,8,15,23,48,14,2,47,52,233
318,Bryon Russell\russebr01,SF,24,UTA,63,15,860,104,238,.437,13,44,.295,91,194,.469,.464,62,93,.667,44,97,141,34,48,11,42,101,283
319,John Salley\sallejo01,C,30,MIA,75,50,1955,197,395,.499,0,0,,197,395,.499,.499,153,207,.739,110,226,336,123,47,85,97,279,547
320,Danny Schayes\schayda01,C,35,PHO,69,27,823,126,248,.508,1,1,1.000,125,247,.506,.510,50,69,.725,57,151,208,89,20,37,64,170,303
321,Steve Scheffler\schefst01,C,27,SEA,18,0,102,12,23,.522,0,0,,12,23,.522,.522,15,18,.833,8,15,23,4,2,2,3,9,39
322,Dwayne Schintzius\schindw01,C,26,NJN,43,11,318,41,108,.380,0,0,,41,108,.380,.380,6,11,.545,29,52,81,15,3,17,17,45,88
323,Detlef Schrempf\schrede01,SF,32,SEA,82,82,2886,521,997,.523,93,181,.514,428,816,.525,.569,437,521,.839,135,373,508,310,93,35,176,252,1572
324,Byron Scott\scottby01,PG,33,IND,80,1,1528,265,583,.455,79,203,.389,186,380,.489,.522,193,227,.850,18,133,151,108,61,13,119,123,802
325,Dennis Scott\scottde01,SF,26,ORL,62,10,1499,283,645,.439,150,352,.426,133,293,.454,.555,86,114,.754,25,121,146,131,45,14,57,119,802
326,Malik Sealy\sealyma01,SG,24,LAC,60,41,1604,291,669,.435,22,73,.301,269,596,.451,.451,174,223,.780,77,137,214,107,72,25,83,173,778
327,Rony Seikaly\seikaro01,C,29,GSW,36,35,1035,162,314,.516,0,0,,162,314,.516,.516,111,160,.694,77,189,266,45,20,37,104,122,435
328,Charles Shackleford\shackch01,PF,28,MIN,21,2,239,39,65,.600,0,0,,39,65,.600,.600,16,20,.800,16,51,67,8,8,6,8,47,94
329,Brian Shaw\shawbr01,PG,28,ORL,78,9,1836,192,494,.389,48,184,.261,144,310,.465,.437,70,95,.737,52,189,241,406,73,18,184,184,502
330,Lionel Simmons\simmoli01,SF,26,SAC,58,3,1064,131,312,.420,6,16,.375,125,296,.422,.429,59,84,.702,61,135,196,89,28,23,70,118,327
331,Dickey Simpkins\simpkdi01,PF,22,CHI,59,5,586,78,184,.424,0,0,,78,184,.424,.424,50,72,.694,60,91,151,37,10,7,45,72,206
332,Scott Skiles\skilesc01,PG,30,WSB,62,62,2077,265,583,.455,96,228,.421,169,355,.476,.537,179,202,.886,26,133,159,452,70,6,172,135,805
333,Reggie Slater\slatere01,PF,24,DEN,25,0,236,40,81,.494,0,0,,40,81,.494,.494,40,55,.727,21,36,57,12,7,3,26,47,120
334,Charles Smith\smithch01,SF,29,NYK,76,58,2150,352,747,.471,7,31,.226,345,716,.482,.476,255,322,.792,144,180,324,120,49,95,147,286,966
335,Chris Smith\smithch03,SG,24,MIN,64,17,1073,116,264,.439,47,108,.435,69,156,.442,.528,41,63,.651,14,59,73,146,32,22,50,119,320
336,Doug Smith\smithdo03,PF,25,DAL,63,0,826,131,314,.417,1,12,.083,130,302,.430,.419,57,75,.760,43,101,144,44,29,26,37,132,320
337,Kenny Smith\smithke01,PG,29,HOU,81,81,2030,287,593,.484,142,331,.429,145,262,.553,.604,126,148,.851,27,128,155,323,71,10,123,109,842
338,Michael Smith\smithmi01,PF,29,LAC,29,0,319,63,134,.470,1,8,.125,62,126,.492,.474,26,30,.867,13,43,56,20,6,2,18,41,153
339,Michael Smith\smithmi02,PF,22,SAC,82,0,1736,220,406,.542,0,2,.000,220,404,.545,.542,127,262,.485,174,312,486,67,61,49,106,235,567
340,Steve Smith\smithst01,SG,25,TOT,80,61,2665,428,1005,.426,137,416,.329,291,589,.494,.494,312,371,.841,104,172,276,274,62,33,155,225,1305
341,Tony Smith\smithto02,SG,26,LAL,61,4,1024,132,309,.427,32,91,.352,100,218,.459,.479,44,63,.698,43,64,107,102,46,7,50,111,340
342,Rik Smits\smitsri01,C,28,IND,78,78,2381,558,1060,.526,0,2,.000,558,1058,.527,.526,284,377,.753,192,409,601,111,40,79,189,278,1400
343,Elmore Spencer\spencel01,C,25,LAC,19,8,368,52,118,.441,0,1,.000,52,117,.444,.441,28,50,.560,11,54,65,25,14,23,48,62,132
344,Felton Spencer\spencfe01,C,27,UTA,34,34,905,105,215,.488,0,0,,105,215,.488,.488,107,135,.793,90,170,260,17,12,32,68,131,317
345,Latrell Sprewell\sprewla01,SG,24,GSW,69,69,2771,490,1171,.418,90,326,.276,400,845,.473,.457,350,448,.781,58,198,256,279,112,46,230,108,1420
346,John Starks\starkjo01,SG,29,NYK,80,78,2725,419,1062,.395,217,611,.355,202,451,.448,.497,168,228,.737,34,185,219,411,92,4,160,257,1223
347,Larry Stewart\stewala01,SF,26,WSB,40,0,346,41,89,.461,0,2,.000,41,87,.471,.461,20,30,.667,28,39,67,18,16,9,16,52,102
348,Bryant Stith\stithbr01,SG,24,DEN,81,51,2329,312,661,.472,20,68,.294,292,593,.492,.487,267,324,.824,95,173,268,153,91,18,110,142,911
349,John Stockton*\stockjo01,PG,32,UTA,82,82,2867,429,791,.542,102,227,.449,327,564,.580,.607,246,306,.804,57,194,251,1011,194,22,267,215,1206
350,Mark Strickland\stricma01,PF,24,IND,4,0,9,1,3,.333,0,0,,1,3,.333,.333,1,2,.500,2,2,4,0,0,1,1,0,3
351,Rod Strickland\stricro02,PG,28,POR,64,61,2267,441,946,.466,46,123,.374,395,823,.480,.490,283,380,.745,73,244,317,562,123,9,209,118,1211
352,Derek Strong\stronde01,PF,26,BOS,70,24,1344,149,329,.453,2,7,.286,147,322,.457,.456,141,172,.820,136,239,375,44,24,13,79,143,441
353,Greg Sutton\suttogr01,PG,27,CHH,53,4,690,94,230,.409,43,115,.374,51,115,.443,.502,32,45,.711,8,48,56,91,33,2,51,114,263
354,Aaron Swinson\swinsaa01,SF,24,PHO,9,0,51,10,18,.556,0,0,,10,18,.556,.556,4,5,.800,3,5,8,3,1,0,5,8,24
355,Zan Tabak\tabakza01,C,24,HOU,37,0,182,24,53,.453,0,1,.000,24,52,.462,.453,27,44,.614,23,34,57,4,2,7,18,37,75
356,Roy Tarpley\tarplro01,C,30,DAL,55,1,1354,292,610,.479,5,18,.278,287,592,.485,.483,102,122,.836,142,307,449,58,45,55,109,155,691
357,Brooks Thompson\thompbr01,PG,24,ORL,38,2,246,45,114,.395,18,58,.310,27,56,.482,.474,8,12,.667,7,16,23,43,10,2,27,46,116
358,LaSalle Thompson\thompla01,C,33,IND,38,3,453,49,118,.415,0,0,,49,118,.415,.415,14,16,.875,28,61,89,18,18,10,33,76,112
359,Otis Thorpe\thorpot01,PF,32,TOT,70,35,2096,385,681,.565,0,7,.000,385,674,.571,.565,167,281,.594,202,356,558,112,41,28,132,224,937
360,Sedale Threatt\threase01,PG,33,LAL,59,2,1384,217,437,.497,36,95,.379,181,342,.529,.538,88,111,.793,21,103,124,248,54,12,70,139,558
361,Wayman Tisdale\tisdawa01,PF,30,PHO,65,13,1276,278,574,.484,0,0,,278,574,.484,.484,94,122,.770,83,164,247,45,29,27,64,190,650
362,Tom Tolbert\tolbeto01,PF,29,CHH,10,0,57,6,18,.333,0,4,.000,6,14,.429,.333,2,2,1.000,7,10,17,2,0,0,3,9,14
363,Keith Tower\towerke01,C,24,ORL,3,0,7,0,2,.000,0,0,,0,2,.000,.000,1,2,.500,1,2,3,0,0,0,1,1,1
364,Anthony Tucker\tuckean01,SF,25,WSB,62,13,982,96,210,.457,0,1,.000,96,209,.459,.457,51,83,.614,44,126,170,68,46,11,56,129,243
365,Henry Turner\turnehe02,PF,28,SAC,30,0,149,23,57,.404,2,5,.400,21,52,.404,.421,20,35,.571,17,11,28,7,8,1,12,20,68
366,Jeff Turner\turneje01,PF,32,ORL,49,5,576,73,178,.410,27,75,.360,46,103,.447,.486,26,29,.897,23,74,97,38,12,3,22,102,199
367,B.J. Tyler\tylerbj01,PG,23,PHI,55,8,809,72,189,.381,16,51,.314,56,138,.406,.423,35,50,.700,13,49,62,174,36,2,97,58,195
368,Nick Van Exel\vanexni01,PG,23,LAL,80,80,2944,465,1107,.420,183,511,.358,282,596,.473,.503,235,300,.783,27,196,223,660,97,6,220,157,1348
369,Loy Vaught\vaughlo01,PF,26,LAC,80,79,2966,609,1185,.514,7,33,.212,602,1152,.523,.517,176,248,.710,261,511,772,139,104,29,166,243,1401
370,Fred Vinson\vinsofr01,SG,24,ATL,5,0,27,1,7,.143,1,6,.167,0,1,.000,.214,1,1,1.000,0,0,0,1,0,0,2,4,4
371,Kenny Walker\walkeke01,SF,30,WSB,24,0,266,18,42,.429,0,0,,18,42,.429,.429,21,28,.750,19,28,47,7,5,5,15,42,57
372,Rex Walters\waltere01,SG,24,NJN,80,30,1435,206,469,.439,71,196,.362,135,273,.495,.515,40,52,.769,18,75,93,121,37,16,71,135,523
373,Charlie Ward\wardch01,PG,24,NYK,10,0,44,4,19,.211,1,10,.100,3,9,.333,.237,7,10,.700,1,5,6,4,2,0,8,7,16
374,Jamie Watson\watsoja01,SF,22,UTA,60,1,673,76,152,.500,5,19,.263,71,133,.534,.516,38,56,.679,16,58,74,59,35,11,51,86,195
375,Clarence Weatherspoon\weathcl01,SF,24,PHI,76,76,2991,543,1238,.439,4,21,.190,539,1217,.443,.440,283,377,.751,144,382,526,215,115,67,191,195,1373
376,Spud Webb\webbsp01,PG,31,SAC,76,76,2458,302,689,.438,48,145,.331,254,544,.467,.473,226,242,.934,29,145,174,468,75,8,185,148,878
377,Chris Webber\webbech01,PF,21,WSB,54,52,2067,464,938,.495,40,145,.276,424,793,.535,.516,117,233,.502,200,318,518,256,83,85,167,186,1085
378,Bill Wennington\wennibi01,C,31,CHI,73,1,956,156,317,.492,0,4,.000,156,313,.498,.492,51,63,.810,64,126,190,40,22,17,39,198,363
379,David Wesley\wesleda01,PG,24,BOS,51,36,1380,128,313,.409,51,119,.429,77,194,.397,.490,71,94,.755,31,86,117,266,82,9,87,144,378
380,Doug West\westdo01,SG,27,MIN,71,65,2328,351,762,.461,11,61,.180,340,701,.485,.468,206,246,.837,60,167,227,185,65,24,126,250,919
381,Mark West\westma01,C,34,DET,67,58,1543,217,390,.556,0,0,,217,390,.556,.556,66,138,.478,160,248,408,18,27,102,85,247,500
382,Ennis Whatley\whatlen01,PG,32,ATL,27,2,292,24,53,.453,2,8,.250,22,45,.489,.472,20,32,.625,9,21,30,54,19,0,19,37,70
383,Chris Whitney\whitnch01,PG,23,SAS,25,0,179,14,47,.298,3,19,.158,11,28,.393,.330,11,11,1.000,4,9,13,28,4,0,18,34,42
384,Morlon Wiley\wileymo01,PG,28,TOT,43,2,424,50,117,.427,30,79,.380,20,38,.526,.556,7,10,.700,6,37,43,75,22,2,23,44,137
385,Dominique Wilkins*\wilkido01,SF,35,BOS,77,64,2423,496,1169,.424,112,289,.388,384,880,.436,.472,266,340,.782,157,244,401,166,61,14,173,130,1370
386,Aaron Williams\williaa01,PF,23,MIL,15,0,72,8,24,.333,0,1,.000,8,23,.348,.333,8,12,.667,5,14,19,0,2,6,7,14,24
387,Buck Williams\willibu01,PF,34,POR,82,82,2422,309,604,.512,1,2,.500,308,602,.512,.512,138,205,.673,251,418,669,78,67,69,119,254,757
388,Herb Williams\willihe01,C,36,NYK,56,3,743,82,180,.456,0,0,,82,180,.456,.456,23,37,.622,23,109,132,27,13,45,40,108,187
389,Hot Rod Williams\williho01,PF,32,CLE,74,73,2641,366,810,.452,1,5,.200,365,805,.453,.452,196,286,.685,173,334,507,192,83,101,149,211,929
390,Jayson Williams\willija01,PF,26,NJN,75,6,982,149,323,.461,0,5,.000,149,318,.469,.461,65,122,.533,179,246,425,35,26,33,59,160,363
391,John Williams\willijo02,SF,28,IND,34,0,402,41,115,.357,4,12,.333,37,103,.359,.374,14,25,.560,23,39,62,27,10,2,35,48,100
392,Lorenzo Williams\willilo01,C,25,DAL,82,81,2383,145,304,.477,0,0,,145,304,.477,.477,38,101,.376,291,399,690,124,52,148,105,306,328
393,Micheal Williams\willimi02,PG,28,MIN,1,1,28,1,4,.250,0,0,,1,4,.250,.250,4,5,.800,0,1,1,3,2,0,3,3,6
394,Monty Williams\willimo01,SF,23,NYK,41,23,503,60,133,.451,0,8,.000,60,125,.480,.451,17,38,.447,42,56,98,49,20,4,41,87,137
395,Reggie Williams\willire01,SF,30,DEN,74,70,2198,388,846,.459,85,266,.320,303,580,.522,.509,132,174,.759,94,235,329,231,114,67,124,264,993
396,Scott Williams\willisc01,PF,26,PHI,77,43,1781,206,434,.475,0,7,.000,206,427,.482,.475,79,107,.738,173,312,485,59,71,40,84,237,491
397,Walt Williams\williwa02,SF,24,SAC,77,77,2739,445,998,.446,103,296,.348,342,702,.487,.497,266,364,.731,100,245,345,316,123,63,243,265,1259
398,Kevin Willis\willike02,PF,32,TOT,67,63,2390,473,1015,.466,3,15,.200,470,1000,.470,.467,205,297,.690,227,505,732,86,60,36,162,215,1154
399,Trevor Wilson\wilsotr01,PF,26,SAC,15,0,147,18,40,.450,0,0,,18,40,.450,.450,11,14,.786,10,16,26,12,4,2,6,12,47
400,David Wingate\wingada01,SG,31,CHH,52,9,515,50,122,.410,4,22,.182,46,100,.460,.426,18,24,.750,11,49,60,56,19,6,27,60,122
401,Dontonio Wingfield\wingfdo01,SF,20,SEA,20,0,81,18,51,.353,2,12,.167,16,39,.410,.373,8,10,.800,11,19,30,3,5,3,8,15,46
402,Joe Wolf\wolfjo01,PF,30,CHH,63,6,583,38,81,.469,2,6,.333,36,75,.480,.481,12,16,.750,34,95,129,37,9,6,22,101,90
403,David Wood\woodda01,PF,30,GSW,78,13,1336,153,326,.469,31,91,.341,122,235,.519,.517,91,117,.778,83,158,241,65,28,13,53,217,428
404,Randy Woods\woodsra01,PG,24,LAC,62,3,495,37,117,.316,22,74,.297,15,43,.349,.410,28,38,.737,10,34,44,134,41,0,55,87,124
405,Haywoode Workman\workmha01,PG,29,IND,69,14,1028,101,269,.375,35,98,.357,66,171,.386,.441,55,74,.743,21,90,111,194,59,5,73,115,292
406,Sharone Wright\wrighsh01,C,22,PHI,79,49,2044,361,776,.465,0,8,.000,361,768,.470,.465,182,282,.645,191,281,472,48,37,104,151,246,904
407,Danny Young\youngda01,PG,32,MIL,7,0,77,9,17,.529,5,12,.417,4,5,.800,.676,1,1,1.000,1,4,5,12,4,0,4,8,24