
Rk,Player,Pos,Age,Tm,G,GS,MP,FG,FGA,FG%,3P,3PA,3P%,2P,2PA,2P%,eFG%,FT,FTA,FT%,ORB,DRB,TRB,AST,STL,BLK,TOV,PF,PTS
1,Mahmoud Abdul-Rauf\abdulma02,PG,28,SAC,31,0,530,103,273,.377,5,31,.161,98,242,.405,.386,16,16,1.000,6,31,37,58,16,1,19,31,227
2,Tariq Abdul-Wahad\abdulta01,SG,23,SAC,59,16,959,144,357,.403,4,19,.211,140,338,.414,.409,84,125,.672,44,72,116,51,35,13,65,81,376
3,Shareef Abdur-Rahim\abdursh01,SF,21,VAN,82,82,2950,653,1347,.485,21,51,.412,632,1296,.488,.493,502,640,.784,227,354,581,213,89,76,257,201,1829
4,Cory Alexander\alexaco01,PG,24,TOT,60,22,1298,171,400,.428,66,176,.375,105,224,.469,.510,80,102,.784,17,129,146,209,70,11,112,98,488
5,Ray Allen*\allenra02,SG,22,MIL,82,82,3287,563,1315,.428,134,368,.364,429,947,.453,.479,342,391,.875,127,278,405,356,111,12,263,244,1602
6,Derek Anderson\anderde01,SF,23,CLE,66,13,1839,239,586,.408,17,84,.202,222,502,.442,.422,275,315,.873,55,132,187,227,86,13,128,136,770
7,Greg Anderson\andergr01,C,33,ATL,50,0,398,36,81,.444,0,5,.000,36,76,.474,.444,16,41,.390,39,79,118,15,19,10,17,85,88
8,Kenny Anderson\anderke01,PG,27,TOT,61,56,1858,268,674,.398,57,160,.356,211,514,.411,.440,153,194,.789,39,134,173,345,87,1,143,135,746
9,Nick Anderson\anderni01,SF,30,ORL,58,44,1701,343,754,.455,77,214,.360,266,540,.493,.506,127,199,.638,98,199,297,119,72,23,85,98,890
10,Shandon Anderson\andersh01,SG,24,UTA,82,2,1602,269,500,.538,7,32,.219,262,468,.560,.545,136,185,.735,86,141,227,89,66,18,91,145,681
11,Chris Anstey\anstech01,C,23,DAL,41,8,680,92,231,.398,3,16,.188,89,215,.414,.405,53,74,.716,53,104,157,35,31,27,41,95,240
12,Greg Anthony\anthogr01,PG,30,SEA,80,0,1021,150,349,.430,66,159,.415,84,190,.442,.524,53,80,.663,18,93,111,205,64,3,91,97,419
13,B.J. Armstrong\armstbj01,PG,30,TOT,66,0,831,105,213,.493,9,35,.257,96,178,.539,.514,42,50,.840,16,60,76,150,29,0,42,74,261
14,Darrell Armstrong\armstda01,PG,29,ORL,48,17,1236,156,380,.411,25,68,.368,131,312,.420,.443,105,123,.854,65,94,159,236,58,5,112,96,442
15,Vincent Askew\askewvi01,SG,31,POR,30,5,443,19,54,.352,0,2,.000,19,52,.365,.352,28,39,.718,21,47,68,38,19,5,35,39,66
16,Keith Askins\askinke01,SF,30,MIA,46,12,681,39,122,.320,21,74,.284,18,48,.375,.406,12,19,.632,28,73,101,29,27,12,26,107,111
17,Stacey Augmon\augmost01,SG,29,POR,71,23,1445,154,372,.414,1,7,.143,153,365,.419,.415,94,156,.603,104,131,235,88,57,32,81,144,403
18,Isaac Austin\austiis01,C,28,TOT,78,50,2266,406,871,.466,0,8,.000,406,863,.470,.466,243,363,.669,199,358,557,175,61,56,206,231,1055
19,Vin Baker\bakervi01,C,26,SEA,82,82,2944,631,1164,.542,1,7,.143,630,1157,.545,.543,311,526,.591,286,370,656,152,91,86,174,278,1574
20,Charles Barkley*\barklch01,PF,34,HOU,68,41,2243,361,744,.485,18,84,.214,343,660,.520,.497,296,397,.746,241,553,794,217,71,28,147,187,1036
21,Dana Barros\barroda01,PG,30,BOS,80,15,1686,281,609,.461,100,246,.407,181,363,.499,.544,122,144,.847,28,125,153,286,83,6,107,124,784
22,Brent Barry\barrybr01,SG,26,TOT,58,36,1600,213,506,.421,90,229,.393,123,277,.444,.510,115,134,.858,29,142,171,153,64,27,104,118,631
23,Drew Barry\barrydr01,PG,24,ATL,27,0,256,18,38,.474,9,21,.429,9,17,.529,.592,11,13,.846,5,30,35,49,10,1,30,28,56
24,Jon Barry\barryjo01,SG,28,LAL,49,1,374,38,104,.365,18,61,.295,20,43,.465,.452,27,29,.931,8,29,37,51,24,3,22,33,121
25,Tony Battie\battito01,PF,21,DEN,65,49,1506,234,525,.446,3,14,.214,231,511,.452,.449,73,104,.702,138,213,351,60,54,69,98,199,544
26,Corey Beck\beckco01,PG,26,CHH,59,14,738,73,159,.459,2,4,.500,71,155,.458,.465,43,59,.729,27,63,90,98,33,7,70,100,191
27,Benoit Benjamin\benjabe01,C,33,PHI,14,0,197,22,41,.537,0,0,,22,41,.537,.537,19,30,.633,18,35,53,3,4,4,12,26,63
28,Mario Bennett\bennema01,PF,24,LAL,45,4,354,80,135,.593,1,2,.500,79,133,.594,.596,16,44,.364,60,66,126,18,19,11,21,61,177
29,David Benoit\benoida01,SF,29,TOT,77,0,1123,152,408,.373,55,170,.324,97,238,.408,.440,61,74,.824,60,143,203,25,35,20,52,157,420
30,Travis Best\besttr01,PG,25,IND,82,0,1547,201,480,.419,21,70,.300,180,410,.439,.441,112,131,.855,28,94,122,281,85,5,111,193,535
31,Chauncey Billups\billuch01,PG,21,TOT,80,70,2216,280,749,.374,107,325,.329,173,424,.408,.445,226,266,.850,62,128,190,314,107,4,174,172,893
32,Mookie Blaylock\blaylmo01,PG,30,ATL,70,69,2700,368,938,.392,90,334,.269,278,604,.460,.440,95,134,.709,81,260,341,469,183,21,176,122,921
33,Corie Blount\blounco01,PF,29,LAL,70,3,1029,107,187,.572,0,4,.000,107,183,.585,.572,39,78,.500,114,184,298,37,29,25,51,157,253
34,Muggsy Bogues\boguemu01,PG,33,TOT,61,31,1570,141,323,.437,4,16,.250,137,307,.446,.443,61,68,.897,30,102,132,331,67,3,105,58,347
35,Etdrick Bohannon\bohanet01,PF,24,IND,5,0,11,0,4,.000,0,0,,0,4,.000,.000,0,0,,2,4,6,1,0,2,3,3,0
36,Keith Booth\boothke01,SF,23,CHI,6,0,17,2,6,.333,0,1,.000,2,5,.400,.333,6,6,1.000,2,2,4,1,0,0,3,3,10
37,Bruce Bowen\bowenbr01,SF,26,BOS,61,9,1305,122,298,.409,20,59,.339,102,239,.427,.443,76,122,.623,79,95,174,81,87,29,52,174,340
38,Anthony Bowie\bowiean01,SG,34,NYK,27,3,224,32,59,.542,3,4,.750,29,55,.527,.568,8,9,.889,9,17,26,11,6,2,7,25,75
39,Shawn Bradley\bradlsh01,C,25,DAL,64,46,1822,300,711,.422,1,3,.333,299,708,.422,.423,130,180,.722,164,354,518,60,51,214,96,214,731
40,Terrell Brandon\brandte01,PG,27,MIL,50,48,1784,339,731,.464,31,93,.333,308,638,.483,.485,132,156,.846,23,153,176,387,111,17,145,120,841
41,Tim Breaux\breauti01,SF,27,MIL,6,0,30,4,11,.364,1,3,.333,3,8,.375,.409,1,2,.500,0,2,2,2,2,1,1,1,10
42,Scott Brooks\brooksc01,PG,32,CLE,43,0,312,28,66,.424,5,11,.455,23,55,.418,.462,18,20,.900,6,24,30,49,18,3,12,25,79
43,Chucky Brown\brownch01,SF,29,ATL,77,8,1202,161,372,.433,2,8,.250,159,364,.437,.435,63,87,.724,57,126,183,55,23,13,51,100,387
44,Dee Brown\brownde01,SG,29,TOT,72,12,1719,246,562,.438,108,271,.399,138,291,.474,.534,58,71,.817,24,128,152,154,82,23,73,123,658
45,P.J. Brown\brownpj01,PF,28,MIA,74,74,2362,278,590,.471,0,0,,278,590,.471,.471,151,197,.766,235,400,635,103,66,98,97,264,707
46,Randy Brown\brownra02,PG,29,CHI,71,6,1147,116,302,.384,0,5,.000,116,297,.391,.384,56,78,.718,34,60,94,151,71,12,63,118,288
47,Rick Brunson\brunsri01,PG,25,POR,38,10,622,49,141,.348,22,61,.361,27,80,.338,.426,42,62,.677,14,42,56,100,25,3,52,55,162
48,Kobe Bryant\bryanko01,SG,19,LAL,79,1,2056,391,913,.428,75,220,.341,316,693,.456,.469,363,457,.794,79,163,242,199,74,40,157,180,1220
49,Mark Bryant\bryanma01,C,32,PHO,70,22,1110,109,225,.484,0,1,.000,109,224,.487,.484,73,95,.768,92,152,244,46,36,15,58,180,291
50,Jud Buechler\buechju01,SF,29,CHI,74,0,608,85,176,.483,25,65,.385,60,111,.541,.554,3,6,.500,24,53,77,49,22,15,21,47,198
51,Matt Bullard\bullama01,SF,30,HOU,67,24,1190,175,389,.450,96,231,.416,79,158,.500,.573,20,27,.741,25,121,146,60,31,24,39,104,466
52,Scott Burrell\burresc01,SF,27,CHI,80,3,1096,159,375,.424,51,144,.354,108,231,.468,.492,47,64,.734,80,118,198,65,64,37,50,131,416
53,Willie Burton\burtowi01,SF,29,SAS,13,0,43,8,21,.381,3,9,.333,5,12,.417,.452,8,12,.667,3,6,9,1,2,2,1,7,27
54,Mitchell Butler\butlemi02,SG,27,CLE,18,0,206,15,47,.319,1,6,.167,14,41,.341,.330,6,10,.600,6,16,22,18,8,0,8,26,37
55,Jason Caffey\caffeja01,PF,24,TOT,80,14,1423,226,466,.485,0,2,.000,226,464,.487,.485,131,200,.655,160,184,344,67,25,20,105,181,583
56,Michael Cage\cagemi01,C,36,NJN,79,17,1201,43,84,.512,0,1,.000,43,83,.518,.512,20,36,.556,115,193,308,32,45,44,23,105,106
57,Adrian Caldwell\caldwad01,PF,31,DAL,1,0,3,0,0,,0,0,,0,0,,,0,0,,0,0,0,0,0,0,0,0,0
58,Marcus Camby\cambyma01,C,23,TOR,63,58,2002,308,747,.412,0,2,.000,308,745,.413,.412,149,244,.611,203,263,466,111,68,230,134,200,765
59,Elden Campbell\campbel01,PF,29,LAL,81,28,1784,289,624,.463,1,2,.500,288,622,.463,.464,237,342,.693,143,312,455,78,35,102,115,209,816
60,Antoine Carr\carran01,PF,36,UTA,66,8,1086,151,325,.465,0,0,,151,325,.465,.465,76,98,.776,42,89,131,48,11,53,48,195,378
61,Chris Carr\carrch01,SG,23,MIN,51,40,1165,190,452,.420,40,127,.315,150,325,.462,.465,84,99,.848,43,112,155,85,17,11,69,129,504
62,Sam Cassell\cassesa01,PG,28,NJN,75,72,2606,510,1156,.441,15,80,.188,495,1076,.460,.448,436,507,.860,73,155,228,603,121,20,269,262,1471
63,Kelvin Cato\catoke01,C,23,POR,74,8,1007,98,229,.428,0,3,.000,98,226,.434,.428,86,125,.688,91,161,252,23,29,94,44,164,282
64,Duane Causwell\causwdu01,C,29,MIA,37,2,363,37,89,.416,0,0,,37,89,.416,.416,15,26,.577,29,70,99,5,7,27,18,73,89
65,Cedric Ceballos\cebalce01,SF,28,TOT,47,25,990,204,415,.492,21,70,.300,183,345,.530,.517,107,145,.738,75,146,221,60,33,16,72,88,536
66,Tom Chambers\chambto01,PF,38,PHI,1,0,10,2,2,1.000,0,0,,2,2,1.000,1.000,2,2,1.000,0,2,2,0,2,0,1,2,6
67,Rex Chapman\chapmre01,SG,30,PHO,68,67,2263,408,956,.427,120,311,.386,288,645,.447,.490,146,187,.781,30,143,173,203,71,14,116,102,1082
68,Calbert Cheaney\cheanca01,SG,26,WAS,82,82,2841,448,981,.457,15,53,.283,433,928,.467,.464,139,215,.647,82,242,324,173,96,36,104,264,1050
69,Pete Chilcutt\chilcpe01,PF,29,VAN,82,0,1420,156,359,.435,54,130,.415,102,229,.445,.510,39,59,.661,77,229,306,104,53,37,62,158,405
70,Chris Childs\childch01,PG,30,NYK,68,0,1599,149,354,.421,27,87,.310,122,267,.457,.459,104,126,.825,29,133,162,268,56,6,103,179,429
71,Doug Christie\chrisdo01,SG,27,TOR,78,78,2939,458,1071,.428,100,307,.326,358,764,.469,.474,271,327,.829,94,310,404,282,190,57,228,198,1287
72,Keith Closs\closske01,C,21,LAC,58,1,740,93,207,.449,0,0,,93,207,.449,.449,46,77,.597,63,105,168,19,12,81,38,73,232
73,Derrick Coleman\colemde01,PF,30,PHI,59,58,2135,356,867,.411,26,98,.265,330,769,.429,.426,302,391,.772,149,438,587,145,46,68,157,144,1040
74,Bimbo Coles\colesbi01,PG,29,GSW,53,44,1471,166,438,.379,13,57,.228,153,381,.402,.394,78,88,.886,17,106,123,248,51,13,89,135,423
75,James Collins\collija01,SG,24,LAC,23,0,103,21,55,.382,9,20,.450,12,35,.343,.464,8,14,.571,7,7,14,3,6,3,8,12,59
76,Marty Conlon\conloma01,C,30,MIA,18,0,209,28,62,.452,0,0,,28,62,.452,.452,32,44,.727,16,30,46,12,9,5,11,27,88
77,Tyrone Corbin\corbity01,SF,35,ATL,79,79,2699,328,747,.439,49,141,.348,279,606,.460,.472,101,128,.789,78,284,362,173,105,7,86,197,806
78,James Cotton\cottoja02,SG,22,SEA,9,0,33,8,21,.381,0,4,.000,8,17,.471,.381,8,9,.889,2,4,6,0,1,1,6,3,24
79,Chris Crawford\crawfch01,PF,22,ATL,40,0,256,46,110,.418,1,3,.333,45,107,.421,.423,57,68,.838,20,21,41,9,12,7,18,27,150
80,Austin Croshere\croshau01,PF,22,IND,26,0,243,32,86,.372,4,13,.308,28,73,.384,.395,8,14,.571,10,35,45,8,9,5,13,32,76
81,John Crotty\crottjo01,PG,28,POR,26,2,379,29,90,.322,6,20,.300,23,70,.329,.356,32,34,.941,4,28,32,63,10,1,42,28,96
82,Terry Cummings\cummite01,PF,36,TOT,74,3,1185,200,428,.467,0,1,.000,200,427,.468,.467,67,98,.684,97,186,283,47,38,10,51,181,467
83,William Cunningham\cunniwi01,C,23,TOT,7,2,39,4,9,.444,0,0,,4,9,.444,.444,0,0,,4,6,10,1,2,0,0,10,8
84,Bill Curley\curlebi01,PF,25,MIN,11,1,146,16,33,.485,0,1,.000,16,32,.500,.485,2,3,.667,11,17,28,4,3,1,3,28,34
85,Dell Curry\curryde01,SG,33,CHH,52,1,971,194,434,.447,61,145,.421,133,289,.460,.517,41,52,.788,26,75,101,69,31,4,54,85,490
86,Michael Curry\currymi01,SG,29,MIL,82,27,1978,196,418,.469,4,9,.444,192,409,.469,.474,147,176,.835,26,72,98,137,56,14,77,218,543
87,Erick Dampier\dampier01,C,22,GSW,82,82,2656,352,791,.445,0,2,.000,352,789,.446,.445,267,399,.669,272,443,715,94,39,139,175,281,971
88,Antonio Daniels\daniean01,SG,22,VAN,74,50,1956,228,548,.416,11,52,.212,217,496,.438,.426,112,170,.659,22,121,143,334,55,10,164,88,579
89,Lloyd Daniels\daniell01,SG,30,TOR,6,0,82,12,29,.414,2,9,.222,10,20,.500,.448,8,10,.800,4,3,7,4,3,2,4,4,34
90,Yinka Dare\dareyi01,C,25,NJN,10,0,60,4,18,.222,0,0,,4,18,.222,.222,4,8,.500,10,7,17,1,0,2,2,9,12
91,Antonio Davis\davisan01,PF,29,IND,82,12,2191,254,528,.481,0,3,.000,254,525,.484,.481,277,398,.696,192,368,560,61,45,72,103,234,785
92,Ben Davis\davisbe01,PF,25,NYK,7,0,13,2,10,.200,0,0,,2,10,.200,.200,0,0,,6,0,6,0,1,0,0,3,4
93,Dale Davis\davisda01,C,28,IND,78,78,2174,273,498,.548,0,0,,273,498,.548,.548,80,172,.465,233,378,611,70,51,87,73,209,626
94,Emanual Davis\davisem01,PG,29,HOU,45,0,599,63,142,.444,27,72,.375,36,70,.514,.539,31,37,.838,10,37,47,59,17,3,52,55,184
95,Hubert Davis\davishu01,SG,27,DAL,81,30,2378,350,767,.456,101,230,.439,249,537,.464,.522,97,116,.836,34,135,169,157,43,5,88,117,898
96,Mark Davis\davisma02,SF,24,PHI,71,12,906,109,244,.447,0,6,.000,109,238,.458,.447,64,101,.634,64,94,158,73,49,18,91,95,282
97,Terry Davis\daviste01,PF,30,WAS,74,66,1705,127,256,.496,0,1,.000,127,255,.498,.496,69,119,.580,209,271,480,30,41,24,56,193,323
98,Todd Day\dayto01,SG,28,MIA,5,0,69,11,31,.355,2,12,.167,9,19,.474,.387,6,9,.667,4,2,6,7,7,0,3,10,30
99,Andrew DeClercq\declean01,C,24,BOS,81,49,1523,169,340,.497,0,1,.000,169,339,.499,.497,101,168,.601,180,212,392,59,85,49,84,277,439
100,Terry Dehere\deherte01,PG,26,SAC,77,18,1410,180,451,.399,50,132,.379,130,319,.408,.455,79,99,.798,21,85,106,196,52,4,96,150,489
101,Vinny Del Negro\delnevi01,SG,31,SAS,54,38,1721,211,479,.441,17,39,.436,194,440,.441,.458,74,93,.796,13,139,152,183,39,6,53,113,513
102,Bison Dele\delebi01,C,28,DET,78,78,2619,531,1040,.511,1,3,.333,530,1037,.511,.511,198,280,.707,223,472,695,94,67,55,181,252,1261
103,Tony Delk\delkto01,PG,24,TOT,77,9,1681,314,798,.393,42,157,.268,272,641,.424,.420,111,151,.735,38,134,172,172,73,12,109,96,781
104,Vlade Divac\divacvl01,C,29,CHH,64,41,1805,267,536,.498,3,14,.214,264,522,.506,.501,130,188,.691,183,335,518,172,83,94,114,179,667
105,Sherman Douglas\douglsh01,PG,31,NJN,80,11,1699,255,515,.495,14,46,.304,241,469,.514,.509,115,172,.669,52,83,135,319,55,7,110,156,639
106,Clyde Drexler*\drexlcl01,SG,35,HOU,70,70,2473,452,1059,.427,106,334,.317,346,725,.477,.477,277,346,.801,105,241,346,382,126,42,189,193,1287
107,Chris Dudley\dudlech02,C,32,NYK,51,22,858,58,143,.406,0,0,,58,143,.406,.406,41,92,.446,108,167,275,21,13,51,44,139,157
108,Joe Dumars*\dumarjo01,SG,34,DET,72,72,2326,329,791,.416,158,426,.371,171,365,.468,.516,127,154,.825,14,90,104,253,44,2,84,99,943
109,Tony Dumas\dumasto01,SG,25,CLE,7,0,47,6,12,.500,2,4,.500,4,8,.500,.583,0,3,.000,1,4,5,5,0,0,5,5,14
110,Tim Duncan\duncati01,PF,21,SAS,82,82,3204,706,1287,.549,0,10,.000,706,1277,.553,.549,319,482,.662,274,703,977,224,55,206,279,254,1731
111,Ledell Eackles\eacklle01,SG,31,WAS,42,0,547,75,175,.429,16,46,.348,59,129,.457,.474,52,59,.881,25,50,75,16,17,0,29,43,218
112,Tyus Edney\edneyty01,PG,24,BOS,52,7,623,93,216,.431,3,10,.300,90,206,.437,.438,88,111,.793,20,35,55,139,51,1,66,69,277
113,Blue Edwards\edwarbl01,SG,32,VAN,81,20,1968,326,742,.439,40,120,.333,286,622,.460,.466,180,215,.837,61,156,217,201,86,27,134,183,872
114,Kevin Edwards\edwarke01,SG,32,TOT,39,5,487,57,165,.345,6,15,.400,51,150,.340,.364,30,35,.857,20,34,54,39,26,1,30,28,150
115,Howard Eisley\eisleho01,PG,25,UTA,82,18,1726,229,519,.441,48,118,.407,181,401,.451,.487,127,149,.852,25,141,166,346,54,13,160,182,633
116,Mario Elie\eliema01,SF,34,HOU,73,59,1988,206,456,.452,55,189,.291,151,267,.566,.512,145,174,.833,39,117,156,221,81,8,100,115,612
117,Sean Elliott\elliose01,SF,29,SAS,36,36,1012,122,303,.403,34,90,.378,88,213,.413,.459,56,78,.718,16,108,124,62,24,14,57,92,334
118,Dale Ellis\ellisda01,SF,37,SEA,79,0,1939,348,700,.497,127,274,.464,221,426,.519,.588,111,142,.782,51,133,184,89,60,5,74,128,934
119,Harold Ellis\ellisha01,SF,27,DEN,27,3,344,62,111,.559,0,4,.000,62,107,.579,.559,40,63,.635,27,23,50,18,19,4,19,53,164
120,LaPhonso Ellis\ellisla01,SF,27,DEN,76,71,2575,410,1007,.407,57,201,.284,353,806,.438,.435,206,256,.805,146,398,544,213,65,49,173,226,1083
121,Pervis Ellison\ellispe01,PF,30,BOS,33,8,447,40,70,.571,0,0,,40,70,.571,.571,20,34,.588,52,57,109,31,20,31,28,90,100
122,Brian Evans\evansbr01,SF,24,TOT,72,1,893,123,312,.394,29,87,.333,94,225,.418,.441,46,57,.807,49,88,137,55,29,13,38,101,321
123,Patrick Ewing*\ewingpa01,C,35,NYK,26,26,848,203,403,.504,0,2,.000,203,401,.506,.504,134,186,.720,59,206,265,28,16,58,77,74,540
124,Tony Farmer\farmeto01,C,28,CHH,27,2,169,17,53,.321,2,9,.222,15,44,.341,.340,31,39,.795,16,16,32,5,10,4,9,23,67
125,Jamie Feick\feickja01,PF,23,MIL,45,2,450,39,90,.433,4,13,.308,35,77,.455,.456,20,41,.488,45,79,124,16,25,17,21,67,102
126,Duane Ferrell\ferredu01,SF,32,GSW,50,5,461,41,111,.369,0,6,.000,41,105,.390,.369,12,22,.545,25,22,47,26,21,6,18,50,94
127,Danny Ferry\ferryda01,PF,31,CLE,69,3,1034,113,286,.395,33,99,.333,80,187,.428,.453,32,40,.800,23,91,114,59,26,17,53,118,291
128,Michael Finley\finlemi01,SF,24,DAL,82,82,3394,675,1505,.449,87,244,.357,588,1261,.466,.477,326,416,.784,150,288,438,405,132,30,219,163,1763
129,Derek Fisher\fishede01,PG,23,LAL,82,36,1760,164,378,.434,31,81,.383,133,297,.448,.475,115,152,.757,38,155,193,333,75,5,119,126,474
130,Danny Fortson\fortsda01,PF,21,DEN,80,23,1811,276,611,.452,1,3,.333,275,608,.452,.453,263,339,.776,182,266,448,76,44,30,157,314,816
131,Greg Foster\fostegr01,C,29,UTA,78,49,1446,186,418,.445,2,9,.222,184,409,.450,.447,67,87,.770,85,188,273,51,15,28,68,187,441
132,Rick Fox\foxri01,SF,28,LAL,82,82,2709,363,771,.471,86,265,.325,277,506,.547,.527,171,230,.743,78,280,358,276,100,48,201,309,983
133,Adonal Foyle\foylead01,C,22,GSW,55,1,656,69,170,.406,0,1,.000,69,169,.408,.406,27,62,.435,73,111,184,14,13,52,50,94,165
134,Todd Fuller\fulleto02,C,23,GSW,57,1,613,86,205,.420,0,4,.000,86,201,.428,.420,55,80,.688,61,135,196,10,6,16,37,89,227
135,Lawrence Funderburke\fundela01,PF,27,SAC,52,1,1094,191,390,.490,1,7,.143,190,383,.496,.491,110,162,.679,80,154,234,63,19,15,62,56,493
136,Chris Garner\garnech01,PG,22,TOR,38,0,293,23,70,.329,4,14,.286,19,56,.339,.357,3,7,.429,7,17,24,45,21,4,25,50,53
137,Kevin Garnett\garneke01,PF,21,MIN,82,82,3222,635,1293,.491,3,16,.188,632,1277,.495,.492,245,332,.738,222,564,786,348,139,150,192,224,1518
138,Dean Garrett\garrede01,C,31,DEN,82,82,2632,242,565,.428,0,0,,242,565,.428,.428,114,176,.648,227,417,644,90,57,133,84,197,598
139,Kiwane Garris\garriki01,SG,23,DEN,28,0,225,22,65,.338,5,14,.357,17,51,.333,.377,19,25,.760,3,16,19,28,7,1,15,22,68
140,Chris Gatling\gatlich01,PF,30,NJN,57,16,1359,248,545,.455,1,4,.250,247,541,.457,.456,159,265,.600,118,216,334,53,52,29,99,152,656
141,Reggie Geary\gearyre01,PG,24,SAS,62,2,685,56,169,.331,12,40,.300,44,129,.341,.367,28,56,.500,19,48,67,74,37,12,42,95,152
142,Matt Geiger\geigema01,C,28,CHH,78,42,1839,358,709,.505,1,11,.091,357,698,.511,.506,168,236,.712,196,325,521,78,68,87,111,191,885
143,Kendall Gill\gillke01,SF,29,NJN,81,81,2733,418,974,.429,26,101,.257,392,873,.449,.443,225,327,.688,112,279,391,200,156,64,124,268,1087
144,Armen Gilliam\gilliar01,PF,33,MIL,82,25,2114,327,676,.484,0,4,.000,327,672,.487,.484,267,333,.802,146,293,439,104,65,37,148,177,921
145,Anthony Goldwire\goldwan01,PG,26,DEN,82,32,2212,269,636,.423,63,164,.384,206,472,.436,.472,150,186,.806,40,107,147,277,86,7,85,149,751
146,Greg Graham\grahagr01,SG,27,CLE,6,0,56,7,12,.583,0,3,.000,7,9,.778,.583,2,2,1.000,0,1,1,6,1,0,10,7,16
147,Brian Grant\grantbr01,SF,25,POR,61,49,1921,283,557,.508,0,1,.000,283,556,.509,.508,171,228,.750,197,358,555,86,44,45,110,184,737
148,Gary Grant\grantga01,PG,32,POR,22,2,359,43,93,.462,7,19,.368,36,74,.486,.500,12,14,.857,8,40,48,84,17,2,24,30,105
149,Harvey Grant\grantha01,SF,32,WAS,65,8,895,75,196,.383,1,6,.167,74,190,.389,.385,19,30,.633,60,108,168,39,23,15,26,94,170
150,Horace Grant\grantho01,C,32,ORL,76,76,2803,393,857,.459,0,7,.000,393,850,.462,.459,135,199,.678,228,390,618,172,81,79,88,180,921
151,Ed Gray\grayed01,SG,22,ATL,30,3,472,77,202,.381,18,46,.391,59,156,.378,.426,55,65,.846,9,36,45,34,15,11,30,73,227
152,Jeff Grayer\grayeje01,SG,32,TOT,5,0,34,4,11,.364,2,6,.333,2,5,.400,.455,0,0,,0,4,4,2,2,0,4,7,10
153,A.C. Green\greenac01,PF,34,DAL,82,68,2649,242,534,.453,0,4,.000,242,530,.457,.453,116,162,.716,219,449,668,123,78,27,68,157,600
154,Litterial Green\greenli01,PG,27,MIL,21,0,124,5,23,.217,0,2,.000,5,21,.238,.217,15,20,.750,1,6,7,16,4,0,8,11,25
155,Derek Grimm\grimmde01,SF,23,SAC,9,0,34,4,14,.286,4,12,.333,0,2,.000,.429,2,2,1.000,0,4,4,0,3,1,3,6,14
156,Tom Gugliotta\guglito01,SF,28,MIN,41,41,1582,319,635,.502,2,17,.118,317,618,.513,.504,183,223,.821,106,250,356,167,61,22,109,102,823
157,Jack Haley\haleyja01,C,34,NJN,16,0,51,5,18,.278,0,1,.000,5,17,.294,.278,12,21,.571,5,10,15,0,0,1,4,9,22
158,Darvin Ham\hamda01,SF,24,WAS,71,3,635,55,104,.529,0,0,,55,104,.529,.529,35,74,.473,72,59,131,16,21,25,37,118,145
159,Tom Hammonds\hammoto01,PF,30,MIN,57,2,1140,127,246,.516,0,1,.000,127,245,.518,.516,92,132,.697,100,171,271,36,15,17,48,127,346
160,Reggie Hanson\hansore01,SF,29,BOS,8,0,26,3,6,.500,0,0,,3,6,.500,.500,0,0,,3,3,6,1,2,1,3,8,6
161,Anfernee Hardaway\hardaan01,SG,26,ORL,19,15,625,103,273,.377,15,50,.300,88,223,.395,.405,90,118,.763,8,68,76,68,28,15,46,45,311
162,Tim Hardaway\hardati01,PG,31,MIA,81,81,3031,558,1296,.431,155,442,.351,403,854,.472,.490,257,329,.781,48,251,299,672,136,16,224,200,1528
163,Derek Harper\harpede01,SG,36,ORL,66,45,1761,226,542,.417,59,164,.360,167,378,.442,.471,55,79,.696,23,80,103,233,72,10,101,140,566
164,Ron Harper\harpero01,PG,34,CHI,82,82,2284,293,665,.441,16,84,.190,277,581,.477,.453,162,216,.750,107,183,290,241,108,48,91,181,764
165,Othella Harrington\harriot01,PF,24,HOU,58,3,903,129,266,.485,0,1,.000,129,265,.487,.485,92,122,.754,73,134,207,24,10,27,47,112,350
166,Lucious Harris\harrilu01,SG,27,NJN,50,0,671,69,177,.390,12,39,.308,57,138,.413,.424,41,55,.745,21,31,52,42,42,5,21,77,191
167,Hersey Hawkins\hawkihe01,SG,31,SEA,82,82,2597,280,636,.440,125,301,.415,155,335,.463,.539,177,204,.868,71,263,334,221,148,17,102,153,862
168,Alan Henderson\hendeal01,PF,25,ATL,69,33,2000,365,753,.485,3,6,.500,362,747,.485,.487,253,388,.652,200,242,442,73,42,36,110,175,986
169,Cedric Henderson\hendece02,SF,22,CLE,82,71,2527,348,725,.480,0,4,.000,348,721,.483,.480,136,190,.716,71,254,325,168,96,45,165,238,832
170,Mark Hendrickson\hendrma01,PF,23,SAC,48,1,737,58,149,.389,0,5,.000,58,144,.403,.389,47,57,.825,33,110,143,41,26,9,31,60,163
171,Steve Henson\hensost01,PG,29,DET,23,0,65,13,26,.500,3,8,.375,10,18,.556,.558,7,7,1.000,0,2,2,4,1,0,6,9,36
172,Carl Herrera\herreca01,PF,31,SAS,58,1,516,76,175,.434,0,1,.000,76,174,.437,.434,18,44,.409,24,67,91,22,19,12,38,71,170
173,Sean Higgins\higgise01,SF,29,POR,2,0,12,0,5,.000,0,2,.000,0,3,.000,.000,0,0,,0,0,0,0,2,0,1,3,0
174,Grant Hill*\hillgr01,SF,25,DET,81,81,3294,615,1361,.452,3,21,.143,612,1340,.457,.453,479,647,.740,93,530,623,551,143,53,285,196,1712
175,Tyrone Hill\hillty01,PF,29,MIL,57,56,2064,208,418,.498,0,1,.000,208,417,.499,.498,155,255,.608,212,396,608,88,67,30,106,230,571
176,Fred Hoiberg\hoibefr01,SG,25,IND,65,1,874,85,222,.383,32,85,.376,53,137,.387,.455,59,69,.855,14,109,123,45,40,3,22,101,261
177,Jerald Honeycutt\honeyje01,PF,23,MIL,38,0,530,90,221,.407,29,77,.377,61,144,.424,.473,36,58,.621,27,66,93,33,20,6,49,83,245
178,Jeff Hornacek\hornaje01,SG,34,UTA,80,80,2460,399,828,.482,56,127,.441,343,701,.489,.516,285,322,.885,65,205,270,349,109,15,132,175,1139
179,Robert Horry\horryro01,PF,27,LAL,72,71,2192,200,420,.476,19,93,.204,181,327,.554,.499,117,169,.692,186,356,542,163,112,94,99,238,536
180,Allan Houston\houstal01,SG,26,NYK,82,82,2848,571,1277,.447,82,213,.385,489,1064,.460,.479,285,335,.851,43,231,274,212,63,24,200,207,1509
181,Juwan Howard\howarju01,PF,24,WAS,64,64,2559,463,991,.467,0,2,.000,463,989,.468,.467,258,358,.721,161,288,449,208,82,23,185,225,1184
182,Stephen Howard\howarst01,SF,27,SEA,13,0,53,8,21,.381,0,0,,8,21,.381,.381,9,18,.500,6,6,12,3,3,1,6,13,25
183,Troy Hudson\hudsotr01,PG,21,UTA,8,0,23,6,14,.429,0,3,.000,6,11,.545,.429,0,0,,1,1,2,4,2,0,1,1,12
184,Lindsey Hunter\hunteli01,PG,27,DET,71,67,2505,316,826,.383,85,265,.321,231,561,.412,.434,145,196,.740,61,186,247,224,123,10,110,174,862
185,Bobby Hurley\hurlebo01,PG,26,TOT,61,3,875,93,238,.391,5,22,.227,88,216,.407,.401,59,76,.776,12,54,66,177,23,0,86,79,250
186,Zydrunas Ilgauskas\ilgauzy01,C,22,CLE,82,81,2379,454,876,.518,1,4,.250,453,872,.519,.519,230,302,.762,279,444,723,71,52,135,146,288,1139
187,Allen Iverson*\iversal01,PG,22,PHI,80,80,3150,649,1407,.461,70,235,.298,579,1172,.494,.486,390,535,.729,86,210,296,494,176,25,244,200,1758
188,Bobby Jackson\jacksbo01,PG,24,DEN,68,53,2042,310,791,.392,21,81,.259,289,710,.407,.405,149,183,.814,78,224,302,317,105,11,184,160,790
189,Jaren Jackson\jacksja01,SG,30,SAS,82,45,2226,258,654,.394,112,297,.377,146,357,.409,.480,94,118,.797,55,155,210,156,60,8,104,222,722
190,Jim Jackson\jacksji01,SG,27,TOT,79,78,3046,476,1107,.430,61,191,.319,415,916,.453,.458,229,282,.812,130,270,400,381,79,8,263,186,1242
191,Mark Jackson\jacksma01,PG,32,IND,82,82,2413,249,598,.416,43,137,.314,206,461,.447,.452,137,180,.761,67,255,322,713,84,2,174,132,678
192,Henry James\jameshe01,PF,32,CLE,28,0,166,24,59,.407,11,25,.440,13,34,.382,.500,21,22,.955,2,13,15,5,1,1,12,24,80
193,Anthony Johnson\johnsan02,PG,23,SAC,77,62,2266,226,609,.371,42,128,.328,184,481,.383,.406,80,110,.727,51,120,171,329,64,6,120,188,574
194,Avery Johnson\johnsav01,PG,32,SAS,75,73,2674,321,671,.478,2,13,.154,319,658,.485,.480,122,168,.726,30,120,150,591,84,18,165,140,766
195,Eddie Johnson\johnsed03,SF,38,HOU,75,1,1490,227,544,.417,66,198,.333,161,346,.465,.478,113,136,.831,50,103,153,88,32,3,62,89,633
196,Ervin Johnson\johnser02,C,30,MIL,81,81,2261,253,471,.537,0,0,,253,471,.537,.537,143,238,.601,242,443,685,59,79,158,117,321,649
197,Kevin Johnson\johnske02,PG,31,PHO,50,12,1290,155,347,.447,4,26,.154,151,321,.470,.452,162,186,.871,35,129,164,245,27,8,101,57,476
198,Larry Johnson\johnsla02,SF,28,NYK,70,70,2412,429,884,.485,15,63,.238,414,821,.504,.494,214,283,.756,175,226,401,150,40,13,127,193,1087
199,Charles Jones\jonesch01,PF,40,HOU,24,0,127,7,10,.700,0,0,,7,10,.700,.700,1,2,.500,12,12,24,5,1,6,4,22,15
200,Dontae' Jones\jonesdo01,SF,22,BOS,15,0,91,19,57,.333,6,23,.261,13,34,.382,.386,0,0,,3,6,9,5,2,3,11,12,44
201,Eddie Jones\jonesed02,SG,26,LAL,80,80,2910,486,1005,.484,143,368,.389,343,637,.538,.555,234,306,.765,85,217,302,246,160,55,146,164,1349
202,Popeye Jones\jonespo01,PF,27,TOR,14,4,352,52,127,.409,2,3,.667,50,124,.403,.417,14,19,.737,50,52,102,18,10,3,16,39,120
203,Michael Jordan*\jordami01,SG,34,CHI,82,82,3181,881,1893,.465,30,126,.238,851,1767,.482,.473,565,721,.784,130,345,475,283,141,45,185,151,2357
204,Reggie Jordan\jordare01,SG,30,MIN,57,1,487,54,113,.478,0,1,.000,54,112,.482,.478,41,72,.569,57,40,97,50,35,9,30,63,149
205,Adam Keefe\keefead01,C,27,UTA,80,75,2047,229,424,.540,0,0,,229,424,.540,.540,162,200,.810,179,259,438,89,52,24,71,172,620
206,Shawn Kemp\kempsh01,PF,28,CLE,80,80,2769,518,1164,.445,2,8,.250,516,1156,.446,.446,404,556,.727,219,526,745,197,108,90,271,310,1442
207,Tim Kempton\kemptti01,PF,34,TOT,8,0,47,2,9,.222,0,0,,2,9,.222,.222,0,0,,4,2,6,3,1,2,4,10,4
208,Steve Kerr\kerrst01,PG,32,CHI,50,0,1119,137,302,.454,57,130,.438,80,172,.465,.548,45,49,.918,14,63,77,96,26,5,27,71,376
209,Jerome Kersey\kerseje01,SF,35,SEA,37,2,717,97,233,.416,1,10,.100,96,223,.430,.418,39,65,.600,56,79,135,44,52,14,36,104,234
210,Jason Kidd*\kiddja01,PG,24,PHO,82,82,3118,357,859,.416,73,233,.313,284,626,.454,.458,167,209,.799,108,402,510,745,162,26,261,142,954
211,Kerry Kittles\kittlke01,SG,23,NJN,77,76,2814,508,1154,.440,110,263,.418,398,891,.447,.488,202,250,.808,132,230,362,176,132,37,106,152,1328
212,Joe Kleine\kleinjo01,C,36,CHI,46,1,397,39,106,.368,0,0,,39,106,.368,.368,15,18,.833,27,50,77,30,4,5,28,63,93
213,Brevin Knight\knighbr01,PG,22,CLE,80,76,2483,261,592,.441,0,7,.000,261,585,.446,.441,201,251,.801,67,186,253,656,196,18,194,271,723
214,Travis Knight\knightr01,C,23,BOS,74,21,1503,193,438,.441,15,55,.273,178,383,.465,.458,81,103,.786,146,219,365,104,54,82,87,253,482
215,Toni Kukoc\kukocto01,SF,29,CHI,74,52,2235,383,841,.455,63,174,.362,320,667,.480,.493,155,219,.708,121,206,327,314,76,37,154,149,984
216,Christian Laettner\laettch01,PF,28,ATL,74,49,2282,354,730,.485,6,27,.222,348,703,.495,.489,306,354,.864,142,345,487,190,71,73,183,246,1020
217,Andrew Lang\langan01,C,31,MIL,57,0,692,54,143,.378,0,1,.000,54,142,.380,.378,44,57,.772,56,97,153,16,18,27,33,101,152
218,Antonio Lang\langan02,SF,25,MIA,6,0,29,3,5,.600,0,0,,3,5,.600,.600,6,8,.750,2,3,5,1,2,0,4,3,12
219,Rusty LaRue\larueru01,PG,24,CHI,14,0,140,20,49,.408,4,16,.250,16,33,.485,.449,5,8,.625,1,7,8,5,3,1,6,12,49
220,Priest Lauderdale\laudepr01,C,24,DEN,39,0,345,53,127,.417,0,0,,53,127,.417,.417,38,69,.551,27,73,100,21,7,17,46,63,144
221,Jason Lawson\lawsoja01,C,23,ORL,17,0,80,9,15,.600,0,0,,9,15,.600,.600,8,10,.800,8,19,27,5,4,4,2,14,26
222,Tim Legler\legleti01,SG,31,WAS,8,0,76,3,19,.158,0,6,.000,3,13,.231,.158,3,4,.750,2,2,4,3,1,0,4,11,9
223,Voshon Lenard\lenarvo01,SG,24,MIA,81,81,2621,363,854,.425,153,378,.405,210,476,.441,.515,141,179,.788,72,220,292,180,58,16,99,219,1020
224,Alton Lister\listeal01,C,39,POR,7,0,44,3,8,.375,0,0,,3,8,.375,.375,0,0,,2,9,11,1,1,1,2,12,6
225,Randy Livingston\livinra01,PG,22,ATL,12,0,82,3,12,.250,0,0,,3,12,.250,.250,4,5,.800,1,5,6,5,7,2,6,6,10
226,Horacio Llamas Grey\llamaho01,C,24,PHO,8,0,42,8,21,.381,1,3,.333,7,18,.389,.405,7,10,.700,4,14,18,1,1,3,9,14,24
227,Brad Lohaus\lohaubr01,PF,33,SAS,9,0,102,7,21,.333,4,14,.286,3,7,.429,.429,1,3,.333,3,9,12,5,1,2,3,10,19
228,Grant Long\longgr01,PF,31,DET,40,17,739,50,117,.427,0,4,.000,50,113,.442,.427,41,57,.719,57,93,150,25,29,12,22,91,141
229,Luc Longley\longllu01,C,29,CHI,58,58,1703,277,609,.455,0,0,,277,609,.455,.455,109,148,.736,113,228,341,161,34,62,130,206,663
230,George Lynch\lynchge01,SF,27,VAN,82,0,1493,248,516,.481,9,30,.300,239,486,.492,.489,111,158,.703,147,215,362,122,65,41,104,161,616
231,Sam Mack\macksa01,SF,27,VAN,57,54,1414,222,559,.397,110,269,.409,112,290,.386,.496,62,77,.805,30,103,133,101,41,11,69,117,616
232,Don MacLean\macledo01,SF,28,NJN,9,0,42,1,10,.100,1,2,.500,0,8,.000,.150,0,0,,3,2,5,0,0,0,2,7,3
233,Gerald Madkins\madkige01,SG,28,GSW,19,0,243,13,34,.382,6,15,.400,7,19,.368,.471,5,7,.714,2,13,15,45,13,1,13,18,37
234,Rick Mahorn\mahorri01,C,39,DET,59,0,707,59,129,.457,0,0,,59,129,.457,.457,23,34,.676,65,130,195,15,14,7,37,123,141
235,Dan Majerle\majerda01,SG,32,MIA,72,22,1928,184,439,.419,111,295,.376,73,144,.507,.546,40,51,.784,48,220,268,157,68,15,65,139,519
236,Karl Malone*\malonka01,PF,34,UTA,81,81,3030,780,1472,.530,2,6,.333,778,1466,.531,.531,628,825,.761,189,645,834,316,96,70,247,237,2190
237,Matt Maloney\malonma01,PG,26,HOU,78,78,2217,239,586,.408,126,346,.364,113,240,.471,.515,65,78,.833,16,126,142,219,62,5,107,99,669
238,Danny Manning\mannida01,PF,31,PHO,70,11,1794,390,756,.516,0,7,.000,390,749,.521,.516,167,226,.739,110,282,392,139,71,46,100,201,947
239,Stephon Marbury\marbust01,PG,20,MIN,82,81,3112,513,1237,.415,95,304,.313,418,933,.448,.453,329,450,.731,58,172,230,704,104,7,256,222,1450
240,Donyell Marshall\marshdo01,SF,24,GSW,73,73,2611,451,1090,.414,63,201,.313,388,889,.436,.443,158,216,.731,210,418,628,159,95,73,147,226,1123
241,Darrick Martin\martida01,PG,26,LAC,82,63,2299,275,730,.377,107,293,.365,168,437,.384,.450,184,217,.848,19,145,164,331,82,10,154,198,841
242,Jamal Mashburn\mashbja01,SF,25,MIA,48,48,1729,251,577,.435,37,122,.303,214,455,.470,.467,184,231,.797,72,164,236,132,43,14,108,137,723
243,Anthony Mason\masonan01,PF,31,CHH,81,80,3148,389,764,.509,0,4,.000,389,760,.512,.509,261,402,.649,177,649,826,342,68,18,146,182,1039
244,Tony Massenburg\masseto01,C,30,VAN,61,13,894,148,309,.479,0,0,,148,309,.479,.479,100,137,.730,80,152,232,21,25,24,60,123,396
245,Vernon Maxwell\maxweve01,SG,32,TOT,42,0,636,103,258,.399,37,112,.330,66,146,.452,.471,48,60,.800,14,43,57,52,16,4,40,71,291
246,Lee Mayberry\maybele01,PG,27,VAN,79,32,1835,131,349,.375,63,180,.350,68,169,.402,.466,38,51,.745,19,95,114,349,65,10,113,164,363
247,Bob McCann\mccanbo01,SF,33,TOR,1,0,5,0,1,.000,0,0,,0,1,.000,.000,0,0,,0,1,1,0,0,0,0,1,0
248,Walter McCarty\mccarwa01,SF,23,BOS,82,64,2340,295,730,.404,54,175,.309,241,555,.434,.441,144,194,.742,141,223,364,177,110,44,141,274,788
249,George McCloud\mccloge01,SF,30,PHO,63,13,1213,173,427,.405,71,208,.341,102,219,.466,.488,39,51,.765,45,173,218,84,54,13,63,132,456
250,Xavier McDaniel\mcdanxa01,SF,34,NJN,20,0,180,10,30,.333,0,0,,10,30,.333,.333,5,8,.625,12,19,31,9,3,2,8,23,25
251,Michael McDonald\mcdonmi01,C,28,CHH,1,0,4,0,0,,0,0,,0,0,,,0,0,,1,0,1,0,0,0,2,1,0
252,Antonio McDyess\mcdyean01,PF,23,PHO,81,81,2441,497,927,.536,0,2,.000,497,925,.537,.536,231,329,.702,206,407,613,106,100,135,142,292,1225
253,Tracy McGrady*\mcgratr01,SF,18,TOR,64,17,1179,179,398,.450,14,41,.341,165,357,.462,.467,79,111,.712,105,164,269,98,49,61,66,86,451
254,Jim McIlvaine\mcilvji01,C,25,SEA,78,72,1211,101,223,.453,0,3,.000,101,220,.459,.453,45,81,.556,96,163,259,19,24,137,54,240,247
255,Derrick McKey\mckeyde01,SF,31,IND,57,4,1316,150,327,.459,4,17,.235,146,310,.471,.465,55,77,.714,74,137,211,88,57,30,79,156,359
256,Aaron McKie\mckieaa01,SG-SF,25,TOT,81,32,1813,139,381,.365,12,63,.190,127,318,.399,.381,42,55,.764,58,173,231,175,101,13,76,164,332
257,Nate McMillan\mcmilna01,SG,33,SEA,18,1,279,23,67,.343,15,34,.441,8,33,.242,.455,1,1,1.000,13,27,40,55,14,4,12,41,62
258,Ron Mercer\mercero01,SG,21,BOS,80,62,2662,515,1145,.450,3,28,.107,512,1117,.458,.451,188,224,.839,109,171,280,176,125,17,132,213,1221
259,Marko Milic\milicma01,SF,20,PHO,33,0,163,39,64,.609,3,6,.500,36,58,.621,.633,11,17,.647,10,15,25,12,10,0,21,17,92
260,Anthony Miller\millean01,PF,26,ATL,37,0,228,29,52,.558,0,0,,29,52,.558,.558,21,39,.538,30,40,70,3,15,3,14,41,79
261,Oliver Miller\milleol01,C,27,TOR,64,53,1628,170,369,.461,0,4,.000,170,365,.466,.461,61,101,.604,146,254,400,196,58,72,131,184,401
262,Reggie Miller*\millere01,SG,32,IND,81,81,2795,516,1081,.477,164,382,.429,352,699,.504,.553,382,440,.868,46,186,232,171,78,11,128,148,1578
263,Chris Mills\millsch01,SF,28,NYK,80,29,2183,292,675,.433,40,137,.292,252,538,.468,.462,152,189,.804,120,288,408,133,45,30,107,218,776
264,Terry Mills\millste01,PF,30,MIA,50,0,782,81,206,.393,25,81,.309,56,125,.448,.454,25,33,.758,34,118,152,39,19,9,45,129,212
265,Greg Minor\minorgr01,SG,26,BOS,69,16,1126,140,321,.436,6,31,.194,134,290,.462,.445,59,86,.686,55,95,150,88,53,11,43,100,345
266,Sam Mitchell\mitchsa01,SF,34,MIN,81,33,2239,371,800,.464,15,43,.349,356,757,.470,.473,243,292,.832,118,267,385,107,64,22,66,200,1000
267,Eric Montross\montrer01,C,26,TOT,48,30,691,61,144,.424,0,0,,61,144,.424,.424,16,40,.400,69,130,199,11,13,27,29,127,138
268,Chris Morris\morrich01,SF,32,UTA,54,1,538,85,207,.411,19,62,.306,66,145,.455,.457,44,61,.721,35,79,114,24,25,17,33,61,233
269,Lawrence Moten\motenla01,SG,25,WAS,8,0,27,3,13,.231,0,1,.000,3,12,.250,.231,3,4,.750,1,0,1,3,0,0,1,6,9
270,Alonzo Mourning*\mournal01,C,27,MIA,58,56,1939,403,732,.551,0,0,,403,732,.551,.551,309,465,.665,193,365,558,52,40,130,179,208,1115
271,Chris Mullin*\mullich01,SF,34,IND,82,82,2177,333,692,.481,107,243,.440,226,449,.503,.559,154,164,.939,38,211,249,186,95,39,117,186,927
272,Eric Murdock\murdoer01,PG,29,MIA,82,1,1395,177,419,.422,28,91,.308,149,328,.454,.456,125,156,.801,39,117,156,219,103,13,104,173,507
273,Lamond Murray\murrala01,SF,24,LAC,79,65,2579,473,984,.481,54,153,.353,419,831,.504,.508,220,294,.748,172,312,484,142,118,54,171,193,1220
274,Tracy Murray\murratr01,SF,26,WAS,82,12,2227,449,1007,.446,158,403,.392,291,604,.482,.524,182,209,.871,75,202,277,84,67,25,102,167,1238
275,Dikembe Mutombo*\mutomdi01,C,31,ATL,82,82,2917,399,743,.537,0,0,,399,743,.537,.537,303,452,.670,276,656,932,82,34,277,168,254,1101
276,Martin Muursepp\muursma01,PF,23,DAL,41,7,603,83,191,.435,16,38,.421,67,153,.438,.476,51,67,.761,46,68,114,30,29,14,29,96,233
277,Pete Myers\myerspe01,SG,34,NYK,9,0,40,5,10,.500,0,0,,5,10,.500,.500,4,6,.667,5,5,10,3,4,0,4,7,14
278,Steve Nash*\nashst01,PG,23,PHO,76,9,1664,268,584,.459,81,195,.415,187,389,.481,.528,74,86,.860,32,128,160,262,63,4,98,145,691
279,Ivano Newbill\newbiiv01,PF,27,VAN,28,2,249,20,57,.351,1,1,1.000,19,56,.339,.360,17,30,.567,24,45,69,9,10,3,17,38,58
280,Johnny Newman\newmajo01,SF,34,DEN,74,15,2176,344,799,.431,36,105,.343,308,694,.444,.453,365,445,.820,50,91,141,138,77,24,147,208,1089
281,Jeff Nordgaard\nordgje01,PF,24,MIL,13,0,48,5,18,.278,0,0,,5,18,.278,.278,8,9,.889,4,10,14,3,2,0,3,7,18
282,Charles O'Bannon\obannch01,SG,22,DET,30,0,234,26,69,.377,0,3,.000,26,66,.394,.377,12,15,.800,14,19,33,17,9,1,9,15,64
283,Jermaine O'Neal\onealje01,PF,19,POR,60,9,808,112,231,.485,0,2,.000,112,229,.489,.485,45,89,.506,80,121,201,17,15,58,55,101,269
284,Shaquille O'Neal*\onealsh01,C,25,LAL,60,57,2175,670,1147,.584,0,0,,670,1147,.584,.584,359,681,.527,208,473,681,142,39,144,175,193,1699
285,Charles Oakley\oaklech01,PF,34,NYK,79,79,2734,307,698,.440,0,6,.000,307,692,.444,.440,97,114,.851,218,506,724,201,123,22,126,280,711
286,Hakeem Olajuwon*\olajuha01,C,35,HOU,47,45,1633,306,633,.483,0,3,.000,306,630,.486,.483,160,212,.755,116,344,460,143,84,96,126,152,772
287,Brian Oliver\olivebr01,SG,29,ATL,5,0,61,7,19,.368,0,0,,7,19,.368,.368,1,4,.250,3,6,9,2,1,0,1,4,15
288,Jimmy Oliver\oliveji01,SG,28,WAS,1,0,10,2,4,.500,1,2,.500,1,2,.500,.625,0,0,,0,2,2,1,0,0,0,1,5
289,Kevin Ollie\ollieke01,PG,25,TOT,35,0,430,37,98,.378,0,1,.000,37,97,.381,.378,49,70,.700,9,30,39,65,13,0,44,31,123
290,Greg Ostertag\ostergr01,C,24,UTA,63,23,1288,115,239,.481,0,0,,115,239,.481,.481,67,140,.479,134,240,374,25,28,132,74,166,297
291,Bo Outlaw\outlabo01,PF,26,ORL,82,76,2953,301,543,.554,1,4,.250,300,539,.557,.555,180,313,.575,255,382,637,216,107,181,175,260,783
292,Doug Overton\overtdo01,PG,28,PHI,23,2,277,24,63,.381,0,3,.000,24,60,.400,.381,14,16,.875,2,12,14,37,8,1,23,34,62
293,Billy Owens\owensbi01,SF,28,SAC,78,78,2348,338,728,.464,26,70,.371,312,658,.474,.482,116,197,.589,170,412,582,219,93,38,153,231,818
294,Robert Pack\packro01,PG,28,DAL,12,10,292,33,98,.337,3,6,.500,30,92,.326,.352,25,36,.694,8,26,34,42,20,1,38,17,94
295,Anthony Parker\parkean01,SG,22,PHI,37,0,196,25,63,.397,9,28,.321,16,35,.457,.468,13,20,.650,8,18,26,19,11,3,11,17,72
296,Cherokee Parks\parksch02,C,25,MIN,79,43,1703,224,449,.499,0,1,.000,224,448,.500,.499,110,169,.651,140,297,437,53,36,86,66,237,558
297,Gary Payton*\paytoga01,PG,29,SEA,82,82,3145,579,1278,.453,134,397,.338,445,881,.505,.505,279,375,.744,77,299,376,679,185,18,229,195,1571
298,Anthony Peeler\peelean01,SG,28,TOT,38,32,1193,190,420,.452,53,125,.424,137,295,.464,.515,36,47,.766,37,86,123,137,61,6,51,97,469
299,Will Perdue\perduwi01,C,32,SAS,79,30,1491,162,295,.549,0,1,.000,162,294,.551,.549,70,133,.526,177,358,535,57,22,50,81,137,394
300,Sam Perkins\perkisa01,PF,36,SEA,81,0,1675,196,471,.416,87,222,.392,109,249,.438,.508,101,128,.789,53,202,255,113,62,29,62,158,580
301,Elliot Perry\perryel01,PG,28,MIL,81,33,1752,241,561,.430,17,50,.340,224,511,.438,.445,92,109,.844,21,87,108,230,90,2,128,129,591
302,Chuck Person\persoch01,PF,33,SAS,61,11,1455,143,398,.359,95,276,.344,48,122,.393,.479,28,37,.757,17,187,204,86,29,10,67,121,409
303,Wesley Person\persowe01,SG,26,CLE,82,82,3198,440,957,.460,192,447,.430,248,510,.486,.560,132,170,.776,65,298,363,188,129,49,110,108,1204
304,Bobby Phills\phillbo01,SG,28,CHH,62,61,1887,246,552,.446,44,114,.386,202,438,.461,.486,106,140,.757,59,157,216,187,81,18,108,181,642
305,Eric Piatkowski\piatker01,SG,27,LAC,67,35,1740,257,568,.452,106,259,.409,151,309,.489,.546,140,170,.824,70,166,236,85,51,12,80,137,760
306,Ricky Pierce\piercri01,SG,38,MIL,39,0,442,52,143,.364,4,13,.308,48,130,.369,.378,43,52,.827,19,26,45,34,9,0,21,35,151
307,Scottie Pippen*\pippesc01,SF,32,CHI,44,44,1652,315,704,.447,61,192,.318,254,512,.496,.491,150,193,.777,53,174,227,254,79,43,109,116,841
308,Scot Pollard\pollasc01,C,22,DET,33,0,317,35,70,.500,0,0,,35,70,.500,.500,19,23,.826,34,40,74,9,8,10,12,48,89
309,Olden Polynice\polynol01,C,33,SAC,70,25,1458,249,542,.459,0,1,.000,249,541,.460,.459,52,115,.452,173,266,439,107,37,45,98,158,550
310,Mark Pope\popema01,SF,25,IND,28,0,193,14,41,.341,1,3,.333,13,38,.342,.354,10,17,.588,9,17,26,7,3,6,10,36,39
311,Terry Porter\portete01,PG,34,MIN,82,8,1786,259,577,.449,92,233,.395,167,344,.485,.529,167,195,.856,37,131,168,271,63,16,104,103,777
312,Vitaly Potapenko\potapvi01,C,22,CLE,80,0,1412,234,488,.480,0,1,.000,234,487,.480,.480,102,144,.708,110,203,313,57,27,28,132,198,570
313,Brent Price\pricebr01,PG,29,HOU,72,2,1332,128,310,.413,73,187,.390,55,123,.447,.531,77,98,.786,37,70,107,192,52,4,111,163,406
314,Mark Price\pricema01,PG,33,ORL,63,33,1430,229,531,.431,52,155,.335,177,376,.471,.480,87,103,.845,24,105,129,297,53,5,162,92,597
315,Theo Ratliff\ratlith01,C,24,TOT,82,67,2447,306,597,.513,0,0,,306,597,.513,.513,197,281,.701,221,326,547,57,50,258,116,292,809
316,Eldridge Recasner\recasel01,SG,30,ATL,59,14,1454,206,452,.456,62,148,.419,144,304,.474,.524,74,79,.937,32,110,142,117,41,1,91,94,548
317,Bryant Reeves\reevebr01,C,24,VAN,74,74,2527,492,941,.523,0,4,.000,492,937,.525,.523,223,316,.706,196,389,585,155,39,80,156,278,1207
318,Khalid Reeves\reevekh01,PG,25,DAL,82,54,1950,248,593,.418,56,152,.368,192,441,.435,.465,165,213,.775,54,131,185,230,80,10,130,195,717
319,Don Reid\reiddo01,PF,24,DET,68,44,994,94,176,.534,0,0,,94,176,.534,.534,50,71,.704,77,98,175,26,25,55,28,183,238
320,J.R. Reid\reidjr01,PF,29,CHH,79,1,1109,146,318,.459,3,8,.375,143,310,.461,.464,89,122,.730,72,138,210,51,35,19,65,172,384
321,Shawn Respert\respesh01,SG,25,TOT,57,4,911,130,293,.444,31,93,.333,99,200,.495,.497,48,61,.787,37,63,100,61,34,1,48,75,339
322,Rodrick Rhodes\rhodero01,SF,24,HOU,58,13,1070,112,305,.367,2,8,.250,110,297,.370,.370,111,180,.617,28,42,70,110,62,10,97,125,337
323,Glen Rice\ricegl01,SF,30,CHH,82,82,3295,634,1386,.457,130,300,.433,504,1086,.464,.504,428,504,.849,89,264,353,182,77,22,182,200,1826
324,Pooh Richardson\richapo01,PG,31,LAC,69,17,1252,124,333,.372,11,57,.193,113,276,.409,.389,30,43,.698,17,79,96,226,44,3,54,71,289
325,Mitch Richmond*\richmmi01,SG,32,SAC,70,70,2569,543,1220,.445,130,334,.389,413,886,.466,.498,407,471,.864,50,179,229,279,88,15,181,154,1623
326,Isaiah Rider\rideris01,SG,26,POR,74,66,2786,551,1302,.423,135,420,.321,416,882,.472,.475,221,267,.828,99,247,346,231,55,19,187,188,1458
327,Eric Riley\rileyer01,C,27,DAL,39,14,544,56,135,.415,0,1,.000,56,134,.418,.415,27,36,.750,43,90,133,22,15,46,37,80,139
328,Stanley Roberts\roberst01,C,27,MIN,74,44,1328,191,386,.495,0,0,,191,386,.495,.495,75,156,.481,109,254,363,27,24,72,70,226,457
329,Chris Robinson\robinch01,SG,23,TOT,35,0,414,65,174,.374,24,66,.364,41,108,.380,.443,8,16,.500,9,37,46,39,19,4,33,50,162
330,Clifford Robinson\robincl02,SF,31,PHO,80,64,2359,429,895,.479,27,84,.321,402,811,.496,.494,248,360,.689,152,258,410,170,92,90,140,249,1133
331,David Robinson*\robinda01,C,32,SAS,73,73,2457,544,1065,.511,1,4,.250,543,1061,.512,.511,485,660,.735,239,536,775,199,64,192,202,204,1574
332,Glenn Robinson\robingl01,SF,25,MIL,56,56,2294,534,1136,.470,25,65,.385,509,1071,.475,.481,215,266,.808,82,225,307,158,69,34,200,164,1308
333,James Robinson\robinja02,PG,27,LAC,70,13,1231,195,501,.389,74,225,.329,121,276,.438,.463,77,107,.720,37,74,111,135,37,10,97,101,541
334,Larry Robinson\robinla01,SF,30,VAN,6,0,41,6,19,.316,3,6,.500,3,13,.231,.395,2,2,1.000,2,10,12,1,4,0,2,0,17
335,Dennis Rodman*\rodmade01,PF,36,CHI,80,66,2856,155,360,.431,4,23,.174,151,337,.448,.436,61,111,.550,421,780,1201,230,47,18,147,238,375
336,Carlos Rogers\rogerca01,PF,26,TOT,21,0,376,47,91,.516,0,2,.000,47,89,.528,.516,18,32,.563,35,32,67,18,10,8,14,35,112
337,Rodney Rogers\rogerro01,SF,26,LAC,76,70,2499,426,935,.456,72,212,.340,354,723,.490,.494,225,328,.686,155,269,424,202,93,38,193,242,1149
338,Roy Rogers\rogerro02,PF,24,TOT,15,0,106,9,25,.360,0,0,,9,25,.360,.360,2,6,.333,8,9,17,2,3,8,5,18,20
339,Sean Rooks\rooksse01,C,28,LAL,41,1,425,46,101,.455,0,0,,46,101,.455,.455,47,79,.595,46,72,118,24,2,23,19,68,139
340,Jalen Rose\roseja01,SF,25,IND,82,0,1706,290,607,.478,25,73,.342,265,534,.496,.498,166,228,.728,28,167,195,155,56,14,132,171,771
341,Malik Rose\rosema01,PF,23,SAS,53,0,429,59,136,.434,1,3,.333,58,133,.436,.438,39,61,.639,40,50,90,19,21,7,44,79,158
342,Donald Royal\royaldo01,SF,31,TOT,31,5,323,25,69,.362,0,0,,25,69,.362,.362,29,33,.879,18,23,41,17,7,1,10,35,79
343,Clifford Rozier\roziecl01,C,25,MIN,6,0,30,3,6,.500,0,0,,3,6,.500,.500,0,1,.000,3,3,6,0,0,0,4,7,6
344,Bryon Russell\russebr01,SF,27,UTA,82,7,2219,226,525,.430,73,214,.341,153,311,.492,.500,213,278,.766,78,248,326,101,90,31,81,229,738
345,Arvydas Sabonis*\sabonar01,C,33,POR,73,73,2333,407,826,.493,30,115,.261,377,711,.530,.511,323,405,.798,149,580,729,218,65,80,190,267,1167
346,Kevin Salvadori\salvake01,C,27,SAC,16,0,87,1,13,.077,0,0,,1,13,.077,.077,3,6,.500,5,15,20,3,0,11,5,12,5
347,Danny Schayes\schayda01,C,38,ORL,74,33,1272,155,371,.418,0,0,,155,371,.418,.418,96,119,.807,97,145,242,44,34,33,61,182,406
348,Detlef Schrempf\schrede01,SF,35,SEA,78,78,2742,437,898,.487,61,147,.415,376,751,.501,.521,297,352,.844,135,419,554,341,60,19,168,205,1232
349,Dennis Scott\scottde01,SF,29,TOT,81,45,2290,329,828,.397,125,342,.365,204,486,.420,.473,105,130,.808,47,200,247,153,53,39,104,152,888
350,Shawnelle Scott\scottsh01,C,25,CLE,41,0,188,16,36,.444,0,0,,16,36,.444,.444,12,18,.667,20,39,59,8,6,8,10,45,44
351,Shea Seals\sealssh01,SG,22,LAL,4,0,9,1,8,.125,0,3,.000,1,5,.200,.125,2,4,.500,3,1,4,0,1,0,0,1,4
352,Malik Sealy\sealyma01,SF,27,DET,77,10,1641,216,505,.428,9,41,.220,207,464,.446,.437,150,182,.824,48,171,219,100,65,20,79,156,591
353,Rony Seikaly\seikaro01,C,32,TOT,56,49,1636,250,579,.432,0,2,.000,250,577,.433,.432,246,332,.741,146,247,393,77,28,43,146,164,746
354,God Shammgod\shammgo01,PG,21,WAS,20,0,146,19,58,.328,0,2,.000,19,56,.339,.328,23,30,.767,2,5,7,36,7,1,21,27,61
355,Brian Shaw\shawbr01,PG,31,TOT,59,34,1530,154,446,.345,28,95,.295,126,351,.359,.377,36,52,.692,37,178,215,261,49,17,99,148,372
356,Dickey Simpkins\simpkdi01,PF,25,TOT,40,0,433,48,89,.539,0,2,.000,48,87,.552,.539,36,70,.514,27,50,77,33,9,5,32,54,132
357,Reggie Slater\slatere01,PF,27,TOR,78,28,1662,211,459,.460,0,0,,211,459,.460,.460,203,322,.630,134,171,305,74,45,30,102,201,625
358,Charles Smith\smithch04,SG,22,TOT,34,0,292,49,125,.392,15,47,.319,34,78,.436,.452,6,11,.545,13,14,27,21,12,6,27,24,119
359,Joe Smith\smithjo02,PF,22,TOT,79,55,2344,464,1070,.434,0,8,.000,464,1062,.437,.434,227,293,.775,199,272,471,94,62,51,158,263,1155
360,Michael Smith\smithmi02,PF,25,TOT,48,33,1053,93,194,.479,0,1,.000,93,193,.482,.479,65,103,.631,120,186,306,88,41,15,51,95,251
361,Steve Smith\smithst01,SG,28,ATL,73,73,2857,489,1101,.444,97,276,.351,392,825,.475,.488,389,455,.855,133,176,309,292,75,29,176,219,1464
362,Tony Smith\smithto02,PG,29,MIL,7,0,80,8,24,.333,0,4,.000,8,20,.400,.333,3,4,.750,4,3,7,10,5,2,9,7,19
363,Rik Smits\smitsri01,C,31,IND,73,69,2085,514,1038,.495,0,3,.000,514,1035,.497,.495,188,240,.783,127,378,505,101,40,88,134,243,1216
364,Eric Snow\snower01,PG,24,TOT,64,0,918,79,184,.429,2,17,.118,77,167,.461,.435,49,71,.690,19,62,81,177,60,5,63,114,209
365,Felton Spencer\spencfe01,C,30,GSW,68,0,813,59,129,.457,0,0,,59,129,.457,.457,44,79,.557,93,133,226,17,23,37,49,175,162
366,Latrell Sprewell\sprewla01,SG,27,GSW,14,13,547,110,277,.397,9,48,.188,101,229,.441,.413,70,94,.745,7,44,51,68,19,5,44,26,299
367,Jerry Stackhouse\stackje01,SG-SF,23,TOT,79,37,2545,424,975,.435,47,195,.241,377,780,.483,.459,354,450,.787,105,161,266,241,89,59,224,175,1249
368,John Starks\starkjo01,SG,32,NYK,82,10,2188,372,947,.393,130,398,.327,242,549,.441,.461,185,235,.787,48,182,230,219,78,5,143,205,1059
369,Joe Stephens\stephjo01,SF,25,HOU,7,0,37,10,28,.357,3,10,.300,7,18,.389,.411,4,6,.667,3,3,6,1,2,0,2,2,27
370,Kebu Stewart\stewake01,PF,24,PHI,15,0,110,12,26,.462,0,0,,12,26,.462,.462,16,25,.640,9,22,31,2,5,2,8,13,40
371,Michael Stewart\stewami01,C,22,SAC,81,37,1761,155,323,.480,0,0,,155,323,.480,.480,65,142,.458,197,339,536,61,29,195,85,251,375
372,Bryant Stith\stithbr01,SG,27,DEN,31,15,718,75,225,.333,10,48,.208,65,177,.367,.356,75,86,.872,15,50,65,50,21,8,35,52,235
373,John Stockton*\stockjo01,PG,35,UTA,64,64,1858,270,511,.528,39,91,.429,231,420,.550,.567,191,231,.827,35,131,166,543,89,10,161,138,770
374,Ed Stokes\stokeed01,C,26,TOR,4,0,17,1,3,.333,0,0,,1,3,.333,.333,1,2,.500,1,3,4,1,1,2,2,4,3
375,Damon Stoudamire\stoudda01,PG,24,TOT,71,71,2839,448,1091,.411,91,304,.299,357,787,.454,.452,238,287,.829,87,211,298,580,113,7,223,150,1225
376,Erick Strickland\stricer01,SG,24,DAL,67,19,1505,199,558,.357,48,163,.294,151,395,.382,.400,65,84,.774,35,126,161,167,56,8,106,140,511
377,Mark Strickland\stricma01,PF,27,MIA,51,8,847,145,269,.539,0,1,.000,145,268,.541,.539,59,82,.720,80,133,213,26,18,34,47,87,349
378,Rod Strickland\stricro02,PG,31,WAS,76,76,3020,490,1130,.434,12,48,.250,478,1082,.442,.439,357,492,.726,112,293,405,801,126,25,266,182,1349
379,Derek Strong\stronde01,PF,29,ORL,58,8,1638,259,617,.420,0,4,.000,259,613,.423,.420,218,279,.781,152,275,427,51,31,24,74,122,736
380,Bob Sura\surabo01,SG,24,CLE,46,4,942,87,231,.377,19,60,.317,68,171,.398,.418,74,131,.565,25,69,94,171,44,7,93,113,267
381,Zan Tabak\tabakza01,C,27,TOT,57,34,984,142,304,.467,0,1,.000,142,303,.469,.467,23,61,.377,84,128,212,48,20,38,61,163,307
382,Johnny Taylor\taylojo01,SF,23,ORL,12,0,108,13,37,.351,1,2,.500,12,35,.343,.365,11,16,.688,4,9,13,1,3,2,8,22,38
383,Maurice Taylor\tayloma01,PF,21,LAC,71,3,1513,321,675,.476,0,1,.000,321,674,.476,.476,173,244,.709,118,178,296,53,34,40,107,222,815
384,Carl Thomas\thomaca01,SG,28,TOT,43,0,426,56,140,.400,20,59,.339,36,81,.444,.471,16,25,.640,10,37,47,19,21,7,18,39,148
385,John Thomas\thomajo02,PF,22,TOT,54,2,535,55,113,.487,0,0,,55,113,.487,.487,41,54,.759,48,58,106,17,22,12,46,97,151
386,Kurt Thomas\thomaku01,PF,25,DAL,5,0,73,17,45,.378,0,0,,17,45,.378,.378,3,3,1.000,8,16,24,3,1,0,10,19,37
387,Tim Thomas\thomati01,SF,20,PHI,77,48,1779,306,684,.447,62,171,.363,244,513,.476,.493,171,231,.740,107,181,288,90,54,17,118,185,845
388,Brooks Thompson\thompbr01,PG,27,TOT,30,0,167,23,56,.411,9,30,.300,14,26,.538,.491,4,8,.500,1,14,15,27,10,1,16,22,59
389,Otis Thorpe\thorpot01,PF,35,TOT,74,66,2197,294,624,.471,0,5,.000,294,619,.475,.471,164,240,.683,151,386,537,222,48,30,152,238,752
390,Gary Trent\trentga01,PF,23,TOT,54,20,1360,241,505,.477,4,12,.333,237,493,.481,.481,144,212,.679,123,215,338,72,35,27,94,161,630
391,Nick Van Exel\vanexni01,PG,26,LAL,64,46,2053,311,743,.419,123,316,.389,188,427,.440,.501,136,172,.791,31,163,194,442,64,6,104,120,881
392,Keith Van Horn\vanhoke01,PF,22,NJN,62,62,2325,446,1047,.426,69,224,.308,377,823,.458,.459,258,305,.846,142,266,408,106,64,25,164,216,1219
393,David Vaughn\vaughda02,PF,24,TOT,40,2,489,66,148,.446,0,1,.000,66,147,.449,.446,30,47,.638,53,99,152,20,15,10,40,83,162
394,Jacque Vaughn\vaughja01,PG,22,UTA,45,0,419,44,122,.361,3,8,.375,41,114,.360,.373,48,68,.706,4,34,38,84,9,1,56,63,139
395,Loy Vaught\vaughlo01,PF,29,LAC,10,6,265,36,84,.429,0,2,.000,36,82,.439,.429,3,8,.375,16,49,65,7,4,2,13,33,75
396,Stojko Vrankovic\vrankst01,C,34,LAC,65,38,996,79,186,.425,0,0,,79,186,.425,.425,37,65,.569,71,192,263,36,11,66,46,130,195
397,Antoine Walker\walkean02,PF,21,BOS,82,82,3268,722,1705,.423,91,292,.312,631,1413,.447,.450,305,473,.645,270,566,836,273,142,60,292,262,1840
398,Samaki Walker\walkesa01,PF,21,DAL,41,19,1027,156,321,.486,0,1,.000,156,320,.488,.486,53,97,.546,96,206,302,24,30,40,61,127,365
399,Ben Wallace\wallabe01,C,23,WAS,67,16,1124,85,164,.518,0,0,,85,164,.518,.518,35,98,.357,112,212,324,18,61,72,28,116,205
400,John Wallace\wallajo01,SF,23,TOR,82,36,2361,468,979,.478,1,2,.500,467,977,.478,.479,210,293,.717,117,256,373,110,62,101,172,239,1147
401,Rasheed Wallace\wallara01,PF,23,POR,77,77,2896,466,875,.533,8,39,.205,458,836,.548,.537,184,278,.662,132,346,478,195,75,88,167,268,1124
402,Rex Walters\waltere01,SG,27,TOT,38,0,235,24,53,.453,6,22,.273,18,31,.581,.509,26,28,.929,5,19,24,35,8,1,27,28,80
403,Charlie Ward\wardch01,PG,27,NYK,82,82,2317,235,516,.455,81,215,.377,154,301,.512,.534,91,113,.805,32,242,274,466,144,37,175,195,642
404,Eric Washington\washier01,SG,23,DEN,66,36,1539,201,498,.404,44,137,.321,157,361,.435,.448,65,83,.783,47,80,127,78,53,25,72,143,511
405,Clarence Weatherspoon\weathcl01,PF,27,TOT,79,49,2325,268,608,.441,0,0,,268,608,.441,.441,200,277,.722,198,396,594,89,85,74,119,194,736
406,Spud Webb\webbsp01,PG,34,ORL,4,0,34,5,12,.417,0,1,.000,5,11,.455,.417,2,2,1.000,2,1,3,5,1,0,7,6,12
407,Chris Webber\webbech01,C,24,WAS,71,71,2809,647,1341,.482,65,205,.317,582,1136,.512,.507,196,333,.589,176,498,674,273,111,124,185,269,1555
408,Bubba Wells\wellsbu01,SG,23,DAL,39,2,395,48,116,.414,1,6,.167,47,110,.427,.418,31,43,.721,22,46,68,34,15,4,31,40,128
409,Bill Wennington\wennibi01,C,34,CHI,48,8,467,75,172,.436,0,0,,75,172,.436,.436,17,21,.810,32,48,80,19,4,5,16,77,167
410,David Wesley\wesleda01,PG,27,CHH,81,81,2845,383,864,.443,59,170,.347,324,694,.467,.477,229,288,.795,49,164,213,529,140,30,226,229,1054
411,Doug West\westdo01,SG,30,MIN,38,10,688,64,171,.374,0,2,.000,64,169,.379,.374,29,40,.725,23,59,82,45,11,5,21,97,157
412,Mark West\westma01,C,37,IND,15,1,105,10,21,.476,0,0,,10,21,.476,.476,3,6,.500,6,9,15,2,2,4,8,15,23
413,DeJuan Wheat\wheatde01,PG,24,MIN,34,0,150,20,50,.400,8,17,.471,12,33,.364,.480,9,15,.600,3,8,11,25,6,1,9,12,57
414,Donald Whiteside\whitedo01,PG,28,ATL,3,0,16,1,2,.500,0,1,.000,1,1,1.000,.500,0,2,.000,0,1,1,1,0,0,1,0,2
415,Chris Whitney\whitnch01,PG,26,WAS,82,6,1073,126,355,.355,52,169,.308,74,186,.398,.428,118,129,.915,16,99,115,196,34,6,65,106,422
416,Gerald Wilkins\wilkige01,SG,34,ORL,72,16,1252,141,434,.325,29,109,.266,112,325,.345,.358,69,98,.704,16,74,90,78,34,6,79,78,380
417,Aaron Williams\williaa01,PF,26,SEA,65,9,757,115,220,.523,0,1,.000,115,219,.525,.523,66,85,.776,48,99,147,14,19,38,50,119,296
418,Alvin Williams\willial02,SG,23,TOT,54,13,1071,125,282,.443,9,28,.321,116,254,.457,.459,65,90,.722,24,57,81,103,38,3,58,79,324
419,Brandon Williams\willibr01,SG,22,GSW,9,2,140,16,50,.320,3,9,.333,13,41,.317,.350,2,4,.500,4,11,15,3,6,3,9,18,37
420,Buck Williams\willibu01,PF,37,NYK,41,6,738,75,149,.503,0,0,,75,149,.503,.503,52,71,.732,78,105,183,21,17,15,38,93,202
421,Eric Williams\willier01,SF,25,DEN,4,4,145,24,61,.393,0,0,,24,61,.393,.393,31,45,.689,10,11,21,12,4,0,9,9,79
422,Herb Williams\willihe01,PF,39,NYK,27,0,178,18,43,.419,0,0,,18,43,.419,.419,1,8,.125,6,23,29,4,6,9,5,34,37
423,Hot Rod Williams\williho01,C,35,PHO,71,30,1333,95,202,.470,0,0,,95,202,.470,.470,65,93,.699,107,205,312,49,33,60,29,138,255
424,Jayson Williams\willija01,C,29,NJN,65,65,2343,321,645,.498,0,4,.000,321,641,.501,.498,195,293,.666,443,440,883,67,45,49,95,236,837
425,Jerome Williams\willije01,PF,24,DET,77,3,1305,151,288,.524,0,1,.000,151,287,.526,.524,108,166,.651,170,209,379,48,51,10,60,144,410
426,Lorenzo Williams\willilo01,PF,28,WAS,14,6,111,13,17,.765,0,0,,13,17,.765,.765,0,2,.000,16,10,26,3,2,3,2,17,26
427,Micheal Williams\willimi02,PG,31,MIN,25,0,161,16,48,.333,0,4,.000,16,44,.364,.333,32,33,.970,2,12,14,32,9,2,16,24,64
428,Monty Williams\willimo01,SF,26,SAS,72,16,1314,165,368,.448,1,2,.500,164,366,.448,.450,122,182,.670,67,112,179,89,34,24,82,133,453
429,Scott Williams\willisc01,C,29,PHI,58,7,801,93,213,.437,0,5,.000,93,208,.447,.437,51,63,.810,87,124,211,29,17,21,30,132,237
430,Travis Williams\willitr01,SF,28,CHH,39,0,365,56,119,.471,0,1,.000,56,118,.475,.471,24,46,.522,53,39,92,20,18,5,30,55,136
431,Walt Williams\williwa02,SF,27,TOT,59,17,1470,210,544,.386,80,219,.365,130,325,.400,.460,108,125,.864,50,150,200,122,59,35,92,161,608
432,Corliss Williamson\willico02,SF,24,SAC,79,75,2819,561,1134,.495,0,9,.000,561,1125,.499,.495,279,443,.630,162,284,446,230,76,48,199,252,1401
433,Kevin Willis\willike02,PF,35,HOU,81,74,2528,531,1041,.510,1,7,.143,530,1034,.513,.511,242,305,.793,232,447,679,78,55,38,170,235,1305
434,David Wingate\wingada01,SG,34,SEA,58,2,546,66,140,.471,3,7,.429,63,133,.474,.482,15,29,.517,19,60,79,37,21,3,37,58,150
435,Dontonio Wingfield\wingfdo01,SF,23,POR,3,0,9,0,3,.000,0,0,,0,3,.000,.000,1,2,.500,2,2,4,0,0,0,1,2,1
436,Joe Wolf\wolfjo01,PF,33,DEN,57,8,621,40,121,.331,2,10,.200,38,111,.342,.339,5,10,.500,36,90,126,30,20,7,22,92,87
437,Lorenzen Wright\wrighlo02,C,22,LAC,69,38,2067,241,542,.445,0,2,.000,241,540,.446,.445,141,214,.659,180,426,606,55,55,87,81,237,623
438,Sharone Wright\wrighsh01,C,25,TOR,7,0,44,7,14,.500,0,0,,7,14,.500,.500,2,4,.500,1,8,9,4,0,0,2,7,16
439,George Zidek\zidekge01,C,24,TOT,12,0,64,7,29,.241,1,2,.500,6,27,.222,.259,14,16,.875,4,13,17,2,0,2,4,10,29