
Rk,Player,Pos,Age,Tm,G,GS,MP,FG,FGA,FG%,3P,3PA,3P%,2P,2PA,2P%,eFG%,FT,FTA,FT%,ORB,DRB,TRB,AST,STL,BLK,TOV,PF,PTS
1,Tariq Abdul-Wahad\abdulta01,SG,25,TOT,61,56,1578,274,646,.424,3,23,.130,271,623,.435,.426,146,193,.756,101,190,291,98,59,28,106,147,697
2,Shareef Abdur-Rahim\abdursh01,SF,23,VAN,82,82,3223,594,1277,.465,29,96,.302,565,1181,.478,.477,446,551,.809,218,607,825,271,89,87,249,244,1663
3,Cory Alexander\alexaco01,PG,26,DEN,29,2,329,28,98,.286,9,35,.257,19,63,.302,.332,17,22,.773,8,34,42,58,24,2,28,39,82
4,Ray Allen*\allenra02,SG,24,MIL,82,82,3070,642,1411,.455,172,407,.423,470,1004,.468,.516,353,398,.887,83,276,359,308,110,19,183,187,1809
5,Rafer Alston\alstora01,PG,23,MIL,27,0,361,27,95,.284,3,14,.214,24,81,.296,.300,3,4,.750,5,18,23,70,12,0,29,29,60
6,John Amaechi\amaecjo01,C,29,ORL,80,53,1684,306,700,.437,1,6,.167,305,694,.439,.438,223,291,.766,62,204,266,95,35,37,139,161,836
7,Derek Anderson\anderde01,SG,25,LAC,64,58,2201,377,860,.438,55,178,.309,322,682,.472,.470,271,309,.877,80,178,258,220,90,11,167,149,1080
8,Kenny Anderson\anderke01,PG,29,BOS,82,82,2593,434,986,.440,85,220,.386,349,766,.456,.483,196,253,.775,55,170,225,420,139,8,130,230,1149
9,Nick Anderson\anderni01,SG,32,SAC,72,72,2094,306,782,.391,132,397,.332,174,385,.452,.476,37,76,.487,83,256,339,123,94,16,95,118,781
10,Shandon Anderson\andersh01,SF,26,HOU,82,82,2700,368,778,.473,79,225,.351,289,553,.523,.524,194,253,.767,91,293,384,239,96,32,194,182,1009
11,Chris Anstey\anstech01,C,25,CHI,73,11,1007,161,364,.442,1,6,.167,160,358,.447,.444,116,147,.789,90,190,280,65,29,25,80,180,439
12,Greg Anthony\anthogr01,PG,32,POR,82,3,1548,169,416,.406,88,233,.378,81,183,.443,.512,88,114,.772,17,116,133,208,59,9,85,143,514
13,B.J. Armstrong\armstbj01,PG,32,CHI,27,18,583,83,186,.446,13,29,.448,70,157,.446,.481,22,25,.880,2,45,47,78,7,1,40,34,201
14,Darrell Armstrong\armstda01,PG,31,ORL,82,82,2590,484,1119,.433,137,403,.340,347,716,.485,.494,225,247,.911,65,205,270,501,169,9,248,137,1330
15,Chucky Atkins\atkinch01,PG,25,ORL,82,0,1626,314,741,.424,57,163,.350,257,578,.445,.462,97,133,.729,20,106,126,306,52,3,142,137,782
16,Stacey Augmon\augmost01,SG,31,POR,59,0,692,83,175,.474,0,2,.000,83,173,.480,.474,37,55,.673,42,74,116,53,27,11,38,69,203
17,Isaac Austin\austiis01,C,30,WAS,59,23,1173,151,352,.429,1,4,.250,150,348,.431,.430,94,137,.686,64,218,282,74,17,38,107,128,397
18,Anthony Avent\aventan01,PF,30,LAC,49,3,377,29,96,.302,0,0,,29,96,.302,.302,23,32,.719,23,51,74,11,16,15,24,62,81
19,William Avery\averywi01,PG,20,MIN,59,1,484,56,181,.309,18,63,.286,38,118,.322,.359,24,36,.667,8,32,40,88,14,2,42,60,154
20,Toby Bailey\baileto01,SG,24,PHO,46,2,449,58,140,.414,2,10,.200,56,130,.431,.421,45,65,.692,26,46,72,30,13,4,24,55,163
21,Vin Baker\bakervi01,C,28,SEA,79,75,2849,514,1129,.455,2,8,.250,512,1121,.457,.456,281,412,.682,227,378,605,148,47,66,213,288,1311
22,Charles Barkley*\barklch01,PF,36,HOU,20,18,620,106,222,.477,6,26,.231,100,196,.510,.491,71,110,.645,71,138,209,63,14,4,44,48,289
23,Dana Barros\barroda01,PG,32,BOS,72,0,1139,196,435,.451,59,144,.410,137,291,.471,.518,66,76,.868,13,86,99,133,31,4,66,80,517
24,Brent Barry\barrybr01,SG,28,SEA,80,74,2726,327,707,.463,164,399,.411,163,308,.529,.579,127,157,.809,50,322,372,291,103,31,142,228,945
25,Drew Barry\barrydr01,PG,26,TOT,16,0,159,15,33,.455,7,18,.389,8,15,.533,.561,4,5,.800,0,12,12,33,2,0,13,23,41
26,Jon Barry\barryjo01,SG,30,SAC,62,1,1281,161,346,.465,66,154,.429,95,192,.495,.561,107,116,.922,38,121,159,150,75,7,85,104,495
27,Tony Battie\battito01,C,23,BOS,82,4,1505,219,459,.477,1,8,.125,218,451,.483,.478,102,151,.675,152,258,410,63,47,70,67,249,541
28,Jonathan Bender\bendejo01,SF,19,IND,24,1,130,23,70,.329,2,12,.167,21,58,.362,.343,16,24,.667,4,17,21,3,1,5,7,18,64
29,Benoit Benjamin\benjabe01,C,35,CLE,3,0,8,1,3,.333,0,0,,1,3,.333,.333,0,0,,0,1,1,0,0,1,0,1,2
30,Corey Benjamin\benjaco01,SG,21,CHI,48,10,862,145,350,.414,31,89,.348,114,261,.437,.459,49,82,.598,21,67,88,54,31,22,74,122,370
31,Mario Bennett\bennema01,PF,26,LAC,1,0,3,0,3,.000,0,0,,0,3,.000,.000,0,0,,1,1,2,0,0,0,0,1,0
32,Travis Best\besttr01,PG,27,IND,82,0,1691,271,561,.483,35,93,.376,236,468,.504,.514,156,190,.821,16,126,142,272,76,5,107,204,733
33,Mike Bibby\bibbymi01,PG,21,VAN,82,82,3155,459,1031,.445,77,212,.363,382,819,.466,.483,195,250,.780,73,233,306,665,132,15,247,171,1190
34,Chauncey Billups\billuch01,SG,23,DEN,13,5,305,34,101,.337,7,41,.171,27,60,.450,.371,37,44,.841,8,26,34,39,10,2,24,27,112
35,Mookie Blaylock\blaylmo01,PG,32,GSW,73,72,2459,327,837,.391,101,301,.336,226,536,.422,.451,67,95,.705,55,215,270,489,146,22,143,122,822
36,Corie Blount\blounco01,PF,31,PHO,38,1,446,44,89,.494,0,2,.000,44,87,.506,.494,19,33,.576,52,61,113,10,15,7,28,78,107
37,Muggsy Bogues\boguemu01,PG,35,TOR,80,5,1731,157,358,.439,17,51,.333,140,307,.456,.462,79,87,.908,25,110,135,299,65,4,59,119,410
38,Etdrick Bohannon\bohanet01,PF,26,TOT,13,0,118,7,13,.538,0,0,,7,13,.538,.538,15,24,.625,13,18,31,5,2,6,10,25,29
39,Calvin Booth\boothca01,C,23,WAS,11,0,143,16,46,.348,0,0,,16,46,.348,.348,10,14,.714,15,17,32,7,3,14,6,23,42
40,Lazaro Borrell\borrela01,SF,27,SEA,17,6,167,28,63,.444,0,3,.000,28,60,.467,.444,6,11,.545,14,26,40,10,6,3,6,9,62
41,Cal Bowdler\bowdlca01,SF,22,ATL,46,0,423,49,115,.426,0,1,.000,49,114,.430,.426,24,38,.632,22,63,85,14,14,9,21,46,122
42,Bruce Bowen\bowenbr01,SF,28,TOT,69,2,878,72,194,.371,27,58,.466,45,136,.331,.441,25,43,.581,27,69,96,34,23,15,19,118,196
43,Ryan Bowen\bowenry01,SF,24,DEN,52,0,589,46,117,.393,1,9,.111,45,108,.417,.397,38,53,.717,75,39,114,20,39,13,14,95,131
44,Ira Bowman\bowmair01,SG,26,PHI,11,0,20,2,2,1.000,0,0,,2,2,1.000,1.000,1,2,.500,0,2,2,1,1,0,1,0,5
45,Earl Boykins\boykiea01,PG,23,TOT,26,0,261,56,116,.483,8,20,.400,48,96,.500,.517,18,23,.783,12,14,26,48,12,1,17,23,138
46,Shawn Bradley\bradlsh01,C,27,DAL,77,54,1901,266,555,.479,1,5,.200,265,550,.482,.480,114,149,.765,160,337,497,60,71,190,74,260,647
47,A.J. Bramlett\bramlaj01,C,23,CLE,8,0,61,4,21,.190,0,0,,4,21,.190,.190,0,0,,12,10,22,0,1,0,3,13,8
48,Elton Brand\brandel01,PF,20,CHI,81,80,2999,630,1306,.482,0,2,.000,630,1304,.483,.482,367,536,.685,348,462,810,155,66,132,228,259,1627
49,Terrell Brandon\brandte01,PG,29,MIN,71,71,2587,486,1042,.466,53,132,.402,433,910,.476,.492,187,208,.899,44,194,238,629,134,30,184,158,1212
50,Chucky Brown\brownch01,PF,31,TOT,63,29,1096,148,328,.451,2,10,.200,146,318,.459,.454,36,52,.692,35,132,167,66,20,18,45,114,334
51,Dee Brown\brownde01,PG,31,TOR,38,12,673,93,258,.360,67,187,.358,26,71,.366,.490,11,16,.688,9,45,54,86,24,5,39,62,264
52,Marcus Brown\brownma01,SG,25,DET,6,0,45,4,14,.286,0,7,.000,4,7,.571,.286,2,2,1.000,3,4,7,3,0,0,3,8,10
53,P.J. Brown\brownpj01,PF,30,MIA,80,80,2302,322,671,.480,0,1,.000,322,670,.481,.480,120,159,.755,216,384,600,145,65,61,100,264,764
54,Randy Brown\brownra02,PG,31,CHI,59,55,1625,157,435,.361,3,6,.500,154,429,.359,.364,62,84,.738,23,121,144,202,61,15,105,120,379
55,Rick Brunson\brunsri01,PG,27,NYK,37,0,289,29,70,.414,2,13,.154,27,57,.474,.429,11,18,.611,3,24,27,49,9,1,31,35,71
56,Kobe Bryant\bryanko01,SG,21,LAL,66,62,2524,554,1183,.468,46,144,.319,508,1039,.489,.488,331,403,.821,108,308,416,323,106,62,182,220,1485
57,Mark Bryant\bryanma01,PF,34,CLE,75,50,1712,174,346,.503,0,0,,174,346,.503,.503,76,94,.809,126,226,352,61,31,31,87,250,424
58,Greg Buckner\buckngr01,SG,23,DAL,48,1,923,111,233,.476,10,26,.385,101,207,.488,.498,43,63,.683,56,118,174,55,38,20,36,148,275
59,Jud Buechler\buechju01,SF,31,DET,58,5,657,55,156,.353,18,83,.217,37,73,.507,.410,2,7,.286,30,61,91,33,25,16,13,50,130
60,Rodney Buford\buforro01,SG,22,MIA,34,0,386,62,151,.411,7,29,.241,55,122,.451,.434,16,22,.727,10,38,48,21,10,8,9,44,147
61,Matt Bullard\bullama01,PF,32,HOU,56,27,1024,139,340,.409,79,177,.446,60,163,.368,.525,25,30,.833,13,125,138,63,19,13,36,85,382
62,Scott Burrell\burresc01,SF,29,NJN,74,9,1336,165,419,.394,82,232,.353,83,187,.444,.492,39,50,.780,65,191,256,72,67,44,38,173,451
63,Jason Caffey\caffeja01,PF,26,GSW,71,56,2159,323,675,.479,0,2,.000,323,673,.480,.479,206,345,.597,189,293,482,119,62,20,170,269,852
64,Michael Cage\cagemi01,C,38,NJN,20,7,242,12,24,.500,0,0,,12,24,.500,.500,3,3,1.000,33,48,81,9,8,8,4,30,27
65,Marcus Camby\cambyma01,C,25,NYK,59,11,1548,226,471,.480,1,2,.500,225,469,.480,.481,148,221,.670,174,287,461,49,43,116,72,204,601
66,Elden Campbell\campbel01,C,31,CHH,78,77,2538,370,829,.446,0,6,.000,370,823,.450,.446,247,358,.690,168,422,590,129,56,150,127,269,987
67,Antoine Carr\carran01,SF,38,VAN,21,0,221,28,64,.438,0,0,,28,64,.438,.438,11,14,.786,8,24,32,7,3,6,9,42,67
68,Chris Carr\carrch01,SF-SG,25,TOT,57,2,1166,196,496,.395,32,101,.317,164,395,.415,.427,107,125,.856,41,132,173,84,30,15,117,113,531
69,Anthony Carter\cartean01,PG,24,MIA,79,30,1859,201,509,.395,3,23,.130,198,486,.407,.398,93,124,.750,48,151,199,378,93,5,173,167,498
70,Vince Carter\cartevi01,SF,23,TOR,82,82,3126,788,1696,.465,95,236,.403,693,1460,.475,.493,436,551,.791,150,326,476,322,110,92,178,263,2107
71,Sam Cassell\cassesa01,PG,30,MIL,81,81,2899,545,1170,.466,26,90,.289,519,1080,.481,.477,390,445,.876,69,232,301,729,102,8,267,255,1506
72,Kelvin Cato\catoke01,C,25,HOU,65,32,1581,216,402,.537,0,4,.000,216,398,.543,.537,135,208,.649,102,287,389,26,33,124,71,175,567
73,Duane Causwell\causwdu01,C,31,MIA,25,2,185,20,37,.541,0,0,,20,37,.541,.541,26,38,.684,11,36,47,2,2,16,10,42,66
74,Cedric Ceballos\cebalce01,SF,30,DAL,69,25,2064,447,1002,.446,44,134,.328,403,868,.464,.468,209,248,.843,172,290,462,90,56,24,125,165,1147
75,John Celestand\celesjo01,PG,22,LAL,16,0,185,15,45,.333,2,9,.222,13,36,.361,.356,5,6,.833,1,10,11,20,7,0,16,22,37
76,Rex Chapman\chapmre01,SG,32,PHO,53,19,957,124,320,.388,41,123,.333,83,197,.421,.452,59,78,.756,10,70,80,62,22,1,38,70,348
77,Calbert Cheaney\cheanca01,SG,28,BOS,67,19,1309,120,273,.440,18,54,.333,102,219,.466,.473,9,21,.429,23,115,138,80,44,14,46,158,267
78,Pete Chilcutt\chilcpe01,PF,31,TOT,56,2,601,53,127,.417,6,26,.231,47,101,.465,.441,8,8,1.000,46,85,131,27,15,10,20,73,120
79,Chris Childs\childch01,PG,32,NYK,71,2,1675,146,357,.409,37,104,.356,109,253,.431,.461,47,59,.797,17,130,147,285,36,4,105,240,376
80,Doug Christie\chrisdo01,SG,29,TOR,73,73,2264,311,764,.407,99,275,.360,212,489,.434,.472,182,216,.843,63,222,285,321,102,43,144,167,903
81,Keon Clark\clarkke01,C,24,DEN,81,20,1850,286,528,.542,1,8,.125,285,520,.548,.543,121,176,.688,162,343,505,71,45,114,125,231,694
82,Keith Closs\closske01,C,23,LAC,57,6,820,96,197,.487,0,3,.000,96,194,.495,.487,46,78,.590,65,114,179,25,13,73,34,80,238
83,Derrick Coleman\colemde01,PF,32,CHH,74,64,2347,446,979,.456,51,141,.362,395,838,.471,.482,296,377,.785,124,508,632,175,34,130,173,195,1239
84,Bimbo Coles\colesbi01,PG,31,ATL,80,54,1924,276,607,.455,8,39,.205,268,568,.472,.461,85,104,.817,30,142,172,290,58,11,103,178,645
85,Marty Conlon\conloma01,C,32,LAC,3,0,9,1,2,.500,0,0,,1,2,.500,.500,0,0,,1,1,2,0,0,0,0,1,2
86,Tyrone Corbin\corbity01,SF,37,SAC,54,5,941,88,247,.356,10,44,.227,78,203,.384,.377,33,39,.846,40,125,165,60,36,5,29,99,219
87,Chris Crawford\crawfch01,PF,24,ATL,55,11,668,91,229,.397,7,27,.259,84,202,.416,.413,63,81,.778,51,48,99,33,17,16,37,83,252
88,Austin Croshere\croshau01,PF,24,IND,81,14,1885,288,653,.441,63,174,.362,225,479,.470,.489,196,231,.848,135,381,516,89,44,60,121,203,835
89,John Crotty\crottjo01,PG,30,DET,69,0,937,106,251,.422,33,80,.413,73,171,.427,.488,80,93,.860,17,58,75,128,27,5,54,104,325
90,Terry Cummings\cummite01,PF,38,GSW,22,0,398,76,177,.429,0,0,,76,177,.429,.429,32,39,.821,45,62,107,21,13,8,27,74,184
91,Vonteego Cummings\cummivo01,PG,23,GSW,75,11,1793,265,655,.405,49,151,.325,216,504,.429,.442,127,169,.751,57,127,184,247,91,13,132,174,706
92,Bill Curley\curlebi01,SF-PF,27,TOT,28,0,309,29,68,.426,0,1,.000,29,67,.433,.426,18,25,.720,18,32,50,14,13,4,21,61,76
93,Dell Curry\curryde01,SG,35,TOR,67,9,1095,194,454,.427,95,242,.393,99,212,.467,.532,24,32,.750,11,89,100,89,32,9,40,66,507
94,Michael Curry\currymi01,SG,31,DET,82,3,1611,182,379,.480,1,5,.200,181,374,.484,.482,141,168,.839,21,83,104,87,33,5,73,209,506
95,Erick Dampier\dampier01,C,24,GSW,21,12,495,70,173,.405,0,0,,70,173,.405,.405,27,51,.529,48,86,134,19,8,15,29,75,167
96,Antonio Daniels\daniean01,SG,24,SAS,68,1,1195,163,344,.474,22,66,.333,141,278,.507,.506,72,101,.713,16,70,86,177,55,5,58,73,420
97,Kornel David\davidko01,SF,28,TOT,32,5,474,67,157,.427,0,3,.000,67,154,.435,.427,45,56,.804,26,55,81,17,17,3,33,56,179
98,Antonio Davis\davisan01,C,31,TOR,79,78,2479,313,712,.440,0,0,,313,712,.440,.440,284,371,.765,235,461,696,105,38,100,121,267,910
99,Baron Davis\davisba01,PG,20,CHH,82,0,1523,182,433,.420,25,111,.225,157,322,.488,.449,97,153,.634,48,117,165,309,97,19,140,201,486
100,Ben Davis\davisbe01,PF,27,PHO,5,0,22,2,6,.333,0,0,,2,6,.333,.333,0,0,,3,6,9,2,1,1,3,2,4
101,Dale Davis\davisda01,C,30,IND,74,72,2127,302,602,.502,0,0,,302,602,.502,.502,139,203,.685,256,473,729,64,52,94,91,203,743
102,Emanual Davis\davisem01,PG,31,SEA,54,2,701,80,220,.364,31,103,.301,49,117,.419,.434,26,38,.684,15,85,100,70,38,5,44,72,217
103,Hubert Davis\davishu01,PG,29,DAL,79,15,1817,217,464,.468,82,167,.491,135,297,.455,.556,67,77,.870,17,117,134,141,24,3,70,109,583
104,Mark Davis\davisma02,SF,26,GSW,23,7,464,56,137,.409,0,2,.000,56,135,.415,.409,31,47,.660,31,53,84,38,25,4,40,52,143
105,Ricky Davis\davisri01,SG,20,CHH,48,4,570,94,187,.503,0,4,.000,94,183,.514,.503,39,51,.765,29,54,83,62,30,8,46,39,227
106,Todd Day\dayto01,SG,30,PHO,58,1,941,130,330,.394,64,165,.388,66,165,.400,.491,72,108,.667,31,98,129,65,44,22,50,127,396
107,Andrew DeClercq\declean01,C,26,CLE,82,31,1831,225,443,.508,0,0,,225,443,.508,.508,94,160,.588,156,283,439,58,63,66,108,275,544
108,Vinny Del Negro\delnevi01,PG,33,MIL,67,0,1211,153,325,.471,8,24,.333,145,301,.482,.483,35,39,.897,9,98,107,160,36,0,48,81,349
109,Tony Delk\delkto01,PG,26,SAC,46,1,682,120,279,.430,9,40,.225,111,239,.464,.446,47,59,.797,36,52,88,55,35,5,32,58,296
110,Derrick Dial\dialde01,SG,24,SAS,8,0,95,17,46,.370,3,12,.250,14,34,.412,.402,3,5,.600,14,12,26,5,1,1,6,10,40
111,Michael Dickerson\dickemi01,SG,24,VAN,82,82,3103,554,1270,.436,119,291,.409,435,979,.444,.483,269,324,.830,78,201,279,208,116,45,165,226,1496
112,Vlade Divac\divacvl01,C,31,SAC,82,81,2374,384,764,.503,7,26,.269,377,738,.511,.507,230,333,.691,174,482,656,244,103,103,190,251,1005
113,Michael Doleac\doleami01,C,22,ORL,81,29,1335,242,535,.452,1,2,.500,241,533,.452,.453,80,95,.842,89,245,334,63,29,34,65,224,565
114,Sherman Douglas\douglsh01,PG,33,NJN,20,2,309,45,90,.500,5,16,.313,40,74,.541,.528,25,28,.893,13,16,29,34,17,0,24,26,120
115,Bryce Drew\drewbr01,PG,25,HOU,72,5,1293,158,413,.383,59,163,.362,99,250,.396,.454,45,53,.849,23,80,103,162,41,1,66,79,420
116,Chris Dudley\dudlech02,C,34,NYK,47,3,459,23,67,.343,0,0,,23,67,.343,.343,9,27,.333,63,73,136,5,7,21,18,95,55
117,Tim Duncan\duncati01,PF,23,SAS,74,74,2875,628,1281,.490,1,11,.091,627,1270,.494,.491,459,603,.761,262,656,918,234,66,165,242,210,1716
118,Howard Eisley\eisleho01,PG,27,UTA,82,5,2096,282,675,.418,60,163,.368,222,512,.434,.462,84,102,.824,23,147,170,347,59,9,132,223,708
119,Obinna Ekezie\ekeziob01,PF,24,VAN,39,0,351,41,88,.466,0,0,,41,88,.466,.466,43,64,.672,34,58,92,8,9,4,26,61,125
120,Mario Elie\eliema01,SF,36,SAS,79,79,2217,195,457,.427,74,186,.398,121,271,.446,.508,126,149,.846,48,201,249,193,73,9,130,156,590
121,Sean Elliott\elliose01,SF,31,SAS,19,19,391,38,106,.358,13,37,.351,25,69,.362,.420,25,32,.781,6,41,47,28,12,2,19,34,114
122,Dale Ellis\ellisda01,SG,39,TOT,42,5,564,66,159,.415,37,100,.370,29,59,.492,.531,9,13,.692,13,43,56,14,13,0,20,45,178
123,LaPhonso Ellis\ellisla01,PF,29,ATL,58,8,1309,209,464,.450,3,21,.143,206,443,.465,.454,66,95,.695,98,192,290,59,32,25,52,133,487
124,Pervis Ellison\ellispe01,C,32,BOS,30,5,269,19,43,.442,0,0,,19,43,.442,.442,15,21,.714,29,38,67,13,10,8,13,67,53
125,Evan Eschmeyer\eschmev01,C,24,NJN,31,5,373,38,72,.528,0,0,,38,72,.528,.528,15,30,.500,40,68,108,21,8,21,21,84,91
126,Patrick Ewing*\ewingpa01,C,37,NYK,62,62,2035,361,775,.466,0,2,.000,361,773,.467,.466,207,283,.731,140,464,604,58,36,84,142,196,929
127,Tony Farmer\farmeto01,PF,30,GSW,74,9,1199,127,312,.407,8,44,.182,119,268,.444,.420,203,265,.766,118,177,295,74,66,16,82,167,465
128,Jamie Feick\feickja01,C,25,NJN,81,17,2241,181,423,.428,3,3,1.000,178,420,.424,.431,94,133,.707,264,491,755,68,43,38,59,206,459
129,Danny Ferry\ferryda01,PF,33,CLE,63,3,1326,189,380,.497,33,75,.440,156,305,.511,.541,52,57,.912,55,183,238,67,22,24,55,181,463
130,Michael Finley\finlemi01,SF,26,DAL,82,82,3464,748,1636,.457,99,247,.401,649,1389,.467,.487,260,317,.820,122,396,518,438,109,32,196,171,1855
131,Derek Fisher\fishede01,PG,25,LAL,78,22,1803,167,483,.346,52,166,.313,115,317,.363,.400,105,145,.724,22,121,143,216,80,3,75,150,491
132,Danny Fortson\fortsda01,PF,23,BOS,55,5,856,140,265,.528,0,0,,140,265,.528,.528,139,189,.735,141,225,366,29,20,5,67,180,419
133,Greg Foster\fostegr01,PF,31,SEA,60,5,718,91,224,.406,3,15,.200,88,209,.421,.413,18,28,.643,16,91,107,41,10,18,28,105,203
134,Jeff Foster\fosteje01,C,23,IND,19,0,86,13,23,.565,0,1,.000,13,22,.591,.565,17,25,.680,12,20,32,5,5,1,2,18,43
135,Rick Fox\foxri01,SF,30,LAL,82,1,1473,206,498,.414,59,181,.326,147,317,.464,.473,63,78,.808,63,135,198,138,52,26,87,203,534
136,Adonal Foyle\foylead01,C,24,GSW,76,59,1654,193,380,.508,0,0,,193,380,.508,.508,34,90,.378,174,250,424,42,26,136,71,218,420
137,Steve Francis\francst01,PG,22,HOU,77,77,2776,497,1117,.445,107,310,.345,390,807,.483,.493,287,365,.786,152,257,409,507,118,29,306,231,1388
138,Todd Fuller\fulleto02,C,25,CHH,41,2,399,51,122,.418,0,0,,51,122,.418,.418,32,53,.604,36,74,110,5,9,8,27,46,134
139,Lawrence Funderburke\fundela01,PF,29,SAC,75,1,1026,184,352,.523,0,2,.000,184,350,.526,.523,115,163,.706,98,136,234,33,32,20,40,91,483
140,Kevin Garnett\garneke01,PF,23,MIN,81,81,3243,759,1526,.497,30,81,.370,729,1445,.504,.507,309,404,.765,223,733,956,401,120,126,268,205,1857
141,Dean Garrett\garrede01,C,33,MIN,56,23,604,48,108,.444,0,0,,48,108,.444,.444,18,26,.692,41,99,140,19,8,40,21,94,114
142,Kiwane Garris\garriki01,SG,25,ORL,3,0,23,2,10,.200,0,1,.000,2,9,.222,.200,0,0,,0,1,1,2,0,0,1,0,4
143,Pat Garrity\garripa01,SF,23,ORL,82,1,1479,258,585,.441,79,197,.401,179,388,.461,.509,80,111,.721,44,166,210,58,31,19,85,197,675
144,Chris Gatling\gatlich01,PF,32,TOT,85,0,1811,365,802,.455,18,70,.257,347,732,.474,.466,266,373,.713,154,348,502,71,82,23,169,246,1014
145,Matt Geiger\geigema01,C,30,PHI,65,20,1406,260,589,.441,0,4,.000,260,585,.444,.441,109,140,.779,154,233,387,39,29,22,91,194,629
146,Devean George\georgde01,SF,22,LAL,49,1,345,56,144,.389,16,47,.340,40,97,.412,.444,27,41,.659,29,46,75,12,10,4,21,54,155
147,Kendall Gill\gillke01,SF,31,NJN,76,75,2355,396,956,.414,20,78,.256,376,878,.428,.425,181,255,.710,82,201,283,210,139,41,89,211,993
148,Armen Gilliam\gilliar01,PF,35,UTA,50,0,782,133,305,.436,0,1,.000,133,304,.438,.436,67,86,.779,72,137,209,42,12,16,55,83,333
149,Dion Glover\glovedi01,SG,21,ATL,30,1,446,66,171,.386,12,45,.267,54,126,.429,.421,51,70,.729,15,23,38,27,15,4,28,28,195
150,Brian Grant\grantbr01,PF,27,POR,63,14,1322,173,352,.491,1,2,.500,172,350,.491,.493,112,166,.675,121,223,344,64,32,28,84,166,459
151,Gary Grant\grantga01,PG,34,POR,3,0,24,6,14,.429,0,0,,6,14,.429,.429,0,0,,0,3,3,1,1,0,2,3,12
152,Horace Grant\grantho01,PF,34,SEA,76,76,2688,266,599,.444,0,4,.000,266,595,.447,.444,80,111,.721,167,424,591,188,55,60,61,192,612
153,Devin Gray\grayde01,SF,27,HOU,21,2,124,15,37,.405,0,0,,15,37,.405,.405,19,29,.655,11,14,25,5,5,3,4,22,49
154,A.C. Green\greenac01,PF,36,LAL,82,82,1929,173,387,.447,1,4,.250,172,383,.449,.448,66,95,.695,160,326,486,80,53,18,53,127,413
155,Adrian Griffin\griffad01,SG,25,BOS,72,47,1927,175,413,.424,16,57,.281,159,356,.447,.443,119,158,.753,128,244,372,177,116,15,93,222,485
156,Tom Gugliotta\guglito01,PF,30,PHO,54,54,1767,310,645,.481,1,8,.125,309,637,.485,.481,117,151,.775,141,284,425,124,80,31,106,152,738
157,Darvin Ham\hamda01,SF,26,MIL,35,21,792,71,128,.555,0,1,.000,71,127,.559,.555,35,78,.449,85,87,172,42,29,29,29,102,177
158,Richard Hamilton\hamilri01,SG,21,WAS,71,12,1373,254,605,.420,28,77,.364,226,528,.428,.443,103,133,.774,38,91,129,108,28,6,84,142,639
159,Thomas Hamilton\hamilth01,C,24,HOU,22,7,273,35,79,.443,0,0,,35,79,.443,.443,12,23,.522,31,59,90,15,4,14,28,25,82
160,Tom Hammonds\hammoto01,PF,32,MIN,56,0,372,42,97,.433,0,0,,42,97,.433,.433,33,56,.589,34,67,101,10,8,3,21,55,117
161,Anfernee Hardaway\hardaan01,SG,28,PHO,60,60,2253,378,798,.474,33,102,.324,345,696,.496,.494,226,286,.790,91,256,347,315,94,38,153,164,1015
162,Tim Hardaway\hardati01,PG,33,MIA,52,52,1672,246,638,.386,94,256,.367,152,382,.398,.459,110,133,.827,25,125,150,385,49,4,119,112,696
163,Ron Harper\harpero01,PG,36,LAL,80,78,2042,212,531,.399,33,106,.311,179,425,.421,.430,100,147,.680,96,241,337,270,85,39,132,164,557
164,Matt Harpring\harprma01,SF,23,ORL,4,0,63,4,17,.235,2,2,1.000,2,15,.133,.294,6,7,.857,5,7,12,8,5,1,1,7,16
165,Al Harrington\harrial01,PF,19,IND,50,0,854,121,264,.458,8,34,.235,113,230,.491,.473,78,111,.703,47,112,159,38,25,9,65,130,328
166,Othella Harrington\harriot01,PF,26,VAN,82,82,2677,420,830,.506,0,2,.000,420,828,.507,.506,236,298,.792,196,367,563,97,36,58,217,287,1076
167,Lucious Harris\harrilu01,SG,29,NJN,77,11,1510,198,463,.428,38,115,.330,160,348,.460,.469,79,99,.798,53,134,187,100,65,6,42,98,513
168,Antonio Harvey\harvean01,PF,29,POR,19,0,137,17,30,.567,0,0,,17,30,.567,.567,7,12,.583,8,25,33,5,1,6,12,20,41
169,Hersey Hawkins\hawkihe01,SG,33,CHI,61,49,1622,159,375,.424,55,141,.390,104,234,.444,.497,107,119,.899,31,144,175,134,74,15,100,146,480
170,Michael Hawkins\hawkimi01,PG,27,CHH,12,0,36,3,13,.231,1,5,.200,2,8,.250,.269,1,2,.500,0,7,7,13,0,0,3,2,8
171,Alan Henderson\hendeal01,PF,27,ATL,82,82,2775,429,930,.461,1,10,.100,428,920,.465,.462,224,334,.671,265,306,571,77,81,54,139,233,1083
172,Cedric Henderson\hendece02,SF,24,CLE,61,7,1107,129,326,.396,1,15,.067,128,311,.412,.397,69,104,.663,34,106,140,55,39,17,68,99,328
173,Mark Hendrickson\hendrma01,PF,25,TOT,15,0,71,5,8,.625,0,0,,5,8,.625,.625,3,4,.750,3,10,13,6,2,1,3,8,13
174,Chris Herren\herrech01,PG,24,DEN,45,1,597,45,124,.363,24,67,.358,21,57,.368,.460,27,40,.675,12,40,52,111,15,2,42,74,141
175,Grant Hill*\hillgr01,SF,27,DET,74,74,2776,696,1422,.489,34,98,.347,662,1324,.500,.501,480,604,.795,97,393,490,385,103,43,240,190,1906
176,Tyrone Hill\hillty01,PF,31,PHI,68,65,2155,318,656,.485,0,1,.000,318,655,.485,.485,179,259,.691,220,405,625,52,64,27,124,243,815
177,Fred Hoiberg\hoibefr01,SG,27,CHI,31,11,845,89,230,.387,32,94,.340,57,136,.419,.457,69,76,.908,7,103,110,85,40,2,43,66,279
178,Derek Hood\hoodde01,PF,23,CHH,2,0,4,0,3,.000,0,0,,0,3,.000,.000,0,0,,0,1,1,0,0,0,0,0,0
179,Jeff Hornacek\hornaje01,SG,36,UTA,77,77,2133,358,728,.492,66,138,.478,292,590,.495,.537,171,180,.950,49,133,182,202,66,16,113,149,953
180,Robert Horry\horryro01,PF,29,LAL,76,0,1685,159,363,.438,29,94,.309,130,269,.483,.478,89,113,.788,133,228,361,118,84,80,73,189,436
181,Allan Houston\houstal01,SG,28,NYK,82,82,3169,614,1271,.483,106,243,.436,508,1028,.494,.525,280,334,.838,38,233,271,224,65,14,186,219,1614
182,Juwan Howard\howarju01,PF,26,WAS,82,82,2909,509,1108,.459,0,7,.000,509,1101,.462,.459,202,275,.735,132,338,470,247,67,21,225,299,1220
183,Troy Hudson\hudsotr01,PG,23,LAC,62,38,1592,204,541,.377,60,193,.311,144,348,.414,.433,77,95,.811,28,120,148,242,43,0,108,65,545
184,Larry Hughes\hughela01,SG,21,TOT,82,37,2324,459,1147,.400,29,125,.232,430,1022,.421,.413,279,377,.740,113,236,349,205,115,28,195,191,1226
185,Rick Hughes\hugheri02,PF,26,DAL,21,0,224,35,72,.486,0,1,.000,35,71,.493,.486,12,26,.462,24,25,49,9,3,1,14,30,82
186,Lindsey Hunter\hunteli01,PG,29,DET,82,82,2919,379,892,.425,168,389,.432,211,503,.419,.519,117,154,.760,35,215,250,327,129,22,145,216,1043
187,Allen Iverson*\iversal01,SG,24,PHI,70,70,2853,729,1733,.421,89,261,.341,640,1472,.435,.446,442,620,.713,71,196,267,328,144,5,230,162,1989
188,Bobby Jackson\jacksbo01,PG,26,MIN,73,10,1034,140,346,.405,13,46,.283,127,300,.423,.423,76,98,.776,50,103,153,172,48,7,58,114,369
189,Jaren Jackson\jacksja01,SG,32,SAS,81,12,1691,186,488,.381,108,306,.353,78,182,.429,.492,33,51,.647,34,147,181,118,54,7,66,157,513
190,Jermaine Jackson\jacksje01,SG,23,DET,7,0,73,1,11,.091,0,1,.000,1,10,.100,.091,5,8,.625,1,10,11,4,3,0,7,7,7
191,Jim Jackson\jacksji01,SF,29,ATL,79,76,2767,507,1235,.411,117,303,.386,390,932,.418,.458,186,212,.877,101,293,394,230,57,10,185,167,1317
192,Mark Jackson\jacksma01,PG,34,IND,81,81,2190,246,570,.432,89,221,.403,157,349,.450,.510,79,98,.806,63,233,296,650,76,10,174,111,660
193,Randell Jackson\jacksra02,PF,24,DAL,1,0,1,0,0,,0,0,,0,0,,,0,0,,0,0,0,0,0,0,0,0,0
194,Sam Jacobson\jacobsa01,PG,24,TOT,52,5,681,108,212,.509,9,24,.375,99,188,.527,.531,30,41,.732,25,46,71,32,30,3,33,113,255
195,Tim James\jamesti01,SF,23,MIA,4,0,23,5,14,.357,0,0,,5,14,.357,.357,1,3,.333,3,1,4,2,0,3,2,1,11
196,Antawn Jamison\jamisan01,SF,23,GSW,43,41,1556,356,756,.471,2,7,.286,354,749,.473,.472,127,208,.611,172,187,359,90,30,15,113,115,841
197,Harold Jamison\jamisha01,PF,23,MIA,12,0,74,7,20,.350,0,0,,7,20,.350,.350,4,18,.222,16,5,21,4,2,1,4,17,18
198,Anthony Johnson\johnsan02,PG,25,TOT,56,6,637,62,164,.378,2,11,.182,60,153,.392,.384,28,39,.718,21,30,51,72,33,4,32,58,154
199,Avery Johnson\johnsav01,PG,34,SAS,82,82,2571,402,850,.473,1,9,.111,401,841,.477,.474,114,155,.735,33,125,158,491,76,18,140,150,919
200,DeMarco Johnson\johnsde02,PF,24,NYK,5,0,37,3,9,.333,0,0,,3,9,.333,.333,0,0,,3,4,7,0,1,0,3,5,6
201,Ervin Johnson\johnser02,C,32,MIL,80,74,2129,144,279,.516,0,1,.000,144,278,.518,.516,95,157,.605,233,415,648,44,81,127,80,298,383
202,Kevin Johnson\johnske02,PG,33,PHO,6,0,113,16,28,.571,1,1,1.000,15,27,.556,.589,7,7,1.000,0,16,16,24,2,0,7,6,40
203,Larry Johnson\johnsla02,PF,30,NYK,70,68,2281,282,652,.433,58,174,.333,224,478,.469,.477,128,167,.766,87,293,380,175,42,7,94,205,750
204,Charles Jones\jonesch03,PG,24,LAC,56,0,662,66,201,.328,39,118,.331,27,83,.325,.425,17,23,.739,17,45,62,94,30,5,28,46,188
205,Damon Jones\jonesda01,PG,23,TOT,55,1,612,80,208,.385,41,114,.360,39,94,.415,.483,32,48,.667,12,43,55,96,18,1,40,34,233
206,Eddie Jones\jonesed02,SG,28,CHH,72,72,2807,478,1119,.427,128,341,.375,350,778,.450,.484,362,419,.864,81,262,343,305,192,49,160,176,1446
207,Jumaine Jones\jonesju01,SF,20,PHI,33,0,138,22,58,.379,2,4,.500,20,54,.370,.397,11,18,.611,16,22,38,5,6,5,14,10,57
208,Popeye Jones\jonespo01,PF,29,DEN,40,1,330,44,104,.423,2,3,.667,42,101,.416,.433,14,19,.737,41,62,103,19,3,6,13,50,104
209,Reggie Jordan\jordare01,PG,32,WAS,36,0,243,17,53,.321,0,1,.000,17,52,.327,.321,7,13,.538,16,25,41,32,12,2,19,29,41
210,Adam Keefe\keefead01,C,29,UTA,62,3,604,53,130,.408,0,1,.000,53,129,.411,.408,29,36,.806,45,91,136,34,17,13,46,90,135
211,Shawn Kemp\kempsh01,C,30,CLE,82,82,2492,484,1160,.417,2,6,.333,482,1154,.418,.418,493,635,.776,231,494,725,138,100,96,291,371,1463
212,Steve Kerr\kerrst01,PG,34,SAS,32,0,268,32,74,.432,16,31,.516,16,43,.372,.541,9,11,.818,3,16,19,12,4,0,7,14,89
213,Jerome Kersey\kerseje01,SF,37,SAS,72,18,1310,146,354,.412,0,9,.000,146,345,.423,.412,29,41,.707,58,167,225,69,67,47,51,161,321
214,Lari Ketner\ketnela01,PF,22,TOT,22,0,132,13,32,.406,0,0,,13,32,.406,.406,8,12,.667,12,22,34,1,4,3,10,20,34
215,Jason Kidd*\kiddja01,PG,26,PHO,67,67,2616,350,855,.409,56,166,.337,294,689,.427,.442,203,245,.829,96,387,483,678,134,28,226,148,959
216,Gerard King\kingge02,SF,27,WAS,62,28,1060,139,277,.502,0,0,,139,277,.502,.502,49,66,.742,84,166,250,49,34,15,41,132,327
217,Kerry Kittles\kittlke01,SG,25,NJN,62,61,1896,305,698,.437,96,240,.400,209,458,.456,.506,101,127,.795,46,179,225,142,79,19,56,120,807
218,Joe Kleine\kleinjo01,C,38,POR,7,0,31,4,11,.364,0,0,,4,11,.364,.364,3,3,1.000,0,6,6,2,1,0,2,7,11
219,Brevin Knight\knighbr01,PG,24,CLE,65,46,1754,230,558,.412,2,10,.200,228,548,.416,.414,140,184,.761,38,155,193,458,107,21,157,185,602
220,Travis Knight\knightr01,C,25,LAL,63,0,410,46,118,.390,0,0,,46,118,.390,.390,17,28,.607,46,83,129,23,6,23,26,88,109
221,Toni Kukoc\kukocto01,SF,31,TOT,56,31,1784,297,728,.408,44,168,.262,253,560,.452,.438,192,265,.725,75,198,273,265,77,28,146,112,830
222,Christian Laettner\laettch01,C,30,DET,82,82,2443,379,801,.473,7,24,.292,372,777,.479,.478,237,292,.812,175,378,553,186,83,45,186,326,1002
223,Raef LaFrentz\lafrera01,C,23,DEN,81,80,2435,392,879,.446,60,183,.328,332,696,.477,.480,162,236,.686,170,471,641,97,42,180,96,292,1006
224,Andrew Lang\langan01,C,33,NYK,19,10,244,28,64,.438,0,0,,28,64,.438,.438,3,7,.429,16,44,60,3,8,6,5,31,59
225,Antonio Lang\langan02,SF,27,TOT,10,0,38,1,6,.167,0,0,,1,6,.167,.167,4,5,.800,0,5,5,2,4,1,2,8,6
226,Trajan Langdon\langdtr01,SG,23,CLE,10,0,145,15,40,.375,8,19,.421,7,21,.333,.475,11,11,1.000,4,11,15,11,5,0,6,16,49
227,Rusty LaRue\larueru01,PG,26,CHI,4,1,129,15,43,.349,2,14,.143,13,29,.448,.372,5,7,.714,1,9,10,11,7,0,7,9,37
228,Tim Legler\legleti01,SG,33,GSW,23,4,284,28,78,.359,7,21,.333,21,57,.368,.404,14,18,.778,4,19,23,24,4,1,6,33,77
229,Voshon Lenard\lenarvo01,SG,26,MIA,53,13,1434,228,560,.407,89,228,.390,139,332,.419,.487,84,106,.792,37,116,153,136,41,15,80,127,629
230,Quincy Lewis\lewisqu01,SG,22,UTA,74,0,896,111,298,.372,23,63,.365,88,235,.374,.411,38,52,.731,46,67,113,40,24,15,46,158,283
231,Rashard Lewis\lewisra02,SF,20,SEA,82,8,1575,275,566,.486,40,120,.333,235,446,.527,.521,84,123,.683,127,209,336,70,62,36,78,163,674
232,Randy Livingston\livinra01,PG,24,PHO,79,15,1081,155,373,.416,19,55,.345,136,318,.428,.441,52,62,.839,25,105,130,170,49,13,92,129,381
233,Grant Long\longgr01,PF,33,VAN,42,1,920,74,167,.443,0,4,.000,74,163,.454,.443,55,71,.775,86,148,234,43,45,10,49,108,203
234,Luc Longley\longllu01,C,31,PHO,72,68,1417,186,399,.466,0,0,,186,399,.466,.466,80,97,.825,100,223,323,77,22,42,136,221,452
235,Felipe Lopez\lopezfe01,SG,25,VAN,65,0,781,111,261,.425,3,18,.167,108,243,.444,.431,67,109,.615,59,65,124,44,32,17,53,94,292
236,Tyronn Lue\luety01,PG,22,LAL,8,0,146,19,39,.487,4,8,.500,15,31,.484,.538,6,8,.750,2,10,12,17,3,0,9,17,48
237,George Lynch\lynchge01,SF,29,PHI,75,75,2416,297,644,.461,15,36,.417,282,608,.464,.473,113,183,.617,216,366,582,136,119,38,120,231,722
238,Todd MacCulloch\maccuto01,C,24,PHI,56,6,528,89,161,.553,0,0,,89,161,.553,.553,28,54,.519,48,98,146,13,11,37,26,94,206
239,Sam Mack\macksa01,SF,29,GSW,23,5,333,37,122,.303,21,64,.328,16,58,.276,.389,19,20,.950,7,32,39,24,18,1,19,45,114
240,Don MacLean\macledo01,PF,30,PHO,16,0,143,18,49,.367,2,6,.333,16,43,.372,.388,4,6,.667,6,17,23,8,2,1,8,24,42
241,Corey Maggette\maggeco01,SF,20,ORL,77,5,1370,224,469,.478,2,11,.182,222,458,.485,.480,196,261,.751,123,180,303,61,24,26,138,169,646
242,Dan Majerle\majerda01,SG,34,MIA,69,69,2308,170,422,.403,110,304,.362,60,118,.508,.533,56,69,.812,27,306,333,206,89,17,62,156,506
243,Karl Malone*\malonka01,PF,36,UTA,82,82,2947,752,1476,.509,2,8,.250,750,1468,.511,.510,589,739,.797,169,610,779,304,79,71,231,229,2095
244,Matt Maloney\malonma01,PG,28,CHI,51,12,1175,114,318,.358,62,174,.356,52,144,.361,.456,37,45,.822,10,54,64,138,32,3,63,42,327
245,Danny Manning\mannida01,PF,33,MIL,72,0,1217,149,339,.440,1,4,.250,148,335,.442,.441,34,52,.654,50,158,208,73,62,29,55,183,333
246,Stephon Marbury\marbust01,PG,22,NJN,74,74,2881,569,1317,.432,66,233,.283,503,1084,.464,.457,436,536,.813,61,179,240,622,112,15,270,195,1640
247,Shawn Marion\mariosh01,SF,21,PHO,51,38,1260,222,471,.471,4,22,.182,218,449,.486,.476,72,85,.847,105,227,332,69,38,53,51,113,520
248,Sean Marks\marksse01,PF,24,TOR,5,0,12,2,6,.333,0,1,.000,2,5,.400,.333,4,4,1.000,0,2,2,0,1,1,3,3,8
249,Donny Marshall\marshdo02,SF,27,CLE,6,0,39,3,11,.273,0,3,.000,3,8,.375,.273,5,6,.833,0,1,1,0,2,0,3,7,11
250,Donyell Marshall\marshdo01,PF,26,GSW,64,51,2071,331,840,.394,49,138,.355,282,702,.402,.423,199,255,.780,189,448,637,167,68,68,123,180,910
251,Darrick Martin\martida01,PG,28,SAC,71,1,893,133,350,.380,38,124,.306,95,226,.420,.434,98,119,.824,7,37,44,122,28,2,62,89,402
252,Jamal Mashburn\mashbja01,SF,27,MIA,76,76,2828,515,1158,.445,112,278,.403,403,880,.458,.493,186,239,.778,64,317,381,298,79,14,180,215,1328
253,Anthony Mason\masonan01,SF,33,CHH,82,81,3133,317,661,.480,0,1,.000,317,660,.480,.480,314,421,.746,145,554,699,367,74,29,160,220,948
254,Tony Massenburg\masseto01,PF,32,HOU,10,0,109,16,36,.444,0,0,,16,36,.444,.444,14,16,.875,7,20,27,3,2,5,9,13,46
255,Vernon Maxwell\maxweve01,SG,34,SEA,47,0,989,169,490,.345,67,223,.300,102,267,.382,.413,108,148,.730,15,64,79,75,38,9,53,83,513
256,Walter McCarty\mccarwa01,PF,25,BOS,61,5,879,78,230,.339,34,110,.309,44,120,.367,.413,39,54,.722,33,77,110,70,24,23,67,83,229
257,George McCloud\mccloge01,SF,32,DEN,78,11,2118,266,638,.417,107,283,.378,159,355,.448,.501,148,181,.818,72,213,285,246,48,26,134,180,787
258,Jelani McCoy\mccoyje01,C,22,SEA,58,2,746,102,177,.576,0,0,,102,177,.576,.576,45,91,.495,54,125,179,24,15,46,45,127,249
259,Antonio McDyess\mcdyean01,PF,25,DEN,81,81,2698,614,1211,.507,0,2,.000,614,1209,.508,.507,323,516,.626,234,451,685,159,69,139,230,316,1551
260,Tracy McGrady*\mcgratr01,SF,20,TOR,79,34,2462,459,1018,.451,18,65,.277,441,953,.463,.460,277,392,.707,188,313,501,263,90,151,160,201,1213
261,Jim McIlvaine\mcilvji01,C,27,NJN,66,53,1048,64,154,.416,0,0,,64,154,.416,.416,29,56,.518,106,124,230,36,26,117,38,205,157
262,Jeff McInnis\mcinnje01,PG,25,LAC,25,10,597,80,186,.430,7,21,.333,73,165,.442,.449,13,17,.765,18,54,72,89,15,2,27,55,180
263,Derrick McKey\mckeyde01,SF,33,IND,32,0,634,43,108,.398,10,23,.435,33,85,.388,.444,43,56,.768,29,106,135,35,29,13,19,81,139
264,Aaron McKie\mckieaa01,SG,27,PHI,82,14,1952,244,593,.411,44,121,.364,200,472,.424,.449,121,146,.829,47,199,246,240,108,18,113,194,653
265,Roshown McLeod\mcleoro01,SF,24,ATL,44,20,860,131,332,.395,2,13,.154,129,319,.404,.398,54,70,.771,41,97,138,52,16,5,59,84,318
266,Ron Mercer\mercero01,SG,23,TOT,68,68,2377,460,1080,.426,15,48,.313,445,1032,.431,.433,213,270,.789,64,186,250,158,75,23,151,151,1148
267,Andre Miller\millean02,PG,23,CLE,82,36,2093,339,755,.449,10,49,.204,329,706,.466,.456,226,292,.774,85,195,280,476,84,17,166,194,914
268,Anthony Miller\millean01,PF,28,HOU,35,14,476,52,97,.536,0,0,,52,97,.536,.536,26,51,.510,49,115,164,16,11,10,19,68,130
269,Brad Miller\millebr01,C,23,CHH,55,4,961,135,293,.461,0,2,.000,135,291,.464,.461,153,195,.785,113,180,293,45,23,35,48,111,423
270,Oliver Miller\milleol01,C,29,PHO,51,9,1088,137,233,.588,0,0,,137,233,.588,.588,49,73,.671,87,174,261,68,42,80,74,132,323
271,Reggie Miller*\millere01,SG,34,IND,81,81,2987,466,1041,.448,165,404,.408,301,637,.473,.527,373,406,.919,50,189,239,187,85,25,129,126,1470
272,Chris Mills\millsch01,SF,30,GSW,20,11,649,123,292,.421,8,30,.267,115,262,.439,.435,68,84,.810,46,77,123,47,18,4,25,60,322
273,Terry Mills\millste01,PF,32,DET,82,78,1842,214,488,.439,95,242,.393,119,246,.484,.536,25,34,.735,50,340,390,85,38,24,46,242,548
274,Jason Miskiri\miskija01,PG,24,CHH,1,0,3,0,1,.000,0,1,.000,0,0,,.000,0,0,,0,0,0,1,0,0,0,2,0
275,Sam Mitchell\mitchsa01,SF,36,MIN,66,24,1227,168,376,.447,10,23,.435,158,353,.448,.460,81,92,.880,28,110,138,111,27,14,44,116,427
276,Cuttino Mobley\moblecu01,SG,24,HOU,81,8,2496,437,1016,.430,104,292,.356,333,724,.460,.481,299,353,.847,59,229,288,208,87,32,186,171,1277
277,Nazr Mohammed\mohamna01,C,22,PHI,28,3,190,21,54,.389,0,0,,21,54,.389,.389,12,22,.545,16,34,50,2,4,12,18,29,54
278,Eric Montross\montrer01,C,28,DET,51,0,332,17,55,.309,0,0,,17,55,.309,.309,6,12,.500,18,54,72,7,6,9,22,81,40
279,Mikki Moore\mooremi01,C,24,DET,29,0,488,87,140,.621,0,0,,87,140,.621,.621,54,68,.794,44,68,112,17,9,31,23,104,228
280,Alonzo Mourning*\mournal01,C,29,MIA,79,78,2748,652,1184,.551,0,4,.000,652,1180,.553,.551,414,582,.711,215,538,753,123,40,294,217,308,1718
281,Chris Mullin*\mullich01,SG,36,IND,47,2,582,80,187,.428,45,110,.409,35,77,.455,.548,37,41,.902,14,62,76,37,28,9,28,60,242
282,Eric Murdock\murdoer01,PG,31,LAC,40,15,693,79,205,.385,16,42,.381,63,163,.387,.424,51,80,.638,15,62,77,108,47,5,58,67,225
283,Gheorghe Muresan\muresgh01,C,28,NJN,30,2,267,41,90,.456,0,0,,41,90,.456,.456,23,38,.605,24,44,68,9,0,12,16,52,105
284,Lamond Murray\murrala01,SF,26,CLE,74,72,2365,460,1019,.451,51,139,.367,409,880,.465,.476,204,268,.761,127,296,423,132,105,36,184,208,1175
285,Tracy Murray\murratr01,SF,28,WAS,80,8,1831,290,670,.433,113,263,.430,177,407,.435,.517,120,141,.851,63,208,271,72,45,24,84,185,813
286,Dikembe Mutombo*\mutomdi01,C,33,ATL,82,82,2984,322,573,.562,0,0,,322,573,.562,.562,298,421,.708,304,853,1157,105,27,269,174,248,942
287,Steve Nash*\nashst01,PG,25,DAL,56,27,1532,173,363,.477,60,149,.403,113,214,.528,.559,75,85,.882,34,87,121,272,37,3,102,122,481
288,Tyrone Nesby\nesbyty01,SG,24,LAC,73,39,2317,364,915,.398,94,281,.335,270,634,.426,.449,151,191,.791,82,193,275,121,75,31,102,205,973
289,Rasho Nesterovic\nestera01,C,23,MIN,82,55,1723,206,433,.476,0,2,.000,206,431,.478,.476,59,103,.573,135,244,379,93,21,85,71,262,471
290,Johnny Newman\newmajo01,SF,36,NJN,82,9,1763,278,623,.446,72,190,.379,206,433,.476,.504,192,229,.838,39,115,154,65,53,11,89,207,820
291,Moochie Norris\norrimo01,PG,26,HOU,30,0,502,69,159,.434,12,29,.414,57,130,.438,.472,57,73,.781,16,52,68,94,23,1,30,32,207
292,Dirk Nowitzki\nowitdi01,PF,21,DAL,82,81,2938,515,1118,.461,116,306,.379,399,812,.491,.513,289,348,.830,102,430,532,203,63,68,141,256,1435
293,Jermaine O'Neal\onealje01,C,21,POR,70,8,859,108,222,.486,0,1,.000,108,221,.489,.486,57,98,.582,97,132,229,18,11,55,47,127,273
294,Shaquille O'Neal*\onealsh01,C,27,LAL,79,79,3163,956,1665,.574,0,1,.000,956,1664,.575,.574,432,824,.524,336,742,1078,299,36,239,223,255,2344
295,Charles Oakley\oaklech01,PF,36,TOR,80,80,2431,234,560,.418,14,41,.341,220,519,.424,.430,66,85,.776,117,423,540,253,102,45,154,294,548
296,Lamar Odom\odomla01,SF,20,LAC,76,70,2767,449,1024,.438,59,164,.360,390,860,.453,.467,302,420,.719,159,436,595,317,91,95,258,291,1259
297,Hakeem Olajuwon*\olajuha01,C,37,HOU,44,28,1049,193,421,.458,0,2,.000,193,419,.461,.458,69,112,.616,65,209,274,61,41,70,73,88,455
298,Kevin Ollie\ollieke01,PG,27,PHI,40,0,290,22,49,.449,0,0,,22,49,.449,.449,28,37,.757,4,27,31,46,10,0,10,27,72
299,Michael Olowokandi\olowomi01,C,24,LAC,80,77,2493,330,756,.437,0,0,,330,756,.437,.437,123,189,.651,194,462,656,38,35,140,177,304,783
300,Greg Ostertag\ostergr01,C,26,UTA,81,3,1606,124,267,.464,0,1,.000,124,266,.466,.464,119,187,.636,172,310,482,18,20,172,79,196,367
301,Bo Outlaw\outlabo01,PF,28,ORL,82,55,2326,204,339,.602,0,3,.000,204,336,.607,.602,82,162,.506,202,323,525,245,113,148,133,203,490
302,Doug Overton\overtdo01,PG,30,BOS,48,0,432,61,154,.396,10,28,.357,51,126,.405,.429,20,21,.952,14,19,33,53,10,0,20,46,152
303,Billy Owens\owensbi01,PF-SF,30,TOT,62,11,1305,150,358,.419,11,34,.324,139,324,.429,.434,63,106,.594,99,202,301,97,33,21,85,166,374
304,Robert Pack\packro01,PG,30,DAL,29,22,665,96,230,.417,4,11,.364,92,219,.420,.426,63,78,.808,7,35,42,168,31,3,76,44,259
305,Scott Padgett\padgesc01,PF,23,UTA,47,9,432,44,140,.314,13,44,.295,31,96,.323,.361,19,27,.704,24,64,88,25,14,8,22,55,120
306,Milt Palacio\palacmi01,PG,21,VAN,53,0,394,43,98,.439,0,2,.000,43,96,.448,.439,22,37,.595,17,34,51,48,20,0,44,32,108
307,Anthony Parker\parkean01,SG,24,ORL,16,0,185,24,57,.421,1,14,.071,23,43,.535,.430,8,11,.727,5,22,27,10,8,4,11,13,57
308,Cherokee Parks\parksch02,C,27,VAN,56,14,808,72,145,.497,0,1,.000,72,144,.500,.497,24,37,.649,55,128,183,35,29,45,28,115,168
309,Andrae Patterson\pattean01,PF,24,MIN,5,0,20,3,4,.750,0,0,,3,4,.750,.750,0,0,,1,1,2,1,1,0,1,4,6
310,Ruben Patterson\patteru01,SF,24,SEA,81,74,2097,354,661,.536,12,27,.444,342,634,.539,.545,222,321,.692,218,216,434,126,94,40,144,190,942
311,Gary Payton*\paytoga01,PG,31,SEA,82,82,3425,747,1666,.448,177,520,.340,570,1146,.497,.502,311,423,.735,100,429,529,732,153,18,224,178,1982
312,Anthony Peeler\peelean01,SG,30,MIN,82,22,2073,316,725,.436,85,255,.333,231,470,.491,.494,87,109,.798,58,174,232,195,62,10,85,171,804
313,Will Perdue\perduwi01,C,34,CHI,67,15,1012,59,168,.351,0,0,,59,168,.351,.351,50,105,.476,88,174,262,65,14,42,78,126,168
314,Sam Perkins\perkisa01,PF,38,IND,81,0,1620,184,441,.417,89,218,.408,95,223,.426,.518,80,97,.825,64,225,289,68,31,33,63,136,537
315,Elliot Perry\perryel01,PG,30,NJN,60,5,803,128,294,.435,11,39,.282,117,255,.459,.454,50,62,.806,13,48,61,139,39,1,60,47,317
316,Chuck Person\persoch01,SF,35,SEA,37,0,340,37,123,.301,24,95,.253,13,28,.464,.398,4,8,.500,6,47,53,22,5,2,12,56,102
317,Wesley Person\persowe01,SG,28,CLE,79,38,2056,280,654,.428,106,250,.424,174,404,.431,.509,61,77,.792,44,223,267,146,40,19,60,119,727
318,Bobby Phills\phillbo01,SG,30,CHH,28,9,825,152,335,.454,30,91,.330,122,244,.500,.499,47,65,.723,17,54,71,79,41,8,48,72,381
319,Eric Piatkowski\piatker01,SF,29,LAC,75,23,1712,238,573,.415,93,243,.383,145,330,.439,.497,85,100,.850,74,148,222,81,44,13,57,140,654
320,Paul Pierce\piercpa01,SF,22,BOS,73,72,2583,486,1099,.442,96,280,.343,390,819,.476,.486,359,450,.798,83,313,396,221,152,62,178,237,1427
321,Scottie Pippen*\pippesc01,SF,34,POR,82,82,2749,388,860,.451,86,263,.327,302,597,.506,.501,160,223,.717,114,399,513,406,117,41,208,208,1022
322,Scot Pollard\pollasc01,C,24,SAC,76,5,1336,149,283,.527,0,0,,149,283,.527,.527,114,159,.717,168,236,404,43,55,59,50,213,412
323,Olden Polynice\polynol01,C,35,UTA,82,79,1819,203,398,.510,1,2,.500,202,396,.510,.511,28,90,.311,166,287,453,37,30,84,70,260,435
324,Terry Porter\portete01,PG,36,SAS,68,8,1613,207,463,.447,90,207,.435,117,256,.457,.544,137,170,.806,24,167,191,221,50,9,100,79,641
325,James Posey\poseyja01,SF,23,DEN,81,77,2052,230,536,.429,82,220,.373,148,316,.468,.506,120,150,.800,85,232,317,146,98,33,95,207,662
326,Vitaly Potapenko\potapvi01,C,24,BOS,79,72,1797,307,615,.499,0,1,.000,307,614,.500,.499,109,160,.681,182,317,499,77,41,29,145,239,723
327,Brent Price\pricebr01,PG,31,VAN,41,0,424,41,119,.345,25,68,.368,16,51,.314,.450,34,39,.872,8,29,37,69,17,1,47,63,141
328,Laron Profit\profila01,SG,22,WAS,33,1,225,21,59,.356,3,17,.176,18,42,.429,.381,4,10,.400,2,24,26,25,7,4,19,26,49
329,Aleksandar Radojevic\radojal01,C,23,TOR,3,0,24,2,7,.286,0,0,,2,7,.286,.286,3,6,.500,2,6,8,1,2,1,5,5,7
330,Theo Ratliff\ratlith01,PF,26,PHI,57,56,1795,247,491,.503,0,0,,247,491,.503,.503,182,236,.771,140,295,435,36,32,171,108,185,676
331,Eldridge Recasner\recasel01,PG,32,CHH,7,0,28,3,7,.429,1,4,.250,2,3,.667,.500,0,0,,0,4,4,5,0,0,0,1,7
332,Bryant Reeves\reevebr01,C,26,VAN,69,67,1773,252,562,.448,0,4,.000,252,558,.452,.448,107,165,.648,126,264,390,82,33,38,119,245,611
333,Khalid Reeves\reevekh01,PG,27,CHI,3,0,48,3,12,.250,0,3,.000,3,9,.333,.250,5,5,1.000,2,2,4,13,2,0,6,8,11
334,Don Reid\reiddo01,PF,26,TOT,38,3,498,60,112,.536,0,0,,60,112,.536,.536,24,34,.706,31,71,102,11,24,31,23,118,144
335,J.R. Reid\reidjr01,PF,31,MIL,34,7,602,53,127,.417,1,7,.143,52,120,.433,.421,43,56,.768,29,88,117,18,19,5,20,81,150
336,Rodrick Rhodes\rhodero01,SF,26,DAL,1,0,8,0,3,.000,0,0,,0,3,.000,.000,0,0,,1,0,1,0,2,0,2,0,0
337,Glen Rice\ricegl01,SF,32,LAL,80,80,2530,421,980,.430,84,229,.367,337,751,.449,.472,346,396,.874,56,271,327,176,47,12,114,179,1272
338,Mitch Richmond*\richmmi01,SG,34,WAS,74,69,2397,447,1049,.426,93,241,.386,354,808,.438,.470,298,340,.876,37,176,213,185,110,13,154,191,1285
339,Isaiah Rider\rideris01,SG,28,ATL,60,47,2084,449,1072,.419,56,180,.311,393,892,.441,.445,204,260,.785,63,195,258,219,41,6,168,132,1158
340,Stanley Roberts\roberst01,C,29,PHI,5,1,51,5,16,.313,0,1,.000,5,15,.333,.313,0,3,.000,6,9,15,3,1,1,2,15,10
341,Ryan Robertson\roberry01,SG,23,SAC,1,0,25,2,6,.333,0,2,.000,2,4,.500,.333,1,1,1.000,0,0,0,0,0,0,0,0,5
342,Clifford Robinson\robincl02,SF,33,PHO,80,67,2839,530,1142,.464,120,324,.370,410,818,.501,.517,298,381,.782,105,254,359,224,90,61,166,239,1478
343,David Robinson*\robinda01,C,34,SAS,80,80,2557,528,1031,.512,0,2,.000,528,1029,.513,.512,371,511,.726,193,577,770,142,97,183,164,247,1427
344,Eddie Robinson\robined01,SF,23,CHH,67,8,1112,212,386,.549,0,4,.000,212,382,.555,.549,47,64,.734,54,130,184,32,48,25,39,67,471
345,Glenn Robinson\robingl01,SF,27,MIL,81,81,2909,690,1461,.472,86,237,.363,604,1224,.493,.502,227,283,.802,107,378,485,193,78,41,223,212,1693
346,Dennis Rodman*\rodmade01,PF,38,DAL,12,12,389,12,31,.387,0,1,.000,12,30,.400,.387,10,14,.714,48,123,171,14,2,1,19,41,34
347,Carlos Rogers\rogerca01,C,28,HOU,53,15,1101,170,324,.525,1,14,.071,169,310,.545,.526,81,137,.591,98,177,275,42,14,34,63,77,422
348,Rodney Rogers\rogerro01,PF,28,PHO,82,7,2286,428,881,.486,115,262,.439,313,619,.506,.551,159,249,.639,138,309,447,170,94,47,163,290,1130
349,Roy Rogers\rogerro02,PF,26,DEN,40,0,355,35,88,.398,0,1,.000,35,87,.402,.398,19,41,.463,33,47,80,9,2,38,10,36,89
350,Sean Rooks\rooksse01,C,30,DAL,71,13,1001,122,283,.431,0,0,,122,283,.431,.431,65,89,.730,82,166,248,68,29,52,70,169,309
351,Jalen Rose\roseja01,SF,27,IND,80,80,2978,563,1196,.471,77,196,.393,486,1000,.486,.503,254,307,.827,42,345,387,320,84,49,188,234,1457
352,Malik Rose\rosema01,PF,25,SAS,74,3,1341,176,385,.457,1,3,.333,175,382,.458,.458,143,198,.722,133,202,335,47,35,52,99,232,496
353,Michael Ruffin\ruffimi01,PF,23,CHI,71,6,975,58,138,.420,0,0,,58,138,.420,.420,43,88,.489,117,133,250,44,26,26,59,170,159
354,Bryon Russell\russebr01,SF,29,UTA,82,70,2900,408,914,.446,106,268,.396,302,646,.467,.504,237,316,.750,99,328,427,158,128,23,101,255,1159
355,Arvydas Sabonis*\sabonar01,C,35,POR,66,61,1688,302,598,.505,7,19,.368,295,579,.509,.511,167,198,.843,97,416,513,118,43,78,97,184,778
356,John Salley\sallejo01,C,35,LAL,45,3,303,25,69,.362,0,0,,25,69,.362,.362,21,28,.750,20,45,65,26,8,14,18,67,71
357,Detlef Schrempf\schrede01,SF,37,POR,77,6,1662,187,433,.432,21,52,.404,166,381,.436,.456,179,215,.833,79,253,332,197,37,17,100,182,574
358,Dennis Scott\scottde01,SF,31,VAN,66,0,1263,125,333,.375,71,189,.376,54,144,.375,.482,48,57,.842,16,90,106,69,28,9,30,104,369
359,Malik Sealy\sealyma01,SF,29,MIN,82,61,2392,371,780,.476,10,35,.286,361,745,.485,.482,177,218,.812,119,233,352,197,76,19,110,197,929
360,Brian Shaw\shawbr01,SG,33,LAL,74,2,1249,123,322,.382,18,58,.310,105,264,.398,.410,41,54,.759,45,171,216,201,35,14,75,105,305
361,Dickey Simpkins\simpkdi01,PF,27,CHI,69,48,1651,111,274,.405,0,1,.000,111,273,.407,.405,65,120,.542,124,248,372,100,22,22,128,217,287
362,Brian Skinner\skinnbr01,PF,23,LAC,33,9,775,68,134,.507,0,0,,68,134,.507,.507,43,65,.662,63,138,201,11,16,44,37,75,179
363,Joe Smith\smithjo02,C,24,MIN,78,9,1975,289,623,.464,1,1,1.000,288,622,.463,.465,195,258,.756,186,298,484,88,45,85,119,302,774
364,Michael Smith\smithmi02,SF,27,WAS,46,46,1145,108,192,.563,0,1,.000,108,191,.565,.563,73,101,.723,121,210,331,56,27,23,45,127,289
365,Steve Smith\smithst01,SG,30,POR,82,81,2689,420,900,.467,96,241,.398,324,659,.492,.520,289,340,.850,123,190,313,209,71,31,117,214,1225
366,Rik Smits\smitsri01,C,33,IND,79,79,1852,431,890,.484,0,1,.000,431,889,.485,.484,156,211,.739,94,307,401,85,20,100,108,249,1018
367,Eric Snow\snower01,PG,26,PHI,82,80,2866,257,597,.430,11,45,.244,246,552,.446,.440,126,177,.712,42,219,261,624,140,8,162,243,651
368,Felton Spencer\spencfe01,C,32,SAS,26,0,149,15,33,.455,0,0,,15,33,.455,.455,20,30,.667,15,24,39,3,6,8,9,32,50
369,Latrell Sprewell\sprewla01,SF,29,NYK,82,82,3276,568,1305,.435,44,127,.346,524,1178,.445,.452,344,397,.866,49,300,349,332,109,22,226,184,1524
370,Ryan Stack\stackry01,PF,24,CLE,25,0,198,17,51,.333,0,1,.000,17,50,.340,.333,18,27,.667,15,30,45,5,4,11,17,47,52
371,Jerry Stackhouse\stackje01,SG,25,DET,82,82,3148,619,1447,.428,83,288,.288,536,1159,.462,.456,618,758,.815,118,197,315,365,103,36,311,188,1939
372,John Starks\starkjo01,SG,34,TOT,37,30,1190,203,542,.375,59,171,.345,144,371,.388,.429,50,59,.847,10,91,101,181,42,4,67,102,515
373,Vladimir Stepania\stepavl01,C,23,SEA,30,1,202,29,79,.367,0,6,.000,29,73,.397,.367,17,36,.472,21,26,47,3,10,11,22,44,75
374,Joe Stephens\stephjo01,SF,27,VAN,13,0,181,19,51,.373,0,8,.000,19,43,.442,.373,3,4,.750,13,23,36,11,7,3,6,9,41
375,Michael Stewart\stewami01,C,24,TOR,42,1,389,20,53,.377,0,0,,20,53,.377,.377,18,32,.563,33,61,94,6,5,19,17,81,58
376,Bryant Stith\stithbr01,SG,29,DEN,45,6,691,86,189,.455,17,56,.304,69,133,.519,.500,64,77,.831,23,61,84,61,18,12,33,56,253
377,John Stockton*\stockjo01,PG,37,UTA,82,82,2432,363,725,.501,43,121,.355,320,604,.530,.530,221,257,.860,45,170,215,703,143,15,179,192,990
378,Peja Stojakovic\stojape01,SF,22,SAC,74,11,1749,321,717,.448,100,267,.375,221,450,.491,.517,135,153,.882,74,202,276,106,52,7,88,97,877
379,Damon Stoudamire\stoudda01,PG,26,POR,78,78,2372,386,894,.432,80,212,.377,306,682,.449,.477,122,145,.841,61,182,243,405,77,1,149,173,974
380,Erick Strickland\stricer01,SG,26,DAL,68,67,2025,316,730,.433,73,186,.392,243,544,.447,.483,162,195,.831,69,254,323,211,105,13,102,190,867
381,Mark Strickland\stricma01,SF,29,MIA,58,5,663,122,224,.545,0,0,,122,224,.545,.545,40,56,.714,44,96,140,22,15,18,24,68,284
382,Rod Strickland\stricro02,PG,33,WAS,69,67,2188,327,762,.429,1,21,.048,326,741,.440,.430,214,305,.702,73,186,259,519,94,18,187,147,869
383,Derek Strong\stronde01,PF,31,ORL,20,0,148,21,48,.438,1,4,.250,20,44,.455,.448,11,14,.786,11,33,44,4,5,2,12,15,54
384,Bruno Sundov\sundobr01,C,19,DAL,14,0,61,12,31,.387,0,0,,12,31,.387,.387,2,2,1.000,5,7,12,2,2,2,4,16,26
385,Bob Sura\surabo01,SG,26,CLE,73,45,2216,356,815,.437,122,332,.367,234,483,.484,.512,175,251,.697,50,238,288,284,91,19,148,201,1009
386,Wally Szczerbiak\szczewa02,SF,22,MIN,73,53,2171,342,669,.511,28,78,.359,314,591,.531,.532,133,161,.826,89,183,272,201,58,23,83,175,845
387,Zan Tabak\tabakza01,C,29,IND,18,0,114,16,34,.471,0,0,,16,34,.471,.471,5,8,.625,16,16,32,4,3,9,11,13,37
388,Johnny Taylor\taylojo01,SF,25,TOT,6,0,34,5,14,.357,1,1,1.000,4,13,.308,.393,0,0,,2,4,6,1,1,1,2,5,11
389,Maurice Taylor\tayloma01,PF,23,LAC,62,60,2227,458,988,.464,1,8,.125,457,980,.466,.464,143,201,.711,96,304,400,101,51,48,169,217,1060
390,Jason Terry\terryja01,PG,22,ATL,81,27,1888,249,600,.415,46,157,.293,203,443,.458,.453,113,140,.807,24,142,166,346,90,10,156,133,657
391,Jamel Thomas\thomaja01,SF,26,TOT,7,0,46,8,18,.444,0,3,.000,8,15,.533,.444,1,1,1.000,1,4,5,6,1,0,5,2,17
392,John Thomas\thomajo02,C,24,TOR,55,6,477,49,107,.458,0,1,.000,49,106,.462,.458,16,41,.390,37,38,75,9,12,14,14,106,114
393,Kenny Thomas\thomake01,PF,22,HOU,72,29,1797,212,531,.399,32,122,.262,180,409,.440,.429,138,209,.660,147,290,437,113,54,22,112,167,594
394,Kurt Thomas\thomaku01,PF,27,NYK,80,21,1971,270,535,.505,1,3,.333,269,532,.506,.506,100,128,.781,144,361,505,82,51,42,105,278,641
395,Tim Thomas\thomati01,SF,22,MIL,80,1,2093,347,753,.461,63,182,.346,284,571,.497,.503,188,243,.774,100,232,332,113,59,31,129,227,945
396,Otis Thorpe\thorpot01,PF,37,MIA,51,1,777,125,243,.514,0,3,.000,125,240,.521,.514,29,48,.604,56,110,166,33,26,9,59,136,279
397,Robert Traylor\traylro01,PF,22,MIL,44,16,447,58,122,.475,0,4,.000,58,118,.492,.475,41,68,.603,50,65,115,20,25,25,27,79,157
398,Gary Trent\trentga01,SF,25,DAL,11,11,301,70,142,.493,0,2,.000,70,140,.500,.493,11,21,.524,20,32,52,22,8,3,25,28,151
399,Mirsad Turkcan\turkcmi01,PF,23,TOT,17,0,90,14,38,.368,0,6,.000,14,32,.438,.368,5,8,.625,13,20,33,5,3,1,8,14,33
400,Wayne Turner\turnewa01,PG,23,BOS,3,0,41,1,6,.167,0,0,,1,6,.167,.167,2,6,.333,1,2,3,5,0,0,3,4,4
401,Nick Van Exel\vanexni01,PG,28,DEN,79,79,2950,473,1213,.390,133,401,.332,340,812,.419,.445,196,240,.817,34,277,311,714,68,11,221,148,1275
402,Keith Van Horn\vanhoke01,PF,24,NJN,80,80,2782,559,1257,.445,84,228,.368,475,1029,.462,.478,333,393,.847,200,476,676,158,64,60,245,258,1535
403,Jacque Vaughn\vaughja01,PG,24,UTA,78,0,884,109,262,.416,14,34,.412,95,228,.417,.443,57,76,.750,11,54,65,121,32,0,77,92,289
404,Loy Vaught\vaughlo01,PF,31,DET,43,0,292,32,89,.360,0,3,.000,32,86,.372,.360,11,16,.688,26,65,91,11,6,4,11,45,75
405,Fred Vinson\vinsofr01,SG,29,SEA,8,0,40,5,17,.294,2,7,.286,3,10,.300,.353,1,2,.500,0,1,1,0,3,0,4,2,13
406,Antoine Walker\walkean02,PF,23,BOS,82,82,3003,648,1506,.430,73,285,.256,575,1221,.471,.455,311,445,.699,199,453,652,305,117,32,259,263,1680
407,Samaki Walker\walkesa01,PF,23,SAS,71,7,980,137,305,.449,0,0,,137,305,.449,.449,86,126,.683,77,195,272,38,10,35,64,108,360
408,Ben Wallace\wallabe01,PF,25,ORL,81,81,1959,168,334,.503,0,0,,168,334,.503,.503,54,114,.474,211,454,665,67,72,130,67,162,390
409,John Wallace\wallajo01,SF,25,NYK,60,0,798,155,332,.467,0,3,.000,155,329,.471,.467,82,102,.804,42,93,135,22,10,14,63,103,392
410,Rasheed Wallace\wallara01,PF,25,POR,81,77,2845,542,1045,.519,8,50,.160,534,995,.537,.522,233,331,.704,129,437,566,142,87,107,157,216,1325
411,Rex Walters\waltere01,PG,29,MIA,33,0,389,38,91,.418,5,20,.250,33,71,.465,.445,12,16,.750,8,28,36,65,6,0,29,44,93
412,Charlie Ward\wardch01,PG,29,NYK,72,69,1986,189,447,.423,102,264,.386,87,183,.475,.537,48,58,.828,22,206,228,300,95,16,102,176,528
413,Clarence Weatherspoon\weathcl01,PF,29,MIA,78,2,1615,215,419,.513,0,0,,215,419,.513,.513,135,183,.738,128,321,449,93,51,49,100,165,565
414,Chris Webber\webbech01,PF,26,SAC,75,75,2880,748,1548,.483,27,95,.284,721,1453,.496,.492,311,414,.751,189,598,787,345,120,128,218,264,1834
415,Bonzi Wells\wellsbo01,SF,23,POR,66,0,1162,236,480,.492,20,53,.377,216,427,.506,.513,88,129,.682,78,104,182,97,69,12,97,153,580
416,Bill Wennington\wennibi01,C,36,SAC,7,0,57,6,19,.316,0,0,,6,19,.316,.316,2,2,1.000,5,14,19,1,2,2,1,13,14
417,David Wesley\wesleda01,PG,29,CHH,82,82,2760,407,955,.426,88,248,.355,319,707,.451,.472,214,275,.778,39,186,225,463,109,11,159,186,1116
418,Doug West\westdo01,SG,32,VAN,38,0,581,59,145,.407,0,3,.000,59,142,.415,.407,34,40,.850,18,53,71,43,12,8,19,80,152
419,Mark West\westma01,C,39,PHO,22,2,127,5,12,.417,0,0,,5,12,.417,.417,5,8,.625,6,25,31,2,2,4,6,23,15
420,Jahidi White\whiteja01,C,23,WAS,80,59,1537,228,450,.507,0,0,,228,450,.507,.507,113,211,.536,202,351,553,15,31,83,94,234,569
421,Chris Whitney\whitnch01,PG,28,WAS,82,15,1627,217,521,.417,96,255,.376,121,266,.455,.509,112,132,.848,20,114,134,313,55,5,107,166,642
422,Aaron Williams\williaa01,PF,28,WAS,81,0,1545,235,450,.522,0,3,.000,235,447,.526,.522,146,201,.726,159,250,409,58,41,92,80,234,616
423,Alvin Williams\willial02,PG,25,TOR,55,28,779,114,287,.397,16,55,.291,98,232,.422,.425,48,65,.738,27,58,85,126,34,11,47,78,292
424,Eric Williams\willier01,SF,27,BOS,68,17,1378,165,386,.427,25,72,.347,140,314,.446,.460,134,169,.793,55,101,156,93,44,16,66,165,489
425,Jason Williams\willija02,PG,24,SAC,81,81,2760,363,973,.373,145,505,.287,218,468,.466,.448,128,170,.753,22,208,230,589,117,8,296,140,999
426,Jerome Williams\willije01,PF,26,DET,82,1,2102,257,456,.564,0,3,.000,257,453,.567,.564,175,284,.616,277,512,789,68,95,21,105,196,689
427,Lorenzo Williams\willilo01,PF,30,WAS,8,0,76,7,9,.778,0,0,,7,9,.778,.778,0,0,,12,13,25,1,3,6,3,13,14
428,Monty Williams\willimo01,SF,28,ORL,75,23,1501,263,538,.489,2,5,.400,261,533,.490,.491,123,166,.741,96,154,250,106,46,17,109,187,651
429,Scott Williams\willisc01,C,31,MIL,68,46,1488,213,426,.500,0,0,,213,426,.500,.500,94,129,.729,177,271,448,28,40,66,65,230,520
430,Shammond Williams\willish01,PG,24,SEA,43,5,517,84,225,.373,24,81,.296,60,144,.417,.427,33,51,.647,12,40,52,78,18,0,40,39,225
431,Walt Williams\williwa02,SF,29,HOU,76,66,1859,312,681,.458,102,261,.391,210,420,.500,.533,101,123,.821,69,237,306,157,49,44,113,190,827
432,Corliss Williamson\willico02,SF,26,SAC,76,76,1707,311,622,.500,0,0,,311,622,.500,.500,163,212,.769,122,168,290,82,38,19,110,192,785
433,Kevin Willis\willike02,PF,37,TOR,79,1,1679,236,569,.415,1,3,.333,235,566,.415,.416,131,164,.799,201,281,482,49,36,48,98,256,604
434,Dedric Willoughby\willode01,PG,25,CHI,25,1,508,61,179,.341,29,98,.296,32,81,.395,.422,39,51,.765,11,40,51,66,23,2,37,32,190
435,David Wingate\wingada01,SG,36,NYK,7,0,32,1,9,.111,0,0,,1,9,.111,.111,0,0,,1,1,2,3,1,2,2,7,2
436,Haywoode Workman\workmha01,PG,34,TOT,36,2,350,31,90,.344,14,43,.326,17,47,.362,.422,10,15,.667,1,25,26,61,20,0,18,37,86
437,Metta World Peace\artesro01,SF,20,CHI,72,63,2238,309,759,.407,60,191,.314,249,568,.438,.447,188,279,.674,62,246,308,202,119,39,166,159,866
438,Lorenzen Wright\wrighlo02,C,24,ATL,75,0,1205,180,361,.499,1,3,.333,179,358,.500,.500,87,135,.644,117,188,305,21,29,40,66,203,448
439,Tim Young\youngti01,C,23,GSW,25,0,137,13,39,.333,0,0,,13,39,.333,.333,28,36,.778,13,22,35,5,2,1,9,18,54