
Rk,Player,Pos,Age,Tm,G,GS,MP,FG,FGA,FG%,3P,3PA,3P%,2P,2PA,2P%,eFG%,FT,FTA,FT%,ORB,DRB,TRB,AST,STL,BLK,TOV,PF,PTS
1,Kareem Abdul-Jabbar*\abdulka01,C,33,LAL,80,,2976,836,1457,.574,0,1,.000,836,1456,.574,.574,423,552,.766,197,624,821,272,59,228,249,244,2095
2,Tom Abernethy\abernto01,SF,26,TOT,39,,298,25,59,.424,0,1,.000,25,58,.431,.424,13,22,.591,20,28,48,19,7,3,8,34,63
2,Tom Abernethy\abernto01,SF,26,GSW,10,,39,1,3,.333,0,0,,1,3,.333,.333,2,3,.667,1,7,8,1,1,0,2,5,4
2,Tom Abernethy\abernto01,SF,26,IND,29,,259,24,56,.429,0,1,.000,24,55,.436,.429,11,19,.579,19,21,40,18,6,3,6,29,59
3,Alvan Adams\adamsal01,C,26,PHO,75,,2054,458,870,.526,0,0,,458,870,.526,.526,199,259,.768,157,389,546,344,106,69,226,226,1115
4,Darrell Allums\allumda01,PF,22,DAL,22,,276,23,67,.343,0,1,.000,23,66,.348,.343,13,22,.591,19,46,65,25,5,8,23,51,59
5,Tiny Archibald*\architi01,PG,32,BOS,80,72,2820,382,766,.499,0,9,.000,382,757,.505,.499,342,419,.816,36,140,176,618,75,18,265,201,1106
6,Dennis Awtrey\awtrede01,C,32,SEA,47,,607,44,93,.473,0,0,,44,93,.473,.473,14,20,.700,33,75,108,54,12,8,33,85,102
7,James Bailey\baileja01,PF,23,SEA,82,,2539,444,889,.499,1,2,.500,443,887,.499,.500,256,361,.709,192,415,607,98,74,143,219,332,1145
8,Greg Ballard\ballagr01,SF,26,WSB,82,,2610,549,1186,.463,7,32,.219,542,1154,.470,.466,166,196,.847,167,413,580,195,118,39,117,194,1271
9,Mike Bantom\bantomi01,SF,29,IND,76,,2375,431,882,.489,0,6,.000,431,876,.492,.489,199,281,.708,150,277,427,240,80,85,197,284,1061
10,Billy Ray Bates\batesbi01,SG,24,POR,77,,1560,439,902,.487,14,54,.259,425,848,.501,.494,170,199,.854,71,86,157,196,82,6,149,120,1062
11,Mel Bennett\benneme01,PF,26,UTA,28,,313,26,60,.433,0,2,.000,26,58,.448,.433,53,81,.654,33,60,93,15,3,11,31,56,105
12,Kent Benson\bensoke01,C,26,DET,59,,1956,364,770,.473,0,4,.000,364,766,.475,.473,196,254,.772,124,276,400,172,72,67,190,184,924
13,Henry Bibby\bibbyhe01,PG,31,SDC,73,,1112,118,306,.386,32,95,.337,86,211,.408,.438,67,98,.684,25,49,74,200,47,2,76,85,335
14,Larry Bird*\birdla01,PF,24,BOS,82,82,3239,719,1503,.478,20,74,.270,699,1429,.489,.485,283,328,.863,191,704,895,451,161,63,289,239,1741
15,Otis Birdsong\birdsot01,SG,25,KCK,71,,2593,710,1306,.544,10,35,.286,700,1271,.551,.547,317,455,.697,119,139,258,233,93,18,173,172,1747
16,Norman Black\blackno01,SG,23,DET,3,,28,3,10,.300,0,0,,3,10,.300,.300,2,8,.250,0,2,2,2,1,0,1,2,8
17,Ron Boone\boonero01,SG,34,UTA,52,,1146,160,371,.431,11,39,.282,149,332,.449,.446,75,94,.798,17,67,84,161,33,8,111,126,406
18,Winford Boynes\boynewi01,SG,23,DAL,44,,757,121,313,.387,0,0,,121,313,.387,.387,45,55,.818,24,51,75,37,23,16,69,79,287
19,Dudley Bradley\bradldu01,SG,23,IND,82,,1867,265,559,.474,2,16,.125,263,543,.484,.476,125,178,.702,70,123,193,188,186,37,122,236,657
20,Mike Bratz\bratzmi01,PG,25,CLE,80,,2595,319,817,.390,57,169,.337,262,648,.404,.425,107,132,.811,66,132,198,452,136,17,162,194,802
21,Jim Brewer\breweji01,PF,29,LAL,78,,1107,101,197,.513,0,2,.000,101,195,.518,.513,15,40,.375,127,154,281,55,43,58,48,158,217
22,Ron Brewer\brewero01,SG,25,TOT,75,,1452,275,631,.436,1,7,.143,274,624,.439,.437,91,114,.798,34,52,86,148,61,34,92,95,642
22,Ron Brewer\brewero01,SG,25,POR,29,,548,95,246,.386,1,3,.333,94,243,.387,.388,26,34,.765,13,20,33,55,34,9,38,42,217
22,Ron Brewer\brewero01,SG,25,SAS,46,,904,180,385,.468,0,4,.000,180,381,.472,.468,65,80,.813,21,32,53,93,27,25,54,53,425
23,Junior Bridgeman\bridgju01,SF,27,MIL,77,,2215,537,1102,.487,3,21,.143,534,1081,.494,.489,213,241,.884,78,211,289,234,88,28,150,182,1290
24,Allan Bristow\bristal01,SF,29,UTA,82,,2001,271,611,.444,5,18,.278,266,593,.449,.448,166,198,.838,103,327,430,383,63,3,171,190,713
25,Dave Britton\brittda01,PG,22,WSB,2,,9,2,3,.667,0,0,,2,3,.667,.667,0,0,,0,2,2,3,1,0,2,2,4
26,Michael Brooks\brookmi01,SF,22,SDC,82,,2479,488,1018,.479,0,6,.000,488,1012,.482,.479,226,320,.706,210,232,442,208,99,31,163,234,1202
27,Fred Brown\brownfr01,SG,32,SEA,78,,1986,505,1035,.488,23,64,.359,482,971,.496,.499,173,208,.832,53,122,175,233,88,13,131,141,1206
28,Lewis Brown\brownle02,C,25,WSB,2,,5,0,3,.000,0,0,,0,3,.000,.000,2,5,.400,1,1,2,0,0,0,1,2,2
29,Rickey Brown\brownri01,C,22,GSW,45,,580,83,162,.512,0,0,,83,162,.512,.512,16,21,.762,52,114,166,21,9,14,31,103,182
30,Joe Bryant\bryanjo01,PF,26,SDC,82,,2359,379,791,.479,2,15,.133,377,776,.486,.480,193,244,.791,146,294,440,189,72,34,176,264,953
31,Quinn Buckner\bucknqu01,PG,26,MIL,82,,2384,471,956,.493,1,6,.167,470,950,.495,.493,149,203,.734,88,210,298,384,197,3,236,271,1092
32,Tom Burleson\burleto01,C,28,ATL,31,,363,41,99,.414,0,0,,41,99,.414,.414,20,41,.488,44,50,94,12,8,19,24,73,102
33,Don Buse\busedo01,SG,30,IND,58,,1095,114,287,.397,19,58,.328,95,229,.415,.430,50,65,.769,19,65,84,140,74,8,38,61,297
34,Marty Byrnes\byrnema01,SF,24,DAL,72,,1360,216,451,.479,9,20,.450,207,431,.480,.489,120,157,.764,74,103,177,113,29,17,61,126,561
35,Mack Calvin\calvima01,PG,33,CLE,21,,128,13,39,.333,1,5,.200,12,34,.353,.346,25,35,.714,2,10,12,28,5,0,17,13,52
36,Austin Carr\carrau01,SG,32,TOT,47,,657,87,234,.372,0,7,.000,87,227,.383,.372,34,54,.630,22,39,61,58,15,2,41,53,208
36,Austin Carr\carrau01,SG,32,DAL,8,,77,7,28,.250,0,0,,7,28,.250,.250,2,4,.500,4,5,9,9,1,0,9,10,16
36,Austin Carr\carrau01,SG,32,WSB,39,,580,80,206,.388,0,7,.000,80,199,.402,.388,32,50,.640,18,34,52,49,14,2,32,43,192
37,Kenny Carr\carrke01,PF,25,CLE,81,,2615,469,918,.511,0,4,.000,469,914,.513,.511,292,409,.714,260,575,835,192,76,42,231,296,1230
38,M.L. Carr\carrml01,SF,30,BOS,41,7,655,97,216,.449,1,14,.071,96,202,.475,.451,53,67,.791,26,57,83,56,30,18,47,74,248
39,Joe Barry Carroll\carrojo01,C,22,GSW,82,,2919,616,1254,.491,0,2,.000,616,1252,.492,.491,315,440,.716,274,485,759,117,50,121,243,313,1547
40,Butch Carter\cartebu01,SF,22,LAL,54,,672,114,247,.462,3,10,.300,111,237,.468,.468,70,95,.737,34,31,65,52,23,1,50,99,301
41,Reggie Carter\cartere01,SG,23,NYK,60,,536,59,179,.330,0,3,.000,59,176,.335,.330,51,69,.739,30,39,69,76,22,2,38,68,169
42,Bill Cartwright\cartwbi01,C,23,NYK,82,,2925,619,1118,.554,0,1,.000,619,1117,.554,.554,408,518,.788,161,452,613,111,48,83,200,259,1646
43,Harvey Catchings\catchha01,PF,29,MIL,77,,1635,134,300,.447,0,0,,134,300,.447,.447,59,92,.641,154,319,473,99,33,184,105,284,327
44,Maurice Cheeks*\cheekma01,PG,24,PHI,81,,2415,310,581,.534,3,8,.375,307,573,.536,.536,140,178,.787,67,178,245,560,193,39,174,231,763
45,Phil Chenier\cheniph01,SG,30,GSW,9,,82,11,33,.333,1,3,.333,10,30,.333,.348,6,6,1.000,1,7,8,7,0,0,4,10,29
46,Jim Chones\choneji01,PF,31,LAL,82,,2562,378,751,.503,0,4,.000,378,747,.506,.503,126,193,.653,180,477,657,153,39,96,159,324,882
47,Art Collins\colliar01,SG,26,ATL,29,,395,35,99,.354,0,2,.000,35,97,.361,.354,24,36,.667,19,22,41,25,11,1,32,35,94
48,Don Collins\collido02,SF,22,TOT,81,,1845,360,811,.444,0,6,.000,360,805,.447,.444,211,272,.776,129,139,268,190,104,25,174,259,931
48,Don Collins\collido02,SF,22,ATL,47,,1184,230,530,.434,0,3,.000,230,527,.436,.434,137,162,.846,96,91,187,115,69,11,107,166,597
48,Don Collins\collido02,SF,22,WSB,34,,661,130,281,.463,0,3,.000,130,278,.468,.463,74,110,.673,33,48,81,75,35,14,67,93,334
49,Doug Collins\collido01,SG,29,PHI,12,,329,62,126,.492,0,0,,62,126,.492,.492,24,29,.828,6,23,29,42,7,4,22,23,148
50,Darwin Cook\cookda01,SG,22,NJN,81,,1980,383,819,.468,6,25,.240,377,794,.475,.471,132,180,.733,96,140,236,297,141,36,176,197,904
51,Jeff Cook\cookje01,SF,24,PHO,79,,2192,286,616,.464,0,5,.000,286,611,.468,.464,100,155,.645,170,297,467,201,82,54,146,236,672
52,Michael Cooper\coopemi01,SG,24,LAL,81,,2625,321,654,.491,4,19,.211,317,635,.499,.494,117,149,.785,121,215,336,332,133,78,164,249,763
53,Wayne Cooper\coopewa01,C,24,UTA,71,,1420,213,471,.452,1,3,.333,212,468,.453,.453,62,90,.689,166,274,440,52,18,51,77,219,489
54,Dave Corzine\corzida01,C,24,SAS,82,,1960,366,747,.490,0,3,.000,366,744,.492,.490,125,175,.714,228,408,636,117,42,99,131,212,857
55,Charlie Criss\crissch01,PG,32,ATL,66,,1708,220,485,.454,1,21,.048,219,464,.472,.455,185,214,.864,26,74,100,283,61,3,134,87,626
56,Geoff Crompton\crompge01,C,25,POR,6,,33,4,8,.500,0,0,,4,8,.500,.500,1,5,.200,7,11,18,2,0,2,5,4,9
57,Pat Cummings\cummipa01,C,24,MIL,74,,1084,248,460,.539,0,2,.000,248,458,.541,.539,99,140,.707,97,195,292,62,31,19,114,192,595
58,Earl Cureton\curetea01,C,23,PHI,52,,528,93,205,.454,0,1,.000,93,204,.456,.454,33,64,.516,51,104,155,25,20,23,29,68,219
59,Bob Dandridge\dandrbo01,SF,33,WSB,23,,545,101,237,.426,0,1,.000,101,236,.428,.426,28,39,.718,19,64,83,60,16,9,33,54,230
60,Adrian Dantley*\dantlad01,SF,24,UTA,80,,3417,909,1627,.559,2,7,.286,907,1620,.560,.559,632,784,.806,192,317,509,322,109,18,282,245,2452
61,Brad Davis\davisbr01,PG,25,DAL,56,,1686,230,410,.561,3,17,.176,227,393,.578,.565,163,204,.799,29,122,151,385,52,11,123,156,626
62,Johnny Davis\davisjo01,PG,25,IND,76,,2536,426,917,.465,4,33,.121,422,884,.477,.467,238,299,.796,56,114,170,480,95,14,167,179,1094
63,Monti Davis\davismo01,PF,22,TOT,2,,10,1,5,.200,0,0,,1,5,.200,.200,1,5,.200,2,2,4,0,0,1,0,0,3
63,Monti Davis\davismo01,PF,22,PHI,1,,2,1,1,1.000,0,0,,1,1,1.000,1.000,0,0,,0,1,1,0,0,0,0,0,2
63,Monti Davis\davismo01,PF,22,DAL,1,,8,0,4,.000,0,0,,0,4,.000,.000,1,5,.200,2,1,3,0,0,1,0,0,1
64,Ron Davis\davisro01,SF,26,SDC,64,,817,139,314,.443,2,8,.250,137,306,.448,.446,94,158,.595,47,72,119,47,36,11,61,98,374
65,Walter Davis\daviswa03,SG,26,PHO,78,,2182,593,1101,.539,7,17,.412,586,1084,.541,.542,209,250,.836,63,137,200,302,97,12,222,192,1402
66,Darryl Dawkins\dawkida01,C,24,PHI,76,,2088,423,697,.607,0,0,,423,697,.607,.607,219,304,.720,106,439,545,109,38,112,220,316,1065
67,Larry Demic\demicla01,PF,23,NYK,76,,964,128,254,.504,0,2,.000,128,252,.508,.504,58,92,.630,114,129,243,28,12,13,58,153,314
68,Coby Dietrick\dietrco01,C,32,CHI,82,,1243,146,320,.456,2,6,.333,144,314,.459,.459,77,111,.694,79,186,265,118,48,53,88,176,371
69,James Donaldson\donalja01,C,23,SEA,68,,980,129,238,.542,0,0,,129,238,.542,.542,101,170,.594,107,202,309,42,8,74,68,79,359
70,Jacky Dorsey\dorseja01,SF,26,SEA,29,,253,20,70,.286,0,0,,20,70,.286,.286,13,25,.520,23,65,88,9,9,1,14,47,53
71,Leon Douglas\douglle01,C,26,KCK,79,,1356,185,323,.573,0,3,.000,185,320,.578,.573,102,186,.548,150,234,384,69,25,38,90,251,472
72,John Drew\drewjo01,SF,26,ATL,67,,2075,500,1096,.456,0,7,.000,500,1089,.459,.456,454,577,.787,145,238,383,79,98,15,194,264,1454
73,Larry Drew\drewla01,PG,22,DET,76,,1581,197,484,.407,4,17,.235,193,467,.413,.411,106,133,.797,24,96,120,249,88,7,166,125,504
74,Ralph Drollinger\drollra01,C,26,DAL,6,,67,7,14,.500,0,0,,7,14,.500,.500,1,4,.250,5,14,19,14,1,2,13,16,15
75,Terry Duerod\duerote01,SG-SF,24,TOT,50,0,451,104,234,.444,8,16,.500,96,218,.440,.462,31,41,.756,17,27,44,36,17,4,35,27,247
75,Terry Duerod\duerote01,SF,24,DAL,18,,337,74,161,.460,2,6,.333,72,155,.465,.466,18,27,.667,15,24,39,30,12,4,25,19,168
75,Terry Duerod\duerote01,SG,24,BOS,32,0,114,30,73,.411,6,10,.600,24,63,.381,.452,13,14,.929,2,3,5,6,5,0,10,8,79
76,Mike Dunleavy\dunlemi01,SG,26,HOU,74,,1609,310,632,.491,1,16,.063,309,616,.502,.491,156,186,.839,28,90,118,268,64,2,137,165,777
77,T.R. Dunn\dunntr01,SG,25,DEN,82,,1427,146,354,.412,0,2,.000,146,352,.415,.412,79,121,.653,133,168,301,81,66,29,56,141,371
78,John Duren\durenjo01,PG,22,UTA,40,,458,33,101,.327,0,1,.000,33,100,.330,.327,5,9,.556,8,27,35,54,18,2,37,54,71
79,James Edwards\edwarja01,C,25,IND,81,,2375,511,1004,.509,0,3,.000,511,1001,.510,.509,244,347,.703,191,380,571,212,32,128,164,304,1266
80,Bob Elliott\elliobo01,C,25,NJN,73,,1320,214,419,.511,1,2,.500,213,417,.511,.512,121,202,.599,104,157,261,129,34,16,119,175,550
81,Len Elmore\elmorle01,C,28,MIL,72,,925,76,212,.358,0,0,,76,212,.358,.358,54,75,.720,68,140,208,69,37,52,44,178,206
82,Alex English*\englial01,SF,27,DEN,81,,3093,768,1555,.494,3,5,.600,765,1550,.494,.495,390,459,.850,273,373,646,290,106,100,241,255,1929
83,Julius Erving*\ervinju01,SF,30,PHI,82,,2874,794,1524,.521,4,18,.222,790,1506,.525,.522,422,536,.787,244,413,657,364,173,147,266,233,2014
84,Mike Evans\evansmi01,PG,25,MIL,71,,911,134,291,.460,2,14,.143,132,277,.477,.464,50,64,.781,22,65,87,167,34,4,72,114,320
85,Eric Fernsten\fernser01,C,27,BOS,45,0,279,38,79,.481,0,0,,38,79,.481,.481,20,30,.667,29,33,62,10,6,7,20,29,96
86,Chris Ford\fordch01,SG,32,BOS,82,75,2723,314,707,.444,36,109,.330,278,598,.465,.470,64,87,.736,72,91,163,295,100,23,127,212,728
87,Don Ford\forddo01,SF,28,CLE,64,,996,100,224,.446,0,3,.000,100,221,.452,.446,22,24,.917,74,90,164,84,15,12,49,100,222
88,Phil Ford\fordph01,PG,24,KCK,66,,2287,424,887,.478,11,36,.306,413,851,.485,.484,294,354,.831,26,102,128,580,99,6,241,190,1153
89,World B. Free\freewo01,SG,27,GSW,65,,2370,516,1157,.446,5,31,.161,511,1126,.454,.448,528,649,.814,48,111,159,361,85,11,195,183,1565
90,Tony Fuller\fulleto01,SG,22,DET,15,,248,24,66,.364,0,1,.000,24,65,.369,.364,12,16,.750,13,29,42,28,10,1,23,25,60
91,Mike Gale\galemi01,PG,30,TOT,77,,1112,157,309,.508,2,7,.286,155,302,.513,.511,55,68,.809,16,83,99,169,94,7,77,117,371
91,Mike Gale\galemi01,PG,30,SAS,35,,636,86,164,.524,1,3,.333,85,161,.528,.527,19,26,.731,7,45,52,99,55,2,39,56,192
91,Mike Gale\galemi01,PG,30,POR,42,,476,71,145,.490,1,4,.250,70,141,.496,.493,36,42,.857,9,38,47,70,39,5,38,61,179
92,Calvin Garrett\garreca01,SF,24,HOU,70,,1638,188,415,.453,1,3,.333,187,412,.454,.454,50,62,.806,85,179,264,132,50,10,90,167,427
93,Gus Gerard\gerargu01,SF,27,TOT,27,,252,41,111,.369,0,4,.000,41,107,.383,.369,27,40,.675,30,37,67,15,10,9,15,41,109
93,Gus Gerard\gerargu01,SF,27,KCK,16,,123,19,51,.373,0,3,.000,19,48,.396,.373,19,29,.655,13,16,29,6,3,6,7,24,57
93,Gus Gerard\gerargu01,SF,27,SAS,11,,129,22,60,.367,0,1,.000,22,59,.373,.367,8,11,.727,17,21,38,9,7,3,8,17,52
94,George Gervin*\gervige01,SG,28,SAS,82,,2765,850,1729,.492,9,35,.257,841,1694,.496,.494,512,620,.826,126,293,419,260,94,56,251,212,2221
95,Artis Gilmore*\gilmoar01,C,31,CHI,82,,2832,547,816,.670,0,0,,547,816,.670,.670,375,532,.705,220,608,828,172,47,198,236,295,1469
96,Mike Glenn\glennmi01,PG,25,NYK,82,,1506,285,511,.558,4,11,.364,281,500,.562,.562,98,110,.891,27,61,88,108,72,5,62,126,672
97,Mike Gminski\gminsmi01,C,21,NJN,56,,1579,291,688,.423,0,1,.000,291,687,.424,.423,155,202,.767,137,282,419,72,54,100,128,127,737
98,Glen Gondrezick\gondrgl01,PF,25,DEN,73,,1077,155,329,.471,0,2,.000,155,327,.474,.471,112,137,.818,136,171,307,83,91,20,69,185,422
99,Rickey Green\greenri01,PG,26,UTA,47,,1307,176,366,.481,0,1,.000,176,365,.482,.481,70,97,.722,30,86,116,235,75,1,83,123,422
100,Dave Greenwood\greenda01,PF,23,CHI,82,,2710,481,989,.486,0,2,.000,481,987,.487,.486,217,290,.748,243,481,724,218,77,124,192,282,1179
101,Kevin Grevey\greveke01,SG,27,WSB,75,,2616,500,1103,.453,45,136,.331,455,967,.471,.474,244,290,.841,67,152,219,300,68,17,144,161,1289
102,Paul Griffin\griffpa01,PF,27,SAS,82,,1930,166,325,.511,0,0,,166,325,.511,.511,170,253,.672,184,321,505,249,77,38,132,207,502
103,Darrell Griffith\griffda01,SG,22,UTA,81,,2867,716,1544,.464,10,52,.192,706,1492,.473,.467,229,320,.716,79,209,288,194,106,40,231,219,1671
104,Bob Gross\grossbo01,SF,27,POR,82,,1934,253,479,.528,0,9,.000,253,470,.538,.528,135,159,.849,126,202,328,251,90,67,151,238,641
105,Ernie Grunfeld\grunfer01,SF,25,KCK,79,,1584,260,486,.535,0,0,,260,486,.535,.535,75,101,.743,31,175,206,205,60,15,88,155,595
106,Roy Hamilton\hamilro01,PG,23,POR,1,,5,1,3,.333,0,0,,1,3,.333,.333,1,2,.500,2,1,3,0,0,0,1,1,3
107,Bill Hanzlik\hanzlbi01,SF,23,SEA,74,,1259,138,289,.478,1,5,.200,137,284,.482,.479,119,150,.793,67,86,153,111,58,20,84,168,396
108,Alan Hardy\hardyal01,SG,23,LAL,22,,111,22,59,.373,0,0,,22,59,.373,.373,7,10,.700,8,11,19,3,1,9,11,13,51
109,James Hardy\hardyja01,PF,24,UTA,23,,509,52,111,.468,0,0,,52,111,.468,.468,11,20,.550,39,94,133,36,21,20,23,58,115
110,Mike Harper\harpemi01,PF,23,POR,55,,461,56,136,.412,0,3,.000,56,133,.421,.412,37,85,.435,28,65,93,17,23,20,32,73,149
111,Joe Hassett\hassejo01,SG,25,TOT,41,,714,143,340,.421,53,156,.340,90,184,.489,.499,17,21,.810,24,44,68,74,13,2,22,65,356
111,Joe Hassett\hassejo01,SG,25,DAL,17,,280,59,142,.415,10,40,.250,49,102,.480,.451,10,13,.769,11,14,25,18,5,0,11,21,138
111,Joe Hassett\hassejo01,SG,25,GSW,24,,434,84,198,.424,43,116,.371,41,82,.500,.533,7,8,.875,13,30,43,56,8,2,11,44,218
112,Steve Hawes\hawesst01,C,30,ATL,74,,2309,333,637,.523,1,4,.250,332,633,.524,.524,222,278,.799,165,396,561,168,73,32,161,289,889
113,Elvin Hayes*\hayesel01,PF,35,WSB,81,,2931,584,1296,.451,0,10,.000,584,1286,.454,.451,271,439,.617,235,554,789,98,68,171,189,300,1439
114,Gar Heard\heardga01,PF,32,SDC,78,,1631,149,396,.376,0,7,.000,149,389,.383,.376,79,101,.782,120,228,348,122,104,72,81,196,377
115,Gerald Henderson\hendege01,PG,25,BOS,82,10,1608,261,579,.451,1,16,.063,260,563,.462,.452,113,157,.720,43,89,132,213,79,12,160,177,636
116,Tom Henderson\hendeto01,SG,29,HOU,66,,1411,137,332,.413,0,3,.000,137,329,.416,.413,78,95,.821,30,74,104,307,53,4,93,111,352
117,Keith Herron\herroke01,SG,24,DET,80,,2270,432,954,.453,2,11,.182,430,943,.456,.454,228,267,.854,98,113,211,148,91,26,153,154,1094
118,Kenny Higgs\higgske01,PG,26,DEN,72,,1689,209,474,.441,4,34,.118,205,440,.466,.445,140,172,.814,24,121,145,408,101,6,166,243,562
119,Johnny High\highjo01,PG,23,PHO,81,,1750,246,576,.427,2,24,.083,244,552,.442,.429,183,264,.693,89,139,228,202,129,26,188,251,677
120,Armond Hill\hillar01,PG,27,TOT,75,,1738,117,335,.349,0,7,.000,117,328,.357,.349,141,172,.820,41,118,159,292,66,11,127,207,375
120,Armond Hill\hillar01,PG,27,ATL,24,,624,39,116,.336,0,1,.000,39,115,.339,.336,42,50,.840,10,41,51,118,26,3,58,60,120
120,Armond Hill\hillar01,PG,27,SEA,51,,1114,78,219,.356,0,6,.000,78,213,.366,.356,99,122,.811,31,77,108,174,40,8,69,147,255
121,Brad Holland\hollabr01,SG,24,LAL,41,,295,47,111,.423,1,3,.333,46,108,.426,.428,35,49,.714,9,20,29,23,21,1,31,44,130
122,Lionel Hollins\hollili01,PG,27,PHI,82,,2154,327,696,.470,2,15,.133,325,681,.477,.471,125,171,.731,47,144,191,352,104,18,207,205,781
123,Cedrick Hordges\hordgce01,PF,24,DEN,68,,1599,221,480,.460,0,3,.000,221,477,.463,.460,130,186,.699,120,338,458,104,33,19,120,226,572
124,Phil Hubbard\hubbaph01,PF,24,DET,80,,2289,433,880,.492,1,3,.333,432,877,.493,.493,294,426,.690,236,350,586,150,80,20,229,317,1161
125,Kim Hughes\hugheki01,C,28,TOT,53,,490,27,70,.386,0,0,,27,70,.386,.386,1,2,.500,48,79,127,35,28,35,44,106,55
125,Kim Hughes\hugheki01,C,28,DEN,8,,159,11,25,.440,0,0,,11,25,.440,.440,1,2,.500,19,31,50,11,11,14,11,33,23
125,Kim Hughes\hugheki01,C,28,CLE,45,,331,16,45,.356,0,0,,16,45,.356,.356,0,0,,29,48,77,24,17,21,33,73,32
126,Geoff Huston\hustoge01,PG,23,TOT,81,,2434,461,942,.489,1,5,.200,460,937,.491,.490,150,212,.708,45,93,138,394,58,7,179,148,1073
126,Geoff Huston\hustoge01,PG,23,DAL,56,,1892,385,789,.488,1,4,.250,384,785,.489,.489,128,185,.692,33,66,99,277,45,6,148,113,899
126,Geoff Huston\hustoge01,PG,23,CLE,25,,542,76,153,.497,0,1,.000,76,152,.500,.497,22,27,.815,12,27,39,117,13,1,31,35,174
127,Dan Issel*\isselda01,C,32,DEN,80,,2641,614,1220,.503,2,12,.167,612,1208,.507,.504,519,684,.759,229,447,676,158,83,53,130,249,1749
128,Tony Jackson\jacksto02,PG,23,LAL,2,,14,1,3,.333,0,0,,1,3,.333,.333,0,0,,0,2,2,2,2,0,0,1,2
129,Abdul Jeelani\jeelaab01,SF,26,DAL,66,,1108,187,440,.425,0,1,.000,187,439,.426,.425,179,220,.814,83,147,230,65,44,31,87,123,553
130,Clemon Johnson\johnscl01,C,24,IND,81,,1643,235,466,.504,0,1,.000,235,465,.505,.504,112,189,.593,173,295,468,144,44,119,121,185,582
131,Dennis Johnson*\johnsde01,PG,26,PHO,79,,2615,532,1220,.436,11,51,.216,521,1169,.446,.441,411,501,.820,160,203,363,291,136,61,208,244,1486
132,Eddie Johnson\johnsed02,SG,25,ATL,75,,2693,573,1136,.504,6,20,.300,567,1116,.508,.507,279,356,.784,60,119,179,407,126,11,197,188,1431
133,George Johnson\johnsge02,C,32,SAS,82,,1935,164,347,.473,0,0,,164,347,.473,.473,80,109,.734,215,387,602,92,47,278,110,273,408
134,George Johnson\johnsge03,PF,24,IND,43,,930,182,394,.462,0,5,.000,182,389,.468,.462,93,122,.762,99,179,278,86,47,23,85,120,457
135,John Johnson\johnsjo01,SF,33,SEA,80,,2324,373,866,.431,0,1,.000,373,865,.431,.431,173,214,.808,135,227,362,312,57,25,230,202,919
136,Lee Johnson\johnsle01,PF,23,TOT,12,,90,7,25,.280,0,0,,7,25,.280,.280,3,5,.600,6,16,22,1,0,5,7,18,17
136,Lee Johnson\johnsle01,PF,23,HOU,10,,80,7,23,.304,0,0,,7,23,.304,.304,3,5,.600,6,14,20,1,0,5,7,17,17
136,Lee Johnson\johnsle01,PF,23,DET,2,,10,0,2,.000,0,0,,0,2,.000,.000,0,0,,0,2,2,0,0,0,0,1,0
137,Magic Johnson*\johnsma02,SG,21,LAL,37,,1371,312,587,.532,3,17,.176,309,570,.542,.534,171,225,.760,101,219,320,317,127,27,143,100,798
138,Marques Johnson\johnsma01,SF,24,MIL,76,,2542,636,1153,.552,0,9,.000,636,1144,.556,.552,269,381,.706,225,293,518,346,115,41,190,196,1541
139,Mickey Johnson\johnsmi01,PF,28,MIL,82,,2118,379,846,.448,3,18,.167,376,828,.454,.450,262,332,.789,183,362,545,286,94,71,230,256,1023
140,Ollie Johnson\johnsol01,SF,31,PHI,40,,372,87,158,.551,1,6,.167,86,152,.566,.554,27,31,.871,8,47,55,30,20,2,25,45,202
141,Reggie Johnson\johnsre01,PF,23,SAS,79,,1716,340,682,.499,0,1,.000,340,681,.499,.499,128,193,.663,132,226,358,78,45,48,130,283,808
142,Vinnie Johnson\johnsvi01,PG,24,SEA,81,,2311,419,785,.534,1,5,.200,418,780,.536,.534,214,270,.793,193,173,366,341,78,20,216,198,1053
143,Bobby Jones\jonesbo01,PF,29,PHI,81,,2046,407,755,.539,0,3,.000,407,752,.541,.539,282,347,.813,142,293,435,226,95,74,149,226,1096
144,Caldwell Jones\jonesca01,C,30,PHI,81,,2639,218,485,.449,0,0,,218,485,.449,.449,148,193,.767,200,613,813,122,53,134,168,271,584
145,Dwight Jones\jonesdw01,PF,28,CHI,81,,1574,245,507,.483,0,0,,245,507,.483,.483,125,161,.776,127,274,401,99,40,36,126,200,615
146,Edgar Jones\jonesed01,PF,24,NJN,60,,950,189,357,.529,0,4,.000,189,353,.535,.529,146,218,.670,92,171,263,43,36,81,101,185,524
147,Major Jones\jonesma01,PF,27,HOU,68,,1003,117,252,.464,0,1,.000,117,251,.466,.464,64,101,.634,96,138,234,41,18,23,57,112,298
148,Eddie Jordan\jordaed01,PG,26,TOT,74,,1226,150,352,.426,6,22,.273,144,330,.436,.435,87,127,.685,30,68,98,241,98,8,143,165,393
148,Eddie Jordan\jordaed01,PG,26,NJN,14,,239,30,73,.411,3,10,.300,27,63,.429,.432,24,32,.750,5,13,18,46,24,1,23,29,87
148,Eddie Jordan\jordaed01,PG,26,LAL,60,,987,120,279,.430,3,12,.250,117,267,.438,.435,63,95,.663,25,55,80,195,74,7,120,136,306
149,Walter Jordan\jordawa01,SF,24,CLE,30,,207,29,75,.387,0,0,,29,75,.387,.387,10,17,.588,23,19,42,11,11,5,17,35,68
150,Jeff Judkins\judkije01,SF,24,UTA,62,,666,92,216,.426,9,28,.321,83,188,.441,.447,45,51,.882,29,64,93,59,16,2,30,84,238
151,Clarence Kea\keacl01,PF,21,DAL,16,,199,37,81,.457,0,1,.000,37,80,.463,.457,43,62,.694,28,39,67,5,6,1,16,44,117
152,Rich Kelley\kelleri01,C,27,PHO,81,,1686,196,387,.506,0,2,.000,196,385,.509,.506,175,231,.758,131,310,441,282,79,63,209,210,567
153,Greg Kelser\kelsegr01,SF,23,DET,25,,654,120,285,.421,0,2,.000,120,283,.424,.421,68,106,.642,53,67,120,45,34,29,78,89,308
154,Larry Kenon\kenonla01,SF,28,CHI,77,,2161,454,946,.480,0,0,,454,946,.480,.480,180,245,.735,179,219,398,120,75,18,161,160,1088
155,Chad Kinch\kinchch01,SG,22,TOT,41,,353,52,141,.369,0,0,,52,141,.369,.369,14,18,.778,7,26,33,45,11,6,30,33,118
155,Chad Kinch\kinchch01,SG,22,CLE,29,,247,38,96,.396,0,0,,38,96,.396,.396,4,5,.800,7,17,24,35,9,5,22,24,80
155,Chad Kinch\kinchch01,SG,22,DAL,12,,106,14,45,.311,0,0,,14,45,.311,.311,10,13,.769,0,9,9,10,2,1,8,9,38
156,Bernard King*\kingbe01,SF,24,GSW,81,,2914,731,1244,.588,2,6,.333,729,1238,.589,.588,307,437,.703,178,373,551,287,72,34,265,304,1771
157,Reggie King\kingre01,PF,23,KCK,81,,2743,472,867,.544,0,0,,472,867,.544,.544,264,386,.684,235,551,786,122,102,41,164,227,1208
158,Billy Knight\knighbi01,SG,28,IND,82,,2385,546,1025,.533,3,19,.158,543,1006,.540,.534,341,410,.832,191,219,410,157,84,12,177,155,1436
159,Joel Kramer\kramejo01,PF,25,PHO,82,,1065,136,258,.527,0,1,.000,136,257,.529,.527,63,91,.692,77,155,232,88,35,17,67,132,335
160,Wayne Kreklow\kreklwa01,SG,24,BOS,25,0,100,11,47,.234,1,4,.250,10,43,.233,.245,7,10,.700,2,10,12,9,2,1,10,20,30
161,Kevin Kunnert\kunneke01,C,29,POR,55,,842,101,216,.468,0,0,,101,216,.468,.468,42,54,.778,98,189,287,67,17,32,50,143,244
162,Mitch Kupchak\kupchmi01,PF,26,WSB,82,,1934,392,747,.525,0,1,.000,392,746,.525,.525,240,340,.706,198,371,569,62,36,26,161,195,1024
163,Sam Lacey\laceysa01,C,32,KCK,82,,2228,237,536,.442,1,5,.200,236,531,.444,.443,92,117,.786,131,453,584,399,95,120,182,302,567
164,Tom LaGarde\lagarto01,C,25,DAL,82,,2670,417,888,.470,0,0,,417,888,.470,.470,288,444,.649,177,488,665,237,35,45,206,293,1122
165,Bill Laimbeer\laimbbi01,C,23,CLE,81,,2460,337,670,.503,0,0,,337,670,.503,.503,117,153,.765,266,427,693,216,56,78,132,332,791
166,John Lambert\lambejo01,PF,28,TOT,46,,483,68,165,.412,0,2,.000,68,163,.417,.412,18,23,.783,28,65,93,27,12,5,19,76,154
166,John Lambert\lambejo01,PF,28,CLE,3,,8,3,5,.600,0,0,,3,5,.600,.600,0,0,,1,2,3,3,0,0,2,2,6
166,John Lambert\lambejo01,PF,28,KCK,43,,475,65,160,.406,0,2,.000,65,158,.411,.406,18,23,.783,27,63,90,24,12,5,17,74,148
167,Mark Landsberger\landsma01,PF,25,LAL,69,,1086,164,327,.502,0,1,.000,164,326,.503,.502,62,116,.534,152,225,377,27,19,6,65,135,390
168,Bob Lanier*\laniebo01,C,32,MIL,67,,1753,376,716,.525,1,1,1.000,375,715,.524,.526,208,277,.751,128,285,413,179,73,81,139,184,961
169,Edmund Lawrence\lawreed01,C,28,DET,3,,19,5,8,.625,0,0,,5,8,.625,.625,2,4,.500,2,2,4,1,1,0,1,6,12
170,Allen Leavell\leaveal01,PG,23,HOU,79,,1686,258,548,.471,2,17,.118,256,531,.482,.473,124,149,.832,30,104,134,384,97,15,189,160,642
171,Ron Lee\leero01,PG,28,DET,82,,1829,113,323,.350,2,13,.154,111,310,.358,.353,113,156,.724,65,155,220,362,166,29,173,260,341
172,Ronnie Lester\lestero01,PG,22,CHI,8,,83,10,24,.417,0,0,,10,24,.417,.417,10,11,.909,3,3,6,7,2,0,9,5,30
173,Scott Lloyd\lloydsc01,C,28,DAL,72,,2186,245,547,.448,0,2,.000,245,545,.450,.448,147,205,.717,161,293,454,159,34,25,145,269,637
174,John Long\longjo01,SG,24,DET,59,,1750,441,957,.461,2,11,.182,439,946,.464,.462,160,184,.870,95,102,197,106,95,22,151,164,1044
175,John Lucas\lucasjo01,PG,27,GSW,66,,1919,222,506,.439,4,24,.167,218,482,.452,.443,107,145,.738,34,120,154,464,83,2,185,140,555
176,Maurice Lucas\lucasma01,PF,28,NJN,68,,2162,404,835,.484,0,2,.000,404,833,.485,.484,191,254,.752,153,422,575,173,57,59,176,260,999
177,Ollie Mack\mackol01,SG,23,TOT,65,,1682,279,606,.460,0,9,.000,279,597,.467,.460,80,125,.640,92,138,230,163,56,7,70,117,638
177,Ollie Mack\mackol01,SG,23,CHI,3,,16,1,6,.167,0,0,,1,6,.167,.167,1,2,.500,0,1,1,1,1,0,0,3,3
177,Ollie Mack\mackol01,SG,23,DAL,62,,1666,278,600,.463,0,9,.000,278,591,.470,.463,79,123,.642,92,137,229,162,55,7,70,114,635
178,Kyle Macy\macyky01,PG,23,PHO,82,,1469,272,532,.511,12,51,.235,260,481,.541,.523,107,119,.899,44,88,132,160,76,5,95,120,663
179,Rick Mahorn\mahorri01,PF,22,WSB,52,,696,111,219,.507,0,0,,111,219,.507,.507,27,40,.675,67,148,215,25,21,44,38,134,249
180,Moses Malone*\malonmo01,C,25,HOU,80,,3245,806,1545,.522,1,3,.333,805,1542,.522,.522,609,804,.757,474,706,1180,141,83,150,308,223,2222
181,Wes Matthews\matthwe01,PG,21,TOT,79,,2266,385,779,.494,5,21,.238,380,758,.501,.497,202,252,.802,46,93,139,411,107,17,261,242,977
181,Wes Matthews\matthwe01,PG,21,WSB,45,,1161,224,449,.499,5,15,.333,219,434,.505,.504,99,129,.767,30,37,67,199,46,10,149,120,552
181,Wes Matthews\matthwe01,PG,21,ATL,34,,1105,161,330,.488,0,6,.000,161,324,.497,.488,103,123,.837,16,56,72,212,61,7,112,122,425
182,Cedric Maxwell\maxwece01,SF,25,BOS,81,81,2730,441,750,.588,0,1,.000,441,749,.589,.588,352,450,.782,222,303,525,219,79,68,180,256,1234
183,Scott May\maysc01,SF,26,CHI,63,,815,165,338,.488,0,0,,165,338,.488,.488,113,149,.758,62,93,155,63,35,7,71,83,443
184,Bill Mayfield\mayfibi01,SF,23,GSW,7,,54,8,18,.444,0,0,,8,18,.444,.444,1,2,.500,7,2,9,1,0,1,3,8,17
185,Bob McAdoo*\mcadobo01,PF,29,TOT,16,,321,68,157,.433,0,1,.000,68,156,.436,.433,29,41,.707,17,50,67,30,17,13,32,38,165
185,Bob McAdoo*\mcadobo01,PF,29,DET,6,,168,30,82,.366,0,0,,30,82,.366,.366,12,20,.600,9,32,41,20,8,7,18,16,72
185,Bob McAdoo*\mcadobo01,PF,29,NJN,10,,153,38,75,.507,0,1,.000,38,74,.514,.507,17,21,.810,8,18,26,10,9,6,14,22,93
186,Andre McCarter\mccaran01,PG,27,WSB,43,,448,51,135,.378,2,8,.250,49,127,.386,.385,18,24,.750,16,23,39,73,14,0,24,36,122
187,Keith McCord\mccorke01,SG,23,WSB,2,,9,2,4,.500,0,0,,2,4,.500,.500,0,0,,1,1,2,1,0,0,2,0,4
188,Jim McElroy\mcelrji01,PG,27,ATL,54,,680,78,202,.386,1,8,.125,77,194,.397,.389,48,59,.814,10,38,48,84,20,9,79,62,205
189,George McGinnis*\mcginge01,PF,30,IND,69,,1845,348,768,.453,0,7,.000,348,761,.457,.453,207,385,.538,164,364,528,210,99,28,221,242,903
190,Kevin McHale*\mchalke01,PF,23,BOS,82,1,1645,355,666,.533,0,2,.000,355,664,.535,.533,108,159,.679,155,204,359,55,27,151,110,260,818
191,Billy McKinney\mckinbi01,PG,25,TOT,84,,2166,327,645,.507,2,12,.167,325,633,.513,.509,162,188,.862,36,148,184,360,99,11,158,231,818
191,Billy McKinney\mckinbi01,PG,25,UTA,35,,1032,124,233,.532,1,2,.500,123,231,.532,.534,44,48,.917,12,62,74,157,38,4,70,107,293
191,Billy McKinney\mckinbi01,PG,25,DEN,49,,1134,203,412,.493,1,10,.100,202,402,.502,.494,118,140,.843,24,86,110,203,61,7,88,124,525
192,Tom McMillen\mcmilto01,C,28,ATL,79,,1564,253,519,.487,1,6,.167,252,513,.491,.488,80,108,.741,96,199,295,72,23,25,81,165,587
193,John Mengelt\mengejo01,SG,31,GSW,2,,11,0,4,.000,0,0,,0,4,.000,.000,0,0,,0,0,0,2,0,0,0,0,0
194,Joe Meriweather\meriwjo01,C,27,KCK,74,,1514,206,415,.496,0,0,,206,415,.496,.496,148,213,.695,126,267,393,77,27,80,125,219,560
195,Dick Miller\milledi01,SF,22,TOT,8,,53,4,9,.444,0,1,.000,4,8,.500,.444,0,0,,2,5,7,5,4,0,8,5,8
195,Dick Miller\milledi01,SF,22,IND,5,,34,2,6,.333,0,1,.000,2,5,.400,.333,0,0,,1,3,4,4,3,0,4,2,4
195,Dick Miller\milledi01,SF,22,UTA,3,,19,2,3,.667,0,0,,2,3,.667,.667,0,0,,1,2,3,1,1,0,4,3,4
196,Mike Mitchell\mitchmi01,SF,25,CLE,82,,3194,853,1791,.476,4,9,.444,849,1782,.476,.477,302,385,.784,215,287,502,139,63,52,175,199,2012
197,Steve Mix\mixst01,SF,33,PHI,72,,1327,288,575,.501,0,3,.000,288,572,.503,.501,200,240,.833,105,159,264,114,59,18,88,107,776
198,Paul Mokeski\mokespa01,C,24,DET,80,,1815,224,458,.489,0,1,.000,224,457,.490,.489,120,200,.600,141,277,418,135,38,73,160,267,568
199,Sidney Moncrief\moncrsi01,SG,23,MIL,80,,2417,400,739,.541,2,9,.222,398,730,.545,.543,320,398,.804,186,220,406,264,90,37,145,156,1122
200,Johnny Moore\moorejo01,PG,22,SAS,82,,1578,249,520,.479,1,19,.053,248,501,.495,.480,105,172,.610,58,138,196,373,120,22,154,178,604
201,Lowes Moore\moorelo01,PG,23,NJN,71,,1406,212,478,.444,4,27,.148,208,451,.461,.448,69,92,.750,43,125,168,228,61,17,108,179,497
202,Calvin Murphy*\murphca01,PG,32,HOU,76,,2014,528,1074,.492,4,17,.235,524,1057,.496,.493,206,215,.958,33,54,87,222,111,6,129,209,1266
203,Swen Nater\natersw01,C,31,SDC,82,,2809,517,935,.553,0,0,,517,935,.553,.553,244,307,.795,295,722,1017,199,49,46,211,295,1278
204,Calvin Natt\nattca01,SF,24,POR,74,,2111,395,794,.497,4,8,.500,391,786,.497,.500,200,283,.707,149,282,431,159,73,18,163,188,994
205,Kenny Natt\nattke01,SG,22,IND,19,,149,25,77,.325,2,8,.250,23,69,.333,.338,7,11,.636,9,6,15,10,5,1,10,18,59
206,Mike Newlin\newlimi01,SG,32,NJN,79,,2911,632,1272,.497,10,30,.333,622,1242,.501,.501,414,466,.888,78,141,219,299,87,9,248,237,1688
207,Carl Nicks\nicksca01,PG,22,TOT,67,,1109,172,359,.479,0,4,.000,172,355,.485,.479,71,126,.563,37,73,110,149,60,3,116,141,415
207,Carl Nicks\nicksca01,PG,22,DEN,27,,493,65,149,.436,0,1,.000,65,148,.439,.436,35,59,.593,13,36,49,80,28,2,63,52,165
207,Carl Nicks\nicksca01,PG,22,UTA,40,,616,107,210,.510,0,3,.000,107,207,.517,.510,36,67,.537,24,37,61,69,32,1,53,89,250
208,Mike Niles\nilesmi01,SF,25,PHO,44,,231,48,138,.348,2,4,.500,46,134,.343,.355,17,37,.459,26,32,58,15,8,1,25,41,115
209,Norm Nixon\nixonno01,PG,25,LAL,79,,2962,576,1210,.476,2,12,.167,574,1198,.479,.477,196,252,.778,64,168,232,696,146,11,285,226,1350
210,Mike O'Koren\okoremi01,SF,22,NJN,79,,2473,365,751,.486,5,18,.278,360,733,.491,.489,135,212,.637,179,299,478,252,86,27,146,243,870
211,Mark Olberding\olberma01,SF,24,SAS,82,,2408,348,685,.508,1,7,.143,347,678,.512,.509,315,380,.829,146,325,471,277,75,31,202,307,1012
212,Jawann Oldham\oldhaja01,C,23,DEN,4,,21,2,6,.333,0,0,,2,6,.333,.333,0,0,,3,2,5,0,0,2,2,3,4
213,Louis Orr\orrlo01,SF,22,IND,82,,1787,348,709,.491,0,6,.000,348,703,.495,.491,163,202,.807,172,189,361,132,55,25,123,153,859
214,Tom Owens\owensto01,PF,31,POR,79,,1843,322,630,.511,0,4,.000,322,626,.514,.511,191,250,.764,165,291,456,140,36,47,130,273,835
215,Robert Parish*\parisro01,C,27,BOS,82,78,2298,635,1166,.545,0,1,.000,635,1165,.545,.545,282,397,.710,245,532,777,144,81,214,191,310,1552
216,Sonny Parker\parkeso01,SG,25,GSW,73,,1317,191,388,.492,0,0,,191,388,.492,.492,94,128,.734,101,93,194,106,67,13,84,112,476
217,Myles Patrick\patrimy01,SF,26,LAL,3,,9,2,5,.400,0,0,,2,5,.400,.400,1,2,.500,1,1,2,1,0,0,1,3,5
218,Billy Paultz\paultbi01,PF,32,HOU,81,,1659,262,517,.507,0,3,.000,262,514,.510,.507,75,153,.490,111,280,391,105,28,72,89,182,599
219,Jim Paxson\paxsoji02,SG,23,POR,79,,2701,585,1092,.536,2,30,.067,583,1062,.549,.537,182,248,.734,74,137,211,299,140,9,131,172,1354
220,Sam Pellom\pellosa01,PF,29,ATL,77,,1472,186,380,.489,0,1,.000,186,379,.491,.489,81,116,.698,122,234,356,48,50,92,99,228,453
221,Roger Phegley\pheglro01,SG,24,CLE,82,,2269,474,965,.491,8,28,.286,466,937,.497,.495,224,267,.839,90,156,246,184,65,15,165,262,1180
222,Stan Pietkiewicz\pietkst01,SG,24,TOT,42,,461,57,138,.413,19,48,.396,38,90,.422,.482,11,14,.786,13,29,42,77,15,2,22,28,144
222,Stan Pietkiewicz\pietkst01,SG,24,SDC,6,,30,2,5,.400,0,0,,2,5,.400,.400,0,0,,0,1,1,2,0,0,5,2,4
222,Stan Pietkiewicz\pietkst01,SG,24,DAL,36,,431,55,133,.414,19,48,.396,36,85,.424,.485,11,14,.786,13,28,41,75,15,2,17,26,140
223,Ben Poquette\poquebe01,PF,25,UTA,82,,2808,324,614,.528,3,6,.500,321,608,.528,.530,126,162,.778,160,469,629,161,67,174,122,342,777
224,Kevin Porter\porteke01,PG,30,WSB,81,,2577,446,859,.519,3,12,.250,443,847,.523,.521,191,247,.773,35,89,124,734,110,10,251,257,1086
225,Tony Price\priceto01,SG,24,SDC,5,,29,2,7,.286,0,0,,2,7,.286,.286,0,0,,0,0,0,3,2,1,2,3,4
226,Wally Rank\rankwa01,SF,22,SDC,25,,153,21,57,.368,0,0,,21,57,.368,.368,13,28,.464,17,13,30,17,7,1,26,33,55
227,Kelvin Ransey\ranseke01,PG,22,POR,80,,2431,525,1162,.452,3,31,.097,522,1131,.462,.453,164,219,.749,42,153,195,555,88,9,232,201,1217
228,Clifford Ray\raycl01,C,32,GSW,66,,838,64,152,.421,0,0,,64,152,.421,.421,29,62,.468,73,144,217,52,24,13,74,194,157
229,James Ray\rayja01,PF,23,DEN,18,,148,15,49,.306,0,1,.000,15,48,.313,.306,7,10,.700,13,24,37,11,4,4,13,31,37
230,Billy Reid\reidbi01,SG,23,GSW,59,,597,84,185,.454,0,5,.000,84,180,.467,.454,22,39,.564,27,33,60,71,33,5,78,111,190
231,Robert Reid\reidro01,SF,25,HOU,82,,2963,536,1113,.482,0,4,.000,536,1109,.483,.482,229,303,.756,164,419,583,344,163,66,198,325,1301
232,Kevin Restani\restake01,SF,29,SAS,64,,999,192,369,.520,3,8,.375,189,361,.524,.524,62,88,.705,71,103,174,81,16,14,68,103,449
233,Clint Richardson\richacl01,SG,24,PHI,77,,1313,227,464,.489,0,1,.000,227,463,.490,.489,84,108,.778,83,93,176,152,36,10,110,102,538
234,Micheal Ray Richardson\richami01,SG,25,NYK,79,,3175,523,1116,.469,23,102,.225,500,1014,.493,.479,224,338,.663,173,372,545,627,232,35,302,258,1293
235,Anthony Roberts\roberan01,SF,25,WSB,26,,350,54,144,.375,0,0,,54,144,.375,.375,19,29,.655,18,50,68,20,11,0,28,52,127
236,Rick Robey\robeyri01,C,25,BOS,82,4,1569,298,547,.545,0,1,.000,298,546,.546,.545,144,251,.574,132,258,390,126,38,19,141,204,740
237,Cliff Robinson\robincl01,PF,20,NJN,63,,1822,525,1070,.491,1,1,1.000,524,1069,.490,.491,178,248,.718,120,361,481,105,58,52,182,216,1229
238,Truck Robinson\robintr01,PF,29,PHO,82,,3088,647,1280,.505,0,0,,647,1280,.505,.505,249,396,.629,216,573,789,206,68,38,250,220,1543
239,Wayne Robinson\robinwa01,PF,22,DET,81,,1592,234,509,.460,0,6,.000,234,503,.465,.460,175,240,.729,117,177,294,112,46,24,149,186,643
240,Bill Robinzine\robinbi01,PF,28,TOT,78,,2016,392,826,.475,1,6,.167,391,820,.477,.475,218,281,.776,168,365,533,118,75,9,187,275,1003
240,Bill Robinzine\robinbi01,PF,28,CLE,8,,84,14,32,.438,0,0,,14,32,.438,.438,5,8,.625,4,9,13,5,4,0,10,19,33
240,Bill Robinzine\robinbi01,PF,28,DAL,70,,1932,378,794,.476,1,6,.167,377,788,.478,.477,213,273,.780,164,356,520,113,71,9,177,256,970
241,Dave Robisch\robisda01,C,31,TOT,84,,2116,330,740,.446,0,0,,330,740,.446,.446,200,247,.810,157,342,499,173,37,34,83,173,860
241,Dave Robisch\robisda01,C,31,CLE,11,,372,37,98,.378,0,0,,37,98,.378,.378,29,36,.806,27,58,85,44,7,6,14,21,103
241,Dave Robisch\robisda01,C,31,DEN,73,,1744,293,642,.456,0,0,,293,642,.456,.456,171,211,.810,130,284,414,129,30,28,69,152,757
242,John Roche\rochejo01,PG,31,DEN,26,,611,82,179,.458,9,27,.333,73,152,.480,.483,58,77,.753,5,32,37,140,17,8,52,44,231
243,Tree Rollins\rollitr01,C,25,ATL,40,,1044,116,210,.552,0,1,.000,116,209,.555,.552,46,57,.807,102,184,286,35,29,117,57,151,278
244,Lorenzo Romar\romarlo01,PG,22,GSW,53,,726,87,211,.412,2,6,.333,85,205,.415,.417,43,63,.683,10,46,56,136,27,3,52,64,219
245,Dan Roundfield\roundda01,PF,27,ATL,63,,2128,426,808,.527,0,1,.000,426,807,.528,.527,256,355,.721,231,403,634,161,76,119,178,258,1108
246,Campy Russell\russeca02,SF,29,NYK,79,,2865,508,1095,.464,8,26,.308,500,1069,.468,.468,268,343,.781,109,244,353,257,99,8,212,248,1292
247,Frankie Sanders\sandefr01,SF,24,KCK,23,,186,34,77,.442,0,0,,34,77,.442,.442,20,22,.909,6,15,21,17,16,1,21,20,88
248,DeWayne Scales\scalede01,PF,22,NYK,44,,484,94,225,.418,1,6,.167,93,219,.425,.420,26,39,.667,47,85,132,10,12,4,30,54,215
249,Alvin Scott\scottal01,SF,25,PHO,82,,1423,173,348,.497,1,6,.167,172,342,.503,.499,97,127,.764,101,167,268,114,60,70,77,124,444
250,Craig Shelton\sheltcr01,SF,23,ATL,55,,586,100,219,.457,0,1,.000,100,218,.459,.457,35,58,.603,59,79,138,27,18,5,61,128,235
251,Lonnie Shelton\sheltlo01,PF,25,SEA,14,,440,73,174,.420,0,0,,73,174,.420,.420,36,55,.655,31,47,78,35,22,3,41,48,182
252,Purvis Short\shortpu01,SF,23,GSW,79,,2309,549,1157,.475,3,17,.176,546,1140,.479,.476,168,205,.820,151,240,391,249,78,19,143,244,1269
253,John Shumate\shumajo01,PF,28,TOT,24,,527,56,131,.427,0,0,,56,131,.427,.427,55,76,.724,34,54,88,24,21,9,42,49,167
253,John Shumate\shumajo01,PF,28,SAS,22,,519,56,128,.438,0,0,,56,128,.438,.438,53,73,.726,33,54,87,24,21,9,41,46,165
253,John Shumate\shumajo01,PF,28,SEA,2,,8,0,3,.000,0,0,,0,3,.000,.000,2,3,.667,1,0,1,0,0,0,1,3,2
254,Jerry Sichting\sichtje01,PG,24,IND,47,,450,34,95,.358,0,5,.000,34,90,.378,.358,25,32,.781,11,32,43,70,23,1,28,38,93
255,Jack Sikma\sikmaja01,C,25,SEA,82,,2920,595,1311,.454,0,5,.000,595,1306,.456,.454,340,413,.823,184,668,852,248,78,93,201,282,1530
256,James Silas\silasja01,PG,31,SAS,75,,2055,476,997,.477,0,2,.000,476,995,.478,.477,374,440,.850,44,187,231,285,51,12,159,129,1326
257,Larry Smith\smithla01,PF,23,GSW,82,,2578,304,594,.512,0,0,,304,594,.512,.512,177,301,.588,433,561,994,93,70,63,146,316,785
258,Phil Smith\smithph01,SG,28,SDC,76,,2378,519,1057,.491,4,18,.222,515,1039,.496,.493,237,313,.757,49,107,156,372,84,18,176,231,1279
259,Randy Smith\smithra01,SG,32,CLE,82,,2199,486,1043,.466,1,28,.036,485,1015,.478,.466,221,271,.815,46,147,193,357,113,14,195,132,1194
260,Robert Smith\smithro01,PG,25,CLE,1,,20,2,5,.400,0,0,,2,5,.400,.400,4,4,1.000,1,2,3,3,0,0,3,6,8
261,Ricky Sobers\soberri01,PG,28,CHI,71,,1803,355,769,.462,17,66,.258,338,703,.481,.473,231,247,.935,46,98,144,284,98,17,206,225,958
262,Jim Spanarkel\spanaji01,SF,23,DAL,82,,2317,404,866,.467,1,10,.100,403,856,.471,.467,375,423,.887,142,155,297,232,117,20,172,230,1184
263,Rory Sparrow\sparrro01,PG,22,NJN,15,,212,22,63,.349,0,0,,22,63,.349,.349,12,16,.750,7,11,18,32,13,3,18,15,56
264,John Stroud\stroujo01,SF,23,HOU,9,,88,11,34,.324,0,0,,11,34,.324,.324,3,4,.750,7,6,13,9,1,0,4,7,25
265,Brian Taylor\taylobr01,PG,29,SDC,80,,2312,310,591,.525,44,115,.383,266,476,.559,.562,146,185,.789,58,93,151,440,118,23,111,212,810
266,Carlos Terry\terryca01,SG,24,WSB,26,,504,80,160,.500,0,6,.000,80,154,.519,.500,28,42,.667,43,73,116,70,27,13,57,68,188
267,Reggie Theus\theusre01,SG,23,CHI,82,,2820,543,1097,.495,18,90,.200,525,1007,.521,.503,445,550,.809,124,163,287,426,122,20,259,258,1549
268,David Thompson*\thompda01,SG,26,DEN,77,,2620,734,1451,.506,10,39,.256,724,1412,.513,.509,489,615,.795,107,180,287,231,53,60,250,231,1967
269,Mychal Thompson\thompmy01,C,26,POR,79,,2790,569,1151,.494,0,1,.000,569,1150,.495,.494,207,323,.641,223,463,686,284,62,170,241,260,1345
270,Rudy Tomjanovich\tomjaru01,PF,32,HOU,52,,1264,263,563,.467,12,51,.235,251,512,.490,.478,65,82,.793,78,130,208,81,19,6,58,121,603
271,Andrew Toney\toneyan01,SG,23,PHI,75,,1768,399,806,.495,9,29,.310,390,777,.502,.501,161,226,.712,32,111,143,273,59,10,219,234,968
272,Terry Tyler\tylerte01,SF,24,DET,82,,2549,476,895,.532,0,8,.000,476,887,.537,.532,148,250,.592,198,369,567,136,112,180,163,215,1100
273,Wes Unseld*\unselwe01,C,34,WSB,63,,2032,225,429,.524,2,4,.500,223,425,.525,.527,55,86,.640,207,466,673,170,52,36,97,171,507
274,Ronnie Valentine\valenro01,SF,23,DEN,24,,123,37,98,.378,1,2,.500,36,96,.375,.383,9,19,.474,10,20,30,7,7,4,16,23,84
275,Jan van Breda Kolff\vanbrja01,SF,29,NJN,78,,1426,100,245,.408,2,8,.250,98,237,.414,.412,98,117,.838,48,154,202,129,38,50,108,214,300
276,Kiki Vandeweghe\vandeki01,SF,22,DEN,51,,1376,229,537,.426,0,7,.000,229,530,.432,.426,130,159,.818,86,184,270,94,29,24,86,116,588
277,Brett Vroman\vromabr01,C,25,UTA,11,,93,10,27,.370,0,1,.000,10,26,.385,.370,14,19,.737,7,18,25,9,5,5,9,26,34
278,Foots Walker\walkefo01,PG,29,NJN,41,,1172,72,169,.426,2,9,.222,70,160,.438,.432,88,111,.793,22,80,102,253,52,1,85,105,234
279,Wally Walker\walkewa01,SF,26,SEA,82,,1796,290,626,.463,0,3,.000,290,623,.465,.463,109,169,.645,105,210,315,122,53,15,115,168,689
280,Lloyd Walton\waltoll01,PG,27,KCK,61,,821,90,218,.413,0,1,.000,90,217,.415,.413,26,33,.788,13,35,48,208,32,2,80,45,206
281,Kermit Washington\washike01,PF,29,POR,73,,2120,325,571,.569,0,1,.000,325,570,.570,.569,181,288,.628,236,450,686,149,85,86,144,258,831
282,Richard Washington\washiri01,PF,25,TOT,80,,1812,340,747,.455,1,2,.500,339,745,.455,.456,119,159,.748,158,295,453,129,46,61,129,283,800
282,Richard Washington\washiri01,PF,25,DAL,11,,307,51,117,.436,0,0,,51,117,.436,.436,17,23,.739,25,59,84,16,5,7,21,37,119
282,Richard Washington\washiri01,PF,25,CLE,69,,1505,289,630,.459,1,2,.500,288,628,.459,.460,102,136,.750,133,236,369,113,41,54,108,246,681
283,Marvin Webster\webstma01,C,28,NYK,82,,1708,159,341,.466,1,4,.250,158,337,.469,.468,104,163,.638,162,303,465,72,27,97,103,187,423
284,Scott Wedman\wedmasc01,SF,28,KCK,81,,2902,685,1437,.477,25,77,.325,660,1360,.485,.485,140,204,.686,128,305,433,226,97,46,161,294,1535
285,Paul Westphal\westppa01,SG,30,SEA,36,,1078,221,500,.442,6,25,.240,215,475,.453,.448,153,184,.832,11,57,68,148,46,14,78,70,601
286,Jo Jo White*\whitejo01,PG,34,KCK,13,,236,36,82,.439,0,0,,36,82,.439,.439,11,18,.611,3,18,21,37,11,1,18,21,83
287,Rudy White\whiteru01,SG,27,TOT,16,,208,23,65,.354,0,1,.000,23,64,.359,.354,15,16,.938,1,10,11,20,9,1,12,23,61
287,Rudy White\whiteru01,SG,27,GSW,4,,43,9,18,.500,0,0,,9,18,.500,.500,4,4,1.000,0,0,0,2,4,0,3,7,22
287,Rudy White\whiteru01,SG,27,SEA,12,,165,14,47,.298,0,1,.000,14,46,.304,.298,11,12,.917,1,10,11,18,5,1,9,16,39
288,Jerome Whitehead\whiteje01,C,24,TOT,48,,688,83,180,.461,0,1,.000,83,179,.464,.461,28,56,.500,58,156,214,26,20,9,56,122,194
288,Jerome Whitehead\whiteje01,C,24,DAL,7,,118,16,38,.421,0,0,,16,38,.421,.421,5,11,.455,8,20,28,2,4,1,11,16,37
288,Jerome Whitehead\whiteje01,C,24,CLE,3,,8,1,3,.333,0,0,,1,3,.333,.333,0,0,,2,1,3,0,1,0,0,6,2
288,Jerome Whitehead\whiteje01,C,24,SDC,38,,562,66,139,.475,0,1,.000,66,138,.478,.475,23,45,.511,48,135,183,24,15,8,45,100,155
289,Hawkeye Whitney\whitnha02,SG,23,KCK,47,,782,149,306,.487,2,6,.333,147,300,.490,.490,50,65,.769,29,77,106,68,47,6,48,98,350
290,Sidney Wicks\wickssi01,PF,31,SDC,49,,1083,125,286,.437,0,1,.000,125,285,.439,.437,76,150,.507,79,144,223,111,40,40,94,168,326
291,Michael Wiley\wileymi01,PF,23,SAS,33,,271,76,138,.551,0,2,.000,76,136,.559,.551,36,48,.750,22,42,64,11,8,6,28,38,188
292,Bob Wilkerson\wilkebo01,SG,26,CHI,80,,2238,330,715,.462,1,10,.100,329,705,.467,.462,137,163,.840,86,196,282,272,102,23,175,170,798
293,Jamaal Wilkes*\wilkeja01,SF,27,LAL,81,,3028,786,1495,.526,1,13,.077,785,1482,.530,.526,254,335,.758,146,289,435,235,121,29,207,223,1827
294,James Wilkes\wilkeja02,SF,22,CHI,48,,540,85,184,.462,0,1,.000,85,183,.464,.462,29,42,.690,36,60,96,30,25,12,34,86,199
295,Jeff Wilkins\wilkije01,C,25,UTA,56,,1058,117,260,.450,0,0,,117,260,.450,.450,27,40,.675,62,212,274,40,32,46,59,169,261
296,Freeman Williams\willifr01,SG,24,SDC,82,,1976,642,1381,.465,48,141,.340,594,1240,.479,.482,253,297,.852,75,54,129,164,91,5,166,157,1585
297,Ray Williams\willira01,PG,26,NYK,79,,2742,616,1335,.461,16,68,.235,600,1267,.474,.467,312,382,.817,122,199,321,432,185,37,235,270,1560
298,Sly Williams\willisl01,PF,23,NYK,67,,1976,349,708,.493,2,8,.250,347,700,.496,.494,185,268,.690,159,257,416,180,116,18,141,199,885
299,John Williamson\willijo01,SG,29,WSB,9,,112,18,56,.321,1,6,.167,17,50,.340,.330,5,6,.833,0,7,7,17,4,1,12,13,42
300,Bill Willoughby\willobi01,SF,23,HOU,55,,1145,150,287,.523,0,0,,150,287,.523,.523,49,64,.766,74,153,227,64,18,31,74,102,349
301,Brian Winters\wintebr01,SG,28,MIL,69,,1771,331,697,.475,18,51,.353,313,646,.485,.488,119,137,.869,32,108,140,229,70,10,136,185,799
302,Mike Woodson\woodsmi01,SG,22,NYK,81,,949,165,373,.442,1,5,.200,164,368,.446,.444,49,64,.766,33,64,97,75,36,12,54,95,380
303,Sam Worthen\worthsa01,PG,23,CHI,64,,945,95,192,.495,0,4,.000,95,188,.505,.495,45,60,.750,22,93,115,115,57,6,91,115,235
304,Larry Wright\wrighla01,PG,26,DET,45,,997,140,303,.462,2,7,.286,138,296,.466,.465,53,66,.803,26,62,88,153,42,7,74,114,335