
Rk,Player,Pos,Age,Tm,G,GS,MP,FG,FGA,FG%,3P,3PA,3P%,2P,2PA,2P%,eFG%,FT,FTA,FT%,ORB,DRB,TRB,AST,STL,BLK,TOV,PF,PTS
1,Kareem Abdul-Jabbar*\abdulka01,C,34,LAL,76,76,2677,753,1301,.579,0,3,.000,753,1298,.580,.579,312,442,.706,172,487,659,225,63,207,230,224,1818
2,Alvan Adams\adamsal01,C,27,PHO,79,75,2393,507,1027,.494,0,1,.000,507,1026,.494,.494,182,233,.781,138,448,586,356,114,78,196,269,1196
3,Mark Aguirre\aguirma01,SF,22,DAL,51,20,1468,381,820,.465,25,71,.352,356,749,.475,.480,168,247,.680,89,160,249,164,37,22,135,152,955
4,Danny Ainge\aingeda01,SG,22,BOS,53,1,564,79,221,.357,5,17,.294,74,204,.363,.369,56,65,.862,25,31,56,87,37,3,53,86,219
5,Tiny Archibald*\architi01,PG,33,BOS,68,51,2167,308,652,.472,6,16,.375,302,636,.475,.477,236,316,.747,25,91,116,541,52,3,178,131,858
6,Dennis Awtrey\awtrede01,C,33,POR,10,3,121,5,15,.333,0,0,,5,15,.333,.333,5,9,.556,7,7,14,8,1,2,6,28,15
7,Carl Bailey\baileca01,C,23,POR,1,0,7,1,1,1.000,0,0,,1,1,1.000,1.000,0,0,,0,0,0,0,0,0,2,2,2
8,James Bailey\baileja01,PF,24,TOT,77,0,1468,261,505,.517,0,0,,261,505,.517,.517,137,224,.612,127,264,391,65,42,83,139,270,659
8,James Bailey\baileja01,PF,24,SEA,10,0,180,31,65,.477,0,0,,31,65,.477,.477,4,11,.364,17,31,48,13,3,7,19,42,66
8,James Bailey\baileja01,PF,24,NJN,67,0,1288,230,440,.523,0,0,,230,440,.523,.523,133,213,.624,110,233,343,52,39,76,120,228,593
9,Greg Ballard\ballagr01,SF,27,WSB,79,79,2946,621,1307,.475,9,22,.409,612,1285,.476,.479,235,283,.830,136,497,633,250,137,22,119,204,1486
10,Gene Banks\banksge01,SF,22,SAS,80,4,1700,311,652,.477,0,8,.000,311,644,.483,.477,145,212,.684,157,254,411,147,55,17,106,199,767
11,Mike Bantom\bantomi01,SF,30,TOT,82,38,2016,334,712,.469,2,6,.333,332,706,.470,.471,168,267,.629,174,266,440,114,63,61,149,272,838
11,Mike Bantom\bantomi01,SF,30,IND,39,37,1037,178,406,.438,1,3,.333,177,403,.439,.440,101,153,.660,87,127,214,68,38,24,85,139,458
11,Mike Bantom\bantomi01,SF,30,PHI,43,1,979,156,306,.510,1,3,.333,155,303,.512,.511,67,114,.588,87,139,226,46,25,37,64,133,380
12,Billy Ray Bates\batesbi01,SG,25,POR,75,0,1229,327,692,.473,12,41,.293,315,651,.484,.481,166,211,.787,53,55,108,111,41,5,93,100,832
13,Mel Bennett\benneme01,PF,27,CLE,3,0,23,2,4,.500,0,0,,2,4,.500,.500,1,6,.167,1,2,3,0,1,0,4,2,5
14,Kent Benson\bensoke01,C,27,DET,75,72,2467,405,802,.505,3,11,.273,402,791,.508,.507,127,158,.804,219,434,653,159,66,98,160,214,940
15,Larry Bird*\birdla01,PF,25,BOS,77,58,2923,711,1414,.503,11,52,.212,700,1362,.514,.507,328,380,.863,200,637,837,447,143,66,254,244,1761
16,Otis Birdsong\birdsot01,SG,26,NJN,37,22,1025,225,480,.469,0,10,.000,225,470,.479,.469,74,127,.583,30,67,97,124,30,5,64,74,524
17,Rolando Blackman\blackro01,SG,22,DAL,82,16,1979,439,855,.513,1,4,.250,438,851,.515,.514,212,276,.768,97,157,254,105,46,30,113,122,1091
18,Ray Blume\blumera01,SG,23,CHI,49,2,546,102,222,.459,4,18,.222,98,204,.480,.468,18,28,.643,14,27,41,68,23,2,54,57,226
19,Alex Bradley\bradlal02,SF,22,NYK,39,0,331,54,103,.524,0,1,.000,54,102,.529,.524,29,48,.604,31,34,65,11,12,5,28,37,137
20,Charles Bradley\bradlch01,SG,22,BOS,51,1,339,55,122,.451,0,1,.000,55,121,.455,.451,42,62,.677,12,26,38,22,14,6,37,61,152
21,Dudley Bradley\bradldu01,SG,24,PHO,64,3,937,125,281,.445,1,4,.250,124,277,.448,.447,74,100,.740,30,57,87,80,78,10,71,115,325
22,Brad Branson\bransbr01,PF,23,CLE,10,3,176,21,52,.404,0,0,,21,52,.404,.404,11,12,.917,14,19,33,6,5,4,13,17,53
23,Mike Bratz\bratzmi01,PG,26,SAS,81,3,1616,230,565,.407,46,138,.333,184,427,.431,.448,119,152,.783,40,126,166,438,65,11,139,183,625
24,Jim Brewer\breweji01,PF,30,LAL,71,9,966,81,175,.463,1,6,.167,80,169,.473,.466,7,19,.368,106,158,264,42,39,46,37,127,170
25,Ron Brewer\brewero01,SG,26,TOT,72,45,2319,569,1194,.477,8,31,.258,561,1163,.482,.480,211,260,.812,55,106,161,188,82,30,125,151,1357
25,Ron Brewer\brewero01,SG,26,SAS,25,4,595,182,361,.504,3,10,.300,179,351,.510,.508,77,88,.875,13,37,50,67,23,7,34,37,444
25,Ron Brewer\brewero01,SG,26,CLE,47,41,1724,387,833,.465,5,21,.238,382,812,.470,.468,134,172,.779,42,69,111,121,59,23,91,114,913
26,Junior Bridgeman\bridgju01,SF,28,MIL,41,4,924,209,433,.483,4,9,.444,205,424,.483,.487,89,103,.864,37,88,125,109,28,3,64,91,511
27,Allan Bristow\bristal01,SF,30,DAL,82,54,2035,218,499,.437,3,18,.167,215,481,.447,.440,134,164,.817,119,220,339,448,65,6,165,222,573
28,Jim Brogan\brogaji01,SG,23,SDC,63,19,1027,165,364,.453,9,32,.281,156,332,.470,.466,61,84,.726,61,59,120,156,49,13,83,123,400
29,Michael Brooks\brookmi01,SF,23,SDC,82,73,2750,537,1066,.504,0,7,.000,537,1059,.507,.504,202,267,.757,207,417,624,236,113,39,197,285,1276
30,Fred Brown\brownfr01,SG,33,SEA,82,2,1785,393,863,.455,25,77,.325,368,786,.468,.470,111,129,.860,42,98,140,238,69,4,96,111,922
31,Rickey Brown\brownri01,C,23,GSW,82,11,1260,192,418,.459,0,0,,192,418,.459,.459,86,122,.705,136,228,364,19,36,29,84,243,470
32,Joe Bryant\bryanjo01,SF,27,SDC,75,49,1988,341,701,.486,8,30,.267,333,671,.496,.492,194,247,.785,79,195,274,189,78,29,183,250,884
33,Quinn Buckner\bucknqu01,PG,27,MIL,70,70,2156,396,822,.482,4,15,.267,392,807,.486,.484,110,168,.655,77,173,250,328,174,3,180,218,906
34,Roger Burkman\burkmro01,SG,23,CHI,6,0,30,0,4,.000,0,1,.000,0,3,.000,.000,5,6,.833,2,4,6,5,6,2,3,6,5
35,David Burns\burnsda01,PG,23,TOT,9,1,87,7,16,.438,0,0,,7,16,.438,.438,9,15,.600,1,4,5,15,3,0,13,17,23
35,David Burns\burnsda01,PG,23,NJN,3,0,34,2,5,.400,0,0,,2,5,.400,.400,3,6,.500,0,2,2,4,1,0,5,4,7
35,David Burns\burnsda01,PG,23,DEN,6,1,53,5,11,.455,0,0,,5,11,.455,.455,6,9,.667,1,2,3,11,2,0,8,13,16
36,Don Buse\busedo01,PG,31,IND,82,78,2529,312,685,.455,73,189,.386,239,496,.482,.509,100,123,.813,46,177,223,407,164,27,95,176,797
37,Kenny Carr\carrke01,PF,26,TOT,74,48,1926,348,692,.503,1,10,.100,347,682,.509,.504,198,302,.656,167,364,531,86,64,22,152,249,895
37,Kenny Carr\carrke01,PF,26,CLE,46,42,1482,271,524,.517,1,9,.111,270,515,.524,.518,145,220,.659,114,280,394,63,58,16,112,180,688
37,Kenny Carr\carrke01,PF,26,DET,28,6,444,77,168,.458,0,1,.000,77,167,.461,.458,53,82,.646,53,84,137,23,6,6,40,69,207
38,M.L. Carr\carrml01,SF,31,BOS,56,27,1296,184,409,.450,5,17,.294,179,392,.457,.456,82,116,.707,56,94,150,128,67,21,63,136,455
39,Joe Barry Carroll\carrojo01,C,23,GSW,76,75,2627,527,1016,.519,0,1,.000,527,1015,.519,.519,235,323,.728,210,423,633,64,64,127,206,265,1289
40,Butch Carter\cartebu01,SG,23,IND,75,0,1035,188,402,.468,8,25,.320,180,377,.477,.478,58,70,.829,30,49,79,60,34,11,54,110,442
41,Reggie Carter\cartere01,SG,24,NYK,75,1,923,119,280,.425,0,0,,119,280,.425,.425,64,80,.800,35,60,95,130,36,6,78,124,302
42,Bill Cartwright\cartwbi01,C,24,NYK,72,50,2060,390,694,.562,0,0,,390,694,.562,.562,257,337,.763,116,305,421,87,48,65,166,208,1037
43,Harvey Catchings\catchha01,PF,30,MIL,80,9,1603,94,224,.420,0,0,,94,224,.420,.420,41,69,.594,129,227,356,97,42,134,94,237,229
44,Bobby Cattage\cattabo01,PF,23,UTA,49,0,337,60,135,.444,0,2,.000,60,133,.451,.444,30,41,.732,22,51,73,7,7,0,18,58,150
45,Tom Chambers\chambto01,PF,22,SDC,81,58,2682,554,1056,.525,0,2,.000,554,1054,.526,.525,284,458,.620,211,350,561,146,58,46,220,341,1392
46,Maurice Cheeks*\cheekma01,PG,25,PHI,79,79,2498,352,676,.521,6,22,.273,346,654,.529,.525,171,220,.777,51,197,248,667,209,33,184,247,881
47,Jim Chones\choneji01,C,32,WSB,59,13,867,74,171,.433,0,0,,74,171,.433,.433,36,46,.783,39,146,185,64,15,32,41,114,184
48,Don Collins\collido02,SG,23,WSB,79,18,1609,334,653,.511,1,12,.083,333,641,.520,.512,121,169,.716,101,95,196,148,89,24,135,195,790
49,Darwin Cook\cookda01,PG,23,NJN,82,17,2090,387,803,.482,7,31,.226,380,772,.492,.486,118,162,.728,52,103,155,319,146,24,175,196,899
50,Jeff Cook\cookje01,PF,25,PHO,76,22,1298,151,358,.422,0,2,.000,151,356,.424,.422,89,134,.664,112,189,301,100,37,23,80,174,391
51,Joe Cooper\coopejo01,C,24,NJN,1,0,11,1,2,.500,0,0,,1,2,.500,.500,0,0,,1,1,2,0,0,0,1,2,2
52,Michael Cooper\coopemi01,SG,25,LAL,76,14,2197,383,741,.517,2,17,.118,381,724,.526,.518,139,171,.813,84,185,269,230,120,61,151,216,907
53,Wayne Cooper\coopewa01,C,25,DAL,76,38,1818,281,669,.420,1,8,.125,280,661,.424,.421,119,160,.744,200,350,550,115,37,106,88,285,682
54,Hollis Copeland\copelho01,SF,26,NYK,18,0,118,16,38,.421,0,0,,16,38,.421,.421,5,6,.833,3,2,5,9,4,2,4,19,37
55,Dave Corzine\corzida01,C,25,SAS,82,21,2189,336,648,.519,1,4,.250,335,644,.520,.519,159,213,.746,211,418,629,130,33,126,139,235,832
56,Charlie Criss\crissch01,PG,33,TOT,55,20,1392,222,498,.446,10,29,.345,212,469,.452,.456,141,159,.887,13,69,82,187,44,6,82,96,595
56,Charlie Criss\crissch01,PG,33,ATL,27,0,552,84,210,.400,2,8,.250,82,202,.406,.405,65,73,.890,6,32,38,75,23,2,30,40,235
56,Charlie Criss\crissch01,PG,33,SDC,28,20,840,138,288,.479,8,21,.381,130,267,.487,.493,76,86,.884,7,37,44,112,21,4,52,56,360
57,Geoff Crompton\crompge01,C,26,MIL,35,1,203,11,32,.344,0,0,,11,32,.344,.344,6,15,.400,10,31,41,13,6,12,17,39,28
58,Pat Cummings\cummipa01,PF,25,MIL,78,7,1132,219,430,.509,0,2,.000,219,428,.512,.509,67,91,.736,61,184,245,99,22,9,108,227,505
59,Earl Cureton\curetea01,PF,24,PHI,66,8,956,149,306,.487,0,2,.000,149,304,.490,.487,51,94,.543,90,180,270,32,31,27,44,142,349
60,Bob Dandridge\dandrbo01,SF,34,MIL,11,0,174,21,55,.382,0,0,,21,55,.382,.382,10,17,.588,4,13,17,13,5,2,11,25,52
61,Adrian Dantley*\dantlad01,SF,25,UTA,81,81,3222,904,1586,.570,1,3,.333,903,1583,.570,.570,648,818,.792,231,283,514,324,95,14,299,252,2457
62,Brad Davis\davisbr01,PG,26,DAL,82,82,2614,397,771,.515,14,49,.286,383,722,.530,.524,185,230,.804,35,191,226,509,73,6,159,218,993
63,Charles Davis\davisch02,SF,23,WSB,54,10,575,88,184,.478,0,2,.000,88,182,.484,.478,30,37,.811,54,79,133,31,10,13,43,89,206
64,Johnny Davis\davisjo01,SG,26,IND,82,70,2664,538,1153,.467,5,27,.185,533,1126,.473,.469,315,394,.799,72,106,178,346,76,11,186,176,1396
65,Ron Davis\davisro01,SF,27,SDC,7,0,67,10,25,.400,0,0,,10,25,.400,.400,3,6,.500,7,6,13,4,0,0,5,8,23
66,Walter Davis\daviswa03,SF,27,PHO,55,12,1182,350,669,.523,3,16,.188,347,653,.531,.525,91,111,.820,21,82,103,162,46,3,112,104,794
67,Darryl Dawkins\dawkida01,C,25,PHI,48,36,1124,207,367,.564,0,2,.000,207,365,.567,.564,114,164,.695,68,237,305,55,19,55,96,193,528
68,Larry Demic\demicla01,PF,24,NYK,48,0,356,39,83,.470,0,1,.000,39,82,.476,.470,14,39,.359,29,50,79,14,4,6,26,65,92
69,Kenny Dennard\dennake01,PF,23,KCK,30,3,607,62,121,.512,0,0,,62,121,.512,.512,26,40,.650,47,86,133,42,35,8,35,81,150
70,Coby Dietrick\dietrco01,C,33,CHI,74,0,999,92,200,.460,0,1,.000,92,199,.462,.460,38,54,.704,63,125,188,87,49,30,44,131,222
71,Mickey Dillard\dillami01,PG,23,CLE,33,0,221,29,79,.367,0,4,.000,29,75,.387,.367,15,23,.652,6,9,15,34,8,2,17,40,73
72,James Donaldson\donalja01,C,24,SEA,82,1,1710,255,419,.609,0,0,,255,419,.609,.609,151,240,.629,138,352,490,51,27,139,115,186,661
73,John Douglas\dougljo01,SG,25,SDC,64,9,1031,181,389,.465,18,59,.305,163,330,.494,.488,67,102,.657,27,63,90,146,48,9,92,147,447
74,Leon Douglas\douglle01,C,27,KCK,63,17,1093,70,140,.500,0,0,,70,140,.500,.500,32,80,.400,111,179,290,35,15,38,55,210,172
75,John Drew\drewjo01,SF,27,ATL,70,51,2040,465,957,.486,4,12,.333,461,945,.488,.488,364,491,.741,169,206,375,96,64,3,178,250,1298
76,Larry Drew\drewla01,PG,23,KCK,81,19,1973,358,757,.473,8,27,.296,350,730,.479,.478,150,189,.794,30,119,149,419,110,1,174,150,874
77,Terry Duerod\duerote01,SG,25,BOS,21,0,146,34,77,.442,0,1,.000,34,76,.447,.442,4,12,.333,6,9,15,12,3,1,2,9,72
78,Mike Dunleavy\dunlemi01,SG,27,HOU,70,15,1315,206,450,.458,33,86,.384,173,364,.475,.494,75,106,.708,24,80,104,227,45,3,80,161,520
79,T.R. Dunn\dunntr01,SG,26,DEN,82,80,2519,258,504,.512,0,1,.000,258,503,.513,.512,153,215,.712,211,348,559,188,135,36,123,210,669
80,John Duren\durenjo01,PG,23,UTA,79,9,1056,121,268,.451,3,11,.273,118,257,.459,.457,27,37,.730,14,70,84,157,20,4,72,143,272
81,Craig Dykema\dykemcr01,SF,22,PHO,32,0,103,17,37,.459,2,4,.500,15,33,.455,.486,7,9,.778,3,9,12,15,2,0,7,19,43
82,Franklin Edwards\edwarfr01,PG,22,PHI,42,3,291,65,150,.433,0,9,.000,65,141,.461,.433,20,27,.741,10,17,27,45,16,5,24,37,150
83,James Edwards\edwarja01,C,26,CLE,77,75,2539,528,1033,.511,0,4,.000,528,1029,.513,.511,232,339,.684,189,392,581,123,24,117,162,347,1288
84,Len Elmore\elmorle01,C,29,NJN,81,70,2100,300,652,.460,0,0,,300,652,.460,.460,135,170,.794,167,274,441,100,92,92,136,280,735
85,Alex English*\englial01,SF,28,DEN,82,82,3015,855,1553,.551,0,8,.000,855,1545,.553,.551,372,443,.840,210,348,558,433,87,120,261,261,2082
86,Julius Erving*\ervinju01,SF,31,PHI,81,81,2789,780,1428,.546,3,11,.273,777,1417,.548,.547,411,539,.763,220,337,557,319,161,141,214,229,1974
87,Mike Evans\evansmi01,PG,26,TOT,22,0,270,35,86,.407,0,6,.000,35,80,.438,.407,13,20,.650,5,17,22,42,13,0,26,36,83
87,Mike Evans\evansmi01,PG,26,MIL,14,0,196,24,51,.471,0,2,.000,24,49,.490,.471,8,12,.667,3,9,12,22,9,0,15,26,56
87,Mike Evans\evansmi01,PG,26,CLE,8,0,74,11,35,.314,0,4,.000,11,31,.355,.314,5,8,.625,2,8,10,20,4,0,11,10,27
88,Eric Fernsten\fernser01,C,28,BOS,43,0,202,19,49,.388,0,0,,19,49,.388,.388,19,30,.633,12,30,42,8,5,7,13,23,57
89,Chris Ford\fordch01,SG,33,BOS,76,53,1591,188,450,.418,20,63,.317,168,387,.434,.440,39,56,.696,52,56,108,142,42,10,52,143,435
90,Don Ford\forddo01,SF,29,CLE,21,1,201,9,24,.375,0,1,.000,9,23,.391,.375,5,6,.833,14,21,35,11,8,0,15,30,23
91,Phil Ford\fordph01,PG,25,KCK,72,65,1952,285,649,.439,7,32,.219,278,617,.451,.445,136,166,.819,24,81,105,451,63,1,194,160,713
92,World B. Free\freewo01,SG,28,GSW,78,78,2796,650,1452,.448,10,56,.179,640,1396,.458,.451,479,647,.740,118,130,248,419,71,8,208,222,1789
93,Mike Gale\galemi01,PG,31,GSW,75,70,1793,185,373,.496,0,5,.000,185,368,.503,.496,51,65,.785,37,152,189,261,121,28,126,173,421
94,Calvin Garrett\garreca01,SF,25,HOU,51,22,858,105,242,.434,3,10,.300,102,232,.440,.440,17,26,.654,27,67,94,76,32,6,38,94,230
95,George Gervin*\gervige01,SG,29,SAS,79,79,2817,993,1987,.500,10,36,.278,983,1951,.504,.502,555,642,.864,138,254,392,187,77,45,210,215,2551
96,Artis Gilmore*\gilmoar01,C,32,CHI,82,82,2796,546,837,.652,1,1,1.000,545,836,.652,.653,424,552,.768,224,611,835,136,49,220,227,287,1517
97,Mike Glenn\glennmi01,SG,26,ATL,49,0,833,158,291,.543,1,2,.500,157,289,.543,.545,59,67,.881,5,56,61,87,26,3,27,80,376
98,Mike Gminski\gminsmi01,C,22,NJN,64,6,740,119,270,.441,0,0,,119,270,.441,.441,97,118,.822,70,116,186,41,17,48,56,69,335
99,Glen Gondrezick\gondrgl01,SF,26,DEN,80,0,1699,250,495,.505,0,3,.000,250,492,.508,.505,160,217,.737,140,283,423,152,92,36,100,229,660
100,Rickey Green\greenri01,PG,27,UTA,81,73,2822,500,1015,.493,0,8,.000,500,1007,.497,.493,202,264,.765,85,158,243,630,185,9,198,183,1202
101,Dave Greenwood\greenda01,PF,24,CHI,82,82,2914,480,1014,.473,0,3,.000,480,1011,.475,.473,240,291,.825,192,594,786,262,70,93,180,292,1200
102,Kevin Grevey\greveke01,SG,28,WSB,71,62,2164,376,857,.439,28,82,.341,348,775,.449,.455,165,193,.855,57,138,195,149,44,23,96,151,945
103,Paul Griffin\griffpa01,PF,28,SAS,23,0,459,32,66,.485,0,0,,32,66,.485,.485,24,37,.649,29,66,95,54,20,8,40,67,88
104,Darrell Griffith\griffda01,SG,23,UTA,80,79,2597,689,1429,.482,15,52,.288,674,1377,.489,.487,189,271,.697,128,177,305,187,95,34,193,213,1582
105,Bob Gross\grossbo01,SF,28,POR,59,24,1377,173,322,.537,3,6,.500,170,316,.538,.542,78,104,.750,101,158,259,125,75,41,88,162,427
106,Ernie Grunfeld\grunfer01,SG,26,KCK,81,11,1892,420,822,.511,2,14,.143,418,808,.517,.512,188,229,.821,55,127,182,276,72,39,148,191,1030
107,Petur Gudmundsson\gudmupe01,C,23,POR,68,6,845,83,166,.500,1,1,1.000,82,165,.497,.503,52,76,.684,51,135,186,59,13,30,73,163,219
108,Glenn Hagan\hagangl01,PG,26,DET,4,0,25,3,7,.429,0,0,,3,7,.429,.429,1,1,1.000,2,2,4,8,3,0,1,7,7
109,Bill Hanzlik\hanzlbi01,SF,24,SEA,81,76,1974,167,357,.468,0,4,.000,167,353,.473,.468,138,176,.784,99,167,266,183,81,30,106,250,472
110,Alan Hardy\hardyal01,SG,24,DET,38,0,310,62,136,.456,0,5,.000,62,131,.473,.456,18,29,.621,14,20,34,20,9,4,20,32,142
111,James Hardy\hardyja01,SF,25,UTA,82,17,1814,179,369,.485,0,1,.000,179,368,.486,.485,64,93,.688,153,317,470,110,58,67,78,192,422
112,Mike Harper\harpemi01,PF,24,POR,68,38,1433,184,370,.497,0,1,.000,184,369,.499,.497,96,153,.627,127,212,339,54,55,82,92,229,464
113,Joe Hassett\hassejo01,SG,26,GSW,68,2,787,144,382,.377,71,214,.332,73,168,.435,.470,31,37,.838,13,40,53,104,30,3,36,94,390
114,Steve Hawes\hawesst01,PF,31,ATL,49,42,1317,178,370,.481,4,10,.400,174,360,.483,.486,96,126,.762,89,231,320,142,36,34,87,156,456
115,Elvin Hayes*\hayesel01,PF,36,HOU,82,82,3032,519,1100,.472,0,5,.000,519,1095,.474,.472,280,422,.664,267,480,747,144,62,104,208,287,1318
116,Steve Hayes\hayesst01,C,26,TOT,35,0,487,54,111,.486,0,0,,54,111,.486,.486,32,53,.604,39,78,117,28,4,20,19,71,140
116,Steve Hayes\hayesst01,C,26,SAS,9,0,75,8,18,.444,0,0,,8,18,.444,.444,7,12,.583,7,10,17,4,1,2,2,17,23
116,Steve Hayes\hayesst01,C,26,DET,26,0,412,46,93,.495,0,0,,46,93,.495,.495,25,41,.610,32,68,100,24,3,18,17,54,117
117,Spencer Haywood*\haywosp01,PF,32,WSB,76,63,2086,395,829,.476,0,3,.000,395,826,.478,.476,219,260,.842,144,278,422,64,45,68,175,249,1009
118,Gerald Henderson\hendege01,PG,26,BOS,82,31,1844,353,705,.501,2,12,.167,351,693,.506,.502,125,172,.727,47,105,152,252,82,11,150,199,833
119,Tom Henderson\hendeto01,SG,30,HOU,75,23,1721,183,403,.454,0,2,.000,183,401,.456,.454,105,150,.700,33,105,138,306,55,7,105,120,471
120,Keith Herron\herroke01,SG,25,CLE,30,0,269,39,106,.368,0,1,.000,39,105,.371,.368,7,8,.875,10,11,21,23,8,2,12,25,85
121,Kenny Higgs\higgske01,PG,27,DEN,76,49,1696,202,468,.432,4,21,.190,198,447,.443,.436,161,197,.817,23,121,144,395,72,6,156,263,569
122,Armond Hill\hillar01,PG,28,TOT,40,18,723,53,126,.421,0,2,.000,53,124,.427,.421,39,55,.709,12,40,52,106,21,5,66,88,145
122,Armond Hill\hillar01,PG,28,SEA,21,4,243,19,37,.514,0,0,,19,37,.514,.514,17,23,.739,6,19,25,25,5,2,14,37,55
122,Armond Hill\hillar01,PG,28,SDC,19,14,480,34,89,.382,0,2,.000,34,87,.391,.382,22,32,.688,6,21,27,81,16,3,52,51,90
123,Brad Holland\hollabr01,SG,25,TOT,14,3,194,27,78,.346,0,3,.000,27,75,.360,.346,3,6,.500,6,7,13,18,11,1,8,13,57
123,Brad Holland\hollabr01,SG,25,WSB,13,3,185,27,73,.370,0,3,.000,27,70,.386,.370,3,4,.750,6,7,13,16,11,1,7,12,57
123,Brad Holland\hollabr01,SG,25,MIL,1,0,9,0,5,.000,0,0,,0,5,.000,.000,0,2,.000,0,0,0,2,0,0,1,1,0
124,Lionel Hollins\hollili01,PG,28,PHI,81,81,2257,380,797,.477,2,16,.125,378,781,.484,.478,132,188,.702,35,152,187,316,103,20,146,198,894
125,Cedrick Hordges\hordgce01,PF,25,DEN,77,1,1372,204,414,.493,3,13,.231,201,401,.501,.496,116,199,.583,119,276,395,65,26,19,111,230,527
126,Phil Hubbard\hubbaph01,SF,25,TOT,83,40,1839,326,665,.490,0,4,.000,326,661,.493,.490,191,280,.682,187,286,473,91,65,19,161,292,843
126,Phil Hubbard\hubbaph01,SF,25,DET,52,38,1104,207,410,.505,0,3,.000,207,407,.509,.505,106,163,.650,101,171,272,67,38,16,99,176,520
126,Phil Hubbard\hubbaph01,SF,25,CLE,31,2,735,119,255,.467,0,1,.000,119,254,.469,.467,85,117,.726,86,115,201,24,27,3,62,116,323
127,Geoff Huston\hustoge01,PG,24,CLE,78,43,2409,325,672,.484,3,10,.300,322,662,.486,.486,153,200,.765,53,97,150,590,70,11,171,169,806
128,Dan Issel*\isselda01,C,33,DEN,81,81,2472,651,1236,.527,4,6,.667,647,1230,.526,.528,546,655,.834,174,434,608,179,67,55,169,245,1852
129,Tracy Jackson\jackstr01,SG,22,TOT,49,0,478,79,172,.459,0,0,,79,172,.459,.459,38,49,.776,35,28,63,27,14,3,24,48,196
129,Tracy Jackson\jackstr01,SG,22,BOS,11,0,66,10,26,.385,0,0,,10,26,.385,.385,6,10,.600,7,5,12,5,3,0,6,5,26
129,Tracy Jackson\jackstr01,SG,22,CHI,38,0,412,69,146,.473,0,0,,69,146,.473,.473,32,39,.821,28,23,51,22,11,3,18,43,170
130,Clay Johnson\johnscl02,SG,25,LAL,7,0,65,11,20,.550,0,0,,11,20,.550,.550,3,6,.500,8,4,12,7,3,3,7,13,25
131,Clemon Johnson\johnscl01,C,25,IND,79,42,1979,312,641,.487,0,0,,312,641,.487,.487,123,189,.651,184,387,571,127,60,112,138,241,747
132,Dennis Johnson*\johnsde01,SG,27,PHO,80,77,2937,577,1228,.470,8,42,.190,569,1186,.480,.473,399,495,.806,142,268,410,369,105,55,233,253,1561
133,Eddie Johnson\johnsed02,SG,26,ATL,68,57,2314,455,1011,.450,7,30,.233,448,981,.457,.454,294,385,.764,63,128,191,358,102,16,186,188,1211
134,Eddie Johnson\johnsed03,SF,22,KCK,74,27,1517,295,643,.459,1,11,.091,294,632,.465,.460,99,149,.664,128,194,322,109,50,14,97,210,690
135,Frank Johnson\johnsfr01,PG,23,WSB,79,29,2027,336,812,.414,17,79,.215,319,733,.435,.424,153,204,.750,34,113,147,380,76,7,160,196,842
136,George Johnson\johnsge02,C,33,SAS,75,62,1578,91,195,.467,0,0,,91,195,.467,.467,43,64,.672,152,302,454,79,20,234,92,259,225
137,George Johnson\johnsge03,PF,25,IND,59,4,720,120,291,.412,0,2,.000,120,289,.415,.412,60,80,.750,72,145,217,40,36,25,68,147,300
138,John Johnson\johnsjo01,SF,34,SEA,14,1,187,22,45,.489,0,0,,22,45,.489,.489,15,20,.750,3,15,18,29,4,3,17,20,59
139,Magic Johnson*\johnsma02,SG,22,LAL,78,77,2991,556,1036,.537,6,29,.207,550,1007,.546,.540,329,433,.760,252,499,751,743,208,34,286,223,1447
140,Marques Johnson\johnsma01,SF,25,MIL,60,52,1900,404,760,.532,0,4,.000,404,756,.534,.532,182,260,.700,153,211,364,213,59,35,145,142,990
141,Mickey Johnson\johnsmi01,PF,29,MIL,76,71,1934,372,757,.491,1,7,.143,371,750,.495,.492,233,291,.801,133,321,454,215,72,45,191,240,978
142,Ollie Johnson\johnsol01,SF,32,PHI,26,0,150,27,54,.500,1,3,.333,26,51,.510,.509,6,7,.857,7,15,22,10,13,3,13,28,61
143,Reggie Johnson\johnsre01,PF,24,TOT,75,48,1904,351,662,.530,0,1,.000,351,661,.531,.530,118,156,.756,140,311,451,73,33,60,100,257,820
143,Reggie Johnson\johnsre01,PF,24,SAS,21,17,504,94,194,.485,0,0,,94,194,.485,.485,32,40,.800,43,94,137,20,7,16,26,67,220
143,Reggie Johnson\johnsre01,PF,24,CLE,23,22,617,94,175,.537,0,0,,94,175,.537,.537,35,44,.795,43,82,125,22,6,17,24,73,223
143,Reggie Johnson\johnsre01,PF,24,KCK,31,9,783,163,293,.556,0,1,.000,163,292,.558,.556,51,72,.708,54,135,189,31,20,27,50,117,377
144,Steve Johnson\johnsst03,C,24,KCK,78,50,1741,395,644,.613,0,0,,395,644,.613,.613,212,330,.642,152,307,459,91,39,89,197,372,1002
145,Vinnie Johnson\johnsvi01,SG,25,TOT,74,15,1295,217,444,.489,3,12,.250,214,432,.495,.492,107,142,.754,82,77,159,171,56,25,96,101,544
145,Vinnie Johnson\johnsvi01,SG,25,SEA,7,0,104,9,22,.409,0,1,.000,9,21,.429,.409,9,12,.750,7,8,15,11,6,2,5,8,27
145,Vinnie Johnson\johnsvi01,SG,25,DET,67,15,1191,208,422,.493,3,11,.273,205,411,.499,.496,98,130,.754,75,69,144,160,50,23,91,93,517
146,Bobby Jones\jonesbo01,PF,30,PHI,76,73,2181,416,737,.564,0,3,.000,416,734,.567,.564,263,333,.790,109,284,393,189,99,112,145,211,1095
147,Caldwell Jones\jonesca01,C,31,PHI,81,47,2446,231,465,.497,0,3,.000,231,462,.500,.497,179,219,.817,164,544,708,100,38,146,155,301,641
148,Dwight Jones\jonesdw01,PF,29,CHI,78,18,2040,303,572,.530,1,1,1.000,302,571,.529,.531,172,238,.723,156,351,507,114,49,36,155,217,779
149,Edgar Jones\jonesed01,PF,25,DET,48,19,802,142,259,.548,1,2,.500,141,257,.549,.550,90,129,.698,70,137,207,40,28,92,66,149,375
150,Major Jones\jonesma01,PF,28,HOU,60,6,746,113,213,.531,0,3,.000,113,210,.538,.531,42,77,.545,80,122,202,25,20,29,50,100,268
151,Eddie Jordan\jordaed01,PG,27,LAL,58,0,608,89,208,.428,1,9,.111,88,199,.442,.430,43,54,.796,4,39,43,131,62,1,66,98,222
152,Jeff Judkins\judkije01,SF,25,DET,30,0,251,31,81,.383,1,10,.100,30,71,.423,.389,16,26,.615,14,20,34,14,6,5,9,33,79
153,Clarence Kea\keacl01,PF,22,DAL,35,0,248,26,49,.531,0,0,,26,49,.531,.531,29,42,.690,26,35,61,14,4,3,16,55,81
154,Rich Kelley\kelleri01,C,28,PHO,81,39,1892,236,505,.467,0,1,.000,236,504,.468,.467,167,223,.749,168,329,497,293,64,71,244,292,639
155,Greg Kelser\kelsegr01,SF,24,TOT,60,10,741,116,271,.428,0,3,.000,116,268,.433,.428,105,160,.656,80,113,193,57,18,21,84,131,337
155,Greg Kelser\kelsegr01,SF,24,DET,11,0,183,35,86,.407,0,3,.000,35,83,.422,.407,27,41,.659,13,26,39,12,5,7,22,32,97
155,Greg Kelser\kelsegr01,SF,24,SEA,49,10,558,81,185,.438,0,0,,81,185,.438,.438,78,119,.655,67,87,154,45,13,14,62,99,240
156,Larry Kenon\kenonla01,PF,29,CHI,60,30,1036,192,412,.466,0,0,,192,412,.466,.466,50,88,.568,72,108,180,65,30,7,82,71,434
157,Albert King\kingal01,SF,22,NJN,76,52,1694,391,812,.482,3,13,.231,388,799,.486,.483,133,171,.778,105,207,312,142,64,36,180,261,918
158,Bernard King*\kingbe01,SF,25,GSW,79,77,2861,740,1307,.566,1,5,.200,739,1302,.568,.567,352,499,.705,140,329,469,282,78,23,267,285,1833
159,Reggie King\kingre01,SF,24,KCK,80,76,2609,383,752,.509,0,0,,383,752,.509,.509,201,285,.705,162,361,523,173,84,29,155,221,967
160,Billy Knight\knighbi01,SF,29,IND,81,19,1803,378,764,.495,9,32,.281,369,732,.504,.501,233,282,.826,97,160,257,118,63,14,137,132,998
161,Toby Knight\knighto01,SF,26,NYK,40,0,550,102,183,.557,0,0,,102,183,.557,.557,17,25,.680,33,49,82,23,14,11,21,74,221
162,Joel Kramer\kramejo01,PF,26,PHO,56,0,549,55,133,.414,0,0,,55,133,.414,.414,33,42,.786,36,72,108,51,19,11,26,62,143
163,Kevin Kunnert\kunneke01,C,30,POR,21,0,237,20,48,.417,0,0,,20,48,.417,.417,9,17,.529,20,46,66,18,3,6,18,51,49
164,Mitch Kupchak\kupchmi01,PF,27,LAL,26,26,821,153,267,.573,0,0,,153,267,.573,.573,65,98,.663,64,146,210,33,12,10,43,80,371
165,Sam Lacey\laceysa01,C,33,TOT,56,7,670,67,154,.435,0,1,.000,67,153,.438,.435,27,37,.730,20,87,107,77,22,38,56,139,161
165,Sam Lacey\laceysa01,C,33,KCK,2,1,20,3,5,.600,0,0,,3,5,.600,.600,0,2,.000,0,4,4,4,2,1,2,2,6
165,Sam Lacey\laceysa01,C,33,NJN,54,6,650,64,149,.430,0,1,.000,64,148,.432,.430,27,35,.771,20,83,103,73,20,37,54,137,155
166,Tom LaGarde\lagarto01,C,26,DAL,47,28,909,113,269,.420,0,2,.000,113,267,.423,.420,86,166,.518,63,147,210,49,17,17,82,138,312
167,Bill Laimbeer\laimbbi01,C,24,TOT,80,34,1829,265,536,.494,4,13,.308,261,523,.499,.498,184,232,.793,234,383,617,100,39,64,121,296,718
167,Bill Laimbeer\laimbbi01,C,24,CLE,50,4,894,119,253,.470,3,6,.500,116,247,.470,.476,93,120,.775,124,153,277,45,22,30,61,170,334
167,Bill Laimbeer\laimbbi01,C,24,DET,30,30,935,146,283,.516,1,7,.143,145,276,.525,.518,91,112,.813,110,230,340,55,17,34,60,126,384
168,John Lambert\lambejo01,PF,29,TOT,63,7,764,86,197,.437,1,7,.143,85,190,.447,.439,34,42,.810,55,123,178,37,18,16,48,123,207
168,John Lambert\lambejo01,PF,29,KCK,42,1,493,60,139,.432,1,6,.167,59,133,.444,.435,21,28,.750,36,91,127,24,12,10,38,80,142
168,John Lambert\lambejo01,PF,29,SAS,21,6,271,26,58,.448,0,1,.000,26,57,.456,.448,13,14,.929,19,32,51,13,6,6,10,43,65
169,Jeff Lamp\lampje01,SF,22,POR,54,0,617,100,196,.510,0,1,.000,100,195,.513,.510,50,61,.820,24,40,64,28,16,1,45,83,250
170,Mark Landsberger\landsma01,PF,26,LAL,75,1,1134,144,329,.438,0,2,.000,144,327,.440,.438,33,65,.508,164,237,401,32,10,7,49,134,321
171,Bob Lanier*\laniebo01,C,33,MIL,74,72,1986,407,729,.558,0,2,.000,407,727,.560,.558,182,242,.752,92,296,388,219,72,56,166,211,996
172,Allen Leavell\leaveal01,PG,24,HOU,79,61,2150,370,793,.467,9,31,.290,361,762,.474,.472,115,135,.852,49,119,168,457,150,15,153,182,864
173,Rock Lee\leero02,C,26,SDC,2,0,10,1,2,.500,0,0,,1,2,.500,.500,0,4,.000,0,1,1,2,0,0,0,3,2
174,Ron Lee\leero01,PG,29,DET,81,7,1467,88,246,.358,18,59,.305,70,187,.374,.394,84,119,.706,35,120,155,312,116,20,123,221,278
175,Ronnie Lester\lestero01,PG,23,CHI,75,74,2252,329,657,.501,4,8,.500,325,649,.501,.504,208,256,.813,75,138,213,362,80,14,185,158,870
176,Alton Lister\listeal01,C,23,MIL,80,23,1186,149,287,.519,0,0,,149,287,.519,.519,64,123,.520,108,279,387,84,18,118,129,239,362
177,Lewis Lloyd\lloydle01,SG,22,GSW,16,0,95,25,45,.556,0,0,,25,45,.556,.556,7,11,.636,9,7,16,6,5,1,14,20,57
178,Scott Lloyd\lloydsc01,PF,29,DAL,74,17,1047,108,285,.379,2,4,.500,106,281,.377,.382,69,91,.758,60,103,163,67,15,7,59,175,287
179,Kevin Loder\loderke01,SF,22,KCK,71,13,1139,208,448,.464,0,11,.000,208,437,.476,.464,77,107,.720,69,126,195,88,35,30,68,147,493
180,John Long\longjo01,SG,25,DET,69,66,2211,637,1294,.492,2,15,.133,635,1279,.496,.493,238,275,.865,95,162,257,148,65,25,167,173,1514
181,John Lucas\lucasjo01,PG,28,WSB,79,53,1940,263,618,.426,2,22,.091,261,596,.438,.427,138,176,.784,40,126,166,551,95,6,156,105,666
182,Maurice Lucas\lucasma01,PF,29,NYK,80,74,2671,505,1001,.504,0,3,.000,505,998,.506,.504,253,349,.725,274,629,903,179,68,70,173,309,1263
183,Ollie Mack\mackol01,SG,24,DAL,13,3,150,19,59,.322,0,2,.000,19,57,.333,.322,6,8,.750,8,10,18,14,5,1,4,6,44
184,Rudy Macklin\macklru01,SF,23,ATL,79,32,1516,210,484,.434,0,3,.000,210,481,.437,.434,134,173,.775,113,150,263,47,40,20,112,225,554
185,Kyle Macy\macyky01,PG,24,PHO,82,72,2845,486,945,.514,39,100,.390,447,845,.529,.535,152,169,.899,78,183,261,384,143,9,125,185,1163
186,Rick Mahorn\mahorri01,PF,23,WSB,80,80,2664,414,816,.507,0,3,.000,414,813,.509,.507,148,234,.632,149,555,704,150,57,138,162,349,976
187,Moses Malone*\malonmo01,C,26,HOU,81,81,3398,945,1822,.519,0,6,.000,945,1816,.520,.519,630,827,.762,558,630,1188,142,76,125,294,208,2520
188,Wes Matthews\matthwe01,PG,22,ATL,47,5,837,131,298,.440,2,8,.250,129,290,.445,.443,60,79,.759,19,39,58,139,53,2,63,129,324
189,Cedric Maxwell\maxwece01,SF,26,BOS,78,73,2590,397,724,.548,0,3,.000,397,721,.551,.548,357,478,.747,218,281,499,183,79,49,174,263,1151
190,Scott May\maysc01,SF,27,MIL,65,7,1187,212,417,.508,0,4,.000,212,413,.513,.508,159,193,.824,85,133,218,133,50,6,92,151,583
191,Bob McAdoo*\mcadobo01,C,30,LAL,41,0,746,151,330,.458,0,5,.000,151,325,.465,.458,90,126,.714,45,114,159,32,22,36,51,109,392
192,John McCullough\mcculjo01,SG,25,PHO,8,0,23,9,13,.692,0,0,,9,13,.692,.692,3,5,.600,1,3,4,3,2,0,3,3,21
193,Hank McDowell\mcdowha01,PF,22,GSW,30,1,335,34,84,.405,0,0,,34,84,.405,.405,27,41,.659,41,59,100,20,6,8,21,52,95
194,Jim McElroy\mcelrji01,PG,28,ATL,20,17,349,52,125,.416,1,5,.200,51,120,.425,.420,29,36,.806,6,11,17,39,8,3,22,44,134
195,Mike McGee\mcgeemi01,SF,22,LAL,39,0,352,80,172,.465,0,4,.000,80,168,.476,.465,31,53,.585,34,15,49,16,18,3,34,59,191
196,George McGinnis*\mcginge01,PF,31,IND,76,4,1341,141,378,.373,0,3,.000,141,375,.376,.373,72,159,.453,93,305,398,204,96,28,131,198,354
197,Kevin McHale*\mchalke01,PF,24,BOS,82,33,2332,465,875,.531,0,0,,465,875,.531,.531,187,248,.754,191,365,556,91,30,185,137,264,1117
198,Kevin McKenna\mckenke01,SG,23,LAL,36,0,237,28,87,.322,0,2,.000,28,85,.329,.322,11,17,.647,18,11,29,14,10,2,20,45,67
199,Billy McKinney\mckinbi01,PG,26,DEN,81,27,1963,369,699,.528,0,17,.000,369,682,.541,.528,137,170,.806,29,113,142,338,69,16,115,186,875
200,Tom McMillen\mcmilto01,C,29,ATL,73,23,1792,291,572,.509,1,3,.333,290,569,.510,.510,140,170,.824,102,234,336,129,25,24,124,202,723
201,Joe Meriweather\meriwjo01,C,28,KCK,18,10,380,47,91,.516,0,0,,47,91,.516,.516,31,40,.775,25,63,88,17,13,21,25,68,125
202,Mike Mitchell\mitchmi01,SF,26,TOT,84,83,3063,753,1477,.510,0,7,.000,753,1470,.512,.510,220,302,.728,244,346,590,82,60,43,153,277,1726
202,Mike Mitchell\mitchmi01,SF,26,CLE,27,26,973,229,504,.454,0,6,.000,229,498,.460,.454,72,100,.720,71,70,141,39,27,15,55,77,530
202,Mike Mitchell\mitchmi01,SF,26,SAS,57,57,2090,524,973,.539,0,1,.000,524,972,.539,.539,148,202,.733,173,276,449,43,33,28,98,200,1196
203,Steve Mix\mixst01,SF,34,PHI,75,0,1235,202,399,.506,1,4,.250,201,395,.509,.508,136,172,.791,92,133,225,93,42,17,67,86,541
204,Paul Mokeski\mokespa01,C,25,TOT,67,4,868,84,193,.435,0,3,.000,84,190,.442,.435,48,63,.762,59,149,208,35,33,40,55,171,216
204,Paul Mokeski\mokespa01,C,25,DET,39,3,523,49,111,.441,0,1,.000,49,110,.445,.441,25,33,.758,35,87,122,24,13,23,39,103,123
204,Paul Mokeski\mokespa01,C,25,CLE,28,1,345,35,82,.427,0,2,.000,35,80,.438,.427,23,30,.767,24,62,86,11,20,17,16,68,93
205,Sidney Moncrief\moncrsi01,SG,24,MIL,80,80,2980,556,1063,.523,1,14,.071,555,1049,.529,.524,468,573,.817,221,313,534,382,138,22,208,206,1581
206,Johnny Moore\moorejo01,PG,23,SAS,79,78,2294,309,667,.463,1,21,.048,308,646,.477,.464,122,182,.670,62,213,275,762,163,12,175,254,741
207,Lowes Moore\moorelo01,PG,24,CLE,4,0,70,19,38,.500,1,5,.200,18,33,.545,.513,6,8,.750,1,3,4,15,6,1,5,15,45
208,Calvin Murphy*\murphca01,PG,33,HOU,64,0,1204,277,648,.427,1,16,.063,276,632,.437,.428,100,110,.909,20,41,61,163,43,1,82,142,655
209,Larry Nance\nancela01,PF,22,PHO,80,0,1186,227,436,.521,0,1,.000,227,435,.522,.521,75,117,.641,95,161,256,82,42,71,104,169,529
210,Swen Nater\natersw01,C,32,SDC,21,7,575,101,175,.577,1,1,1.000,100,174,.575,.580,59,79,.747,46,146,192,30,6,9,48,64,262
211,Calvin Natt\nattca01,SF,25,POR,75,71,2599,515,894,.576,2,8,.250,513,886,.579,.577,294,392,.750,193,420,613,150,62,36,140,175,1326
212,Mike Newlin\newlimi01,SG,33,NYK,76,32,1507,286,615,.465,7,23,.304,279,592,.471,.471,126,147,.857,36,55,91,170,33,3,104,194,705
213,Carl Nicks\nicksca01,SG,23,UTA,80,1,1322,252,555,.454,0,5,.000,252,550,.458,.454,85,150,.567,67,94,161,89,66,4,101,184,589
214,Kurt Nimphius\nimphku01,C,23,DAL,63,27,1085,137,297,.461,0,0,,137,297,.461,.461,63,108,.583,92,203,295,61,17,82,56,190,337
215,Norm Nixon\nixonno01,PG,26,LAL,82,82,3024,628,1274,.493,3,12,.250,625,1262,.495,.494,181,224,.808,38,138,176,652,132,7,238,264,1440
216,Mike O'Koren\okoremi01,SF,23,NJN,80,32,2018,383,778,.492,8,23,.348,375,755,.497,.497,135,189,.714,111,194,305,192,83,13,147,175,909
217,Mark Olberding\olberma01,PF,25,SAS,68,63,2098,333,705,.472,2,12,.167,331,693,.478,.474,273,338,.808,118,321,439,202,57,29,139,253,941
218,Jawann Oldham\oldhaja01,C,24,HOU,22,0,124,13,36,.361,0,0,,13,36,.361,.361,8,14,.571,7,17,24,3,2,10,6,28,34
219,Louis Orr\orrlo01,SF,23,IND,80,41,1951,357,719,.497,1,8,.125,356,711,.501,.497,203,254,.799,127,204,331,134,56,26,137,182,918
220,Tom Owens\owensto01,PF,32,IND,74,40,1599,299,636,.470,1,2,.500,298,634,.470,.471,181,226,.801,142,230,372,127,41,37,137,259,780
221,Robert Parish*\parisro01,C,28,BOS,80,78,2534,669,1235,.542,0,0,,669,1235,.542,.542,252,355,.710,288,578,866,140,68,192,221,267,1590
222,Sonny Parker\parkeso01,SF,26,GSW,71,0,899,116,245,.473,0,0,,116,245,.473,.473,48,72,.667,73,104,177,89,39,11,51,101,280
223,Billy Paultz\paultbi01,C,33,HOU,65,3,807,89,226,.394,0,0,,89,226,.394,.394,34,65,.523,54,126,180,41,15,22,45,99,212
224,Jim Paxson\paxsoji02,SG,24,POR,82,82,2756,662,1258,.526,8,35,.229,654,1223,.535,.529,220,287,.767,75,146,221,276,129,12,144,159,1552
225,Sam Pellom\pellosa01,PF,30,ATL,69,4,1037,114,251,.454,0,1,.000,114,250,.456,.454,61,79,.772,90,139,229,28,29,47,57,164,289
226,Roger Phegley\pheglro01,SG,25,TOT,81,9,1183,233,507,.460,5,31,.161,228,476,.479,.464,85,109,.780,61,93,154,114,36,8,66,152,556
226,Roger Phegley\pheglro01,SG,25,CLE,27,8,566,104,214,.486,4,13,.308,100,201,.498,.495,36,45,.800,28,43,71,53,16,2,33,61,248
226,Roger Phegley\pheglro01,SG,25,SAS,54,1,617,129,293,.440,1,18,.056,128,275,.465,.442,49,64,.766,33,50,83,61,20,6,33,91,308
227,Ben Poquette\poquebe01,PF,26,UTA,82,56,1698,220,428,.514,3,10,.300,217,418,.519,.518,97,120,.808,117,294,411,94,51,65,69,235,540
228,Mark Radford\radfoma01,SG,22,SEA,43,0,369,54,100,.540,2,3,.667,52,97,.536,.550,35,69,.507,13,16,29,57,16,2,42,65,145
229,Ed Rains\rainsed01,SF,25,SAS,49,15,637,77,177,.435,0,2,.000,77,175,.440,.435,38,64,.594,37,43,80,40,18,2,25,74,192
230,Kurt Rambis\rambiku01,PF,23,LAL,64,43,1131,118,228,.518,0,1,.000,118,227,.520,.518,59,117,.504,116,232,348,56,60,76,77,167,295
231,Kelvin Ransey\ranseke01,PG,23,POR,78,68,2418,504,1095,.460,3,38,.079,501,1057,.474,.462,242,318,.761,39,147,186,555,97,4,229,169,1253
232,James Ray\rayja01,PF,24,DEN,40,4,262,51,116,.440,1,1,1.000,50,115,.435,.444,21,36,.583,18,47,65,26,10,16,37,59,124
233,Robert Reid\reidro01,SF,26,HOU,77,75,2913,437,958,.456,1,10,.100,436,948,.460,.457,160,214,.748,175,336,511,314,115,48,157,297,1035
234,Kevin Restani\restake01,PF,30,TOT,47,0,483,32,88,.364,0,2,.000,32,86,.372,.364,10,16,.625,39,73,112,22,11,11,20,56,74
234,Kevin Restani\restake01,PF,30,SAS,13,0,145,9,28,.321,0,1,.000,9,27,.333,.321,3,4,.750,8,27,35,7,1,4,6,16,21
234,Kevin Restani\restake01,PF,30,CLE,34,0,338,23,60,.383,0,1,.000,23,59,.390,.383,7,12,.583,31,46,77,15,10,7,14,40,53
235,Clint Richardson\richacl01,SG,25,PHI,77,0,1040,140,310,.452,2,2,1.000,138,308,.448,.455,69,88,.784,55,63,118,109,36,9,79,109,351
236,Micheal Ray Richardson\richami01,PG,26,NYK,82,79,3044,619,1343,.461,19,101,.188,600,1242,.483,.468,212,303,.700,177,388,565,572,213,41,291,317,1469
237,Rick Robey\robeyri01,C,26,BOS,80,4,1186,185,375,.493,0,2,.000,185,373,.496,.493,84,157,.535,114,181,295,68,27,14,92,183,454
238,Cliff Robinson\robincl01,PF,21,TOT,68,59,2175,518,1143,.453,0,4,.000,518,1139,.455,.453,222,313,.709,174,435,609,120,88,103,149,222,1258
238,Cliff Robinson\robincl01,PF,21,KCK,38,30,1229,322,708,.455,0,3,.000,322,705,.457,.455,125,180,.694,83,239,322,71,46,60,86,120,769
238,Cliff Robinson\robincl01,PF,21,CLE,30,29,946,196,435,.451,0,1,.000,196,434,.452,.451,97,133,.729,91,196,287,49,42,43,63,102,489
239,Jackie Robinson\robinja01,SF,26,CHI,3,0,29,3,9,.333,0,0,,3,9,.333,.333,4,4,1.000,3,0,3,0,0,0,1,1,10
240,Truck Robinson\robintr01,PF,30,PHO,74,72,2745,579,1128,.513,1,1,1.000,578,1127,.513,.514,255,371,.687,202,519,721,179,42,28,202,215,1414
241,Bill Robinzine\robinbi01,PF,29,UTA,56,9,651,131,294,.446,0,0,,131,294,.446,.446,61,75,.813,56,88,144,49,37,5,83,156,323
242,Dave Robisch\robisda01,C,32,DEN,12,0,257,48,106,.453,0,0,,48,106,.453,.453,48,55,.873,14,49,63,32,3,4,13,29,144
243,John Roche\rochejo01,SG,32,DEN,39,2,501,68,150,.453,23,52,.442,45,98,.459,.530,28,38,.737,4,19,23,89,15,2,29,40,187
244,Tree Rollins\rollitr01,C,26,ATL,79,39,2018,202,346,.584,0,0,,202,346,.584,.584,79,129,.612,168,443,611,59,35,224,79,285,483
245,Lorenzo Romar\romarlo01,PG,23,GSW,79,11,1259,203,403,.504,3,15,.200,200,388,.515,.507,79,96,.823,12,86,98,226,60,13,89,103,488
246,Dan Roundfield\roundda01,PF,28,ATL,61,58,2217,424,910,.466,1,5,.200,423,905,.467,.466,285,375,.760,227,494,721,162,64,93,183,210,1134
247,Jeff Ruland\rulanje01,C,23,WSB,82,0,2214,420,749,.561,1,3,.333,419,746,.562,.561,342,455,.752,253,509,762,134,44,58,237,319,1183
248,Campy Russell\russeca02,SF,30,NYK,77,63,2358,410,858,.478,25,57,.439,385,801,.481,.492,228,294,.776,86,150,236,284,77,12,195,221,1073
249,DeWayne Scales\scalede01,PF,23,NYK,3,0,24,1,5,.200,0,0,,1,5,.200,.200,1,2,.500,2,3,5,0,1,1,2,3,3
250,Danny Schayes\schayda01,C,22,UTA,82,20,1623,252,524,.481,0,1,.000,252,523,.482,.481,140,185,.757,131,296,427,146,46,72,151,292,644
251,Alvin Scott\scottal01,SF,26,PHO,81,38,1740,189,380,.497,0,2,.000,189,378,.500,.497,108,148,.730,97,197,294,149,59,70,98,169,486
252,Craig Shelton\sheltcr01,SF,24,ATL,4,0,21,2,6,.333,0,0,,2,6,.333,.333,1,2,.500,1,2,3,0,1,0,0,3,5
253,Lonnie Shelton\sheltlo01,PF,26,SEA,81,81,2667,508,1046,.486,0,8,.000,508,1038,.489,.486,188,240,.783,161,348,509,252,99,43,199,317,1204
254,Purvis Short\shortpu01,SF,24,GSW,76,8,1782,456,935,.488,6,28,.214,450,907,.496,.491,177,221,.801,123,143,266,209,65,10,122,220,1095
255,Jerry Sichting\sichtje01,PG,25,IND,51,0,800,91,194,.469,1,9,.111,90,185,.486,.472,29,38,.763,14,41,55,117,33,1,42,63,212
256,Jack Sikma\sikmaja01,C,26,SEA,82,82,3049,581,1212,.479,2,13,.154,579,1199,.483,.480,447,523,.855,223,815,1038,277,102,107,213,268,1611
257,James Silas\silasja01,SG,32,CLE,67,34,1447,251,573,.438,0,5,.000,251,568,.442,.438,246,286,.860,26,83,109,222,40,6,107,109,748
258,Jim Smith\smithji01,PF,23,SDC,72,3,858,86,169,.509,0,0,,86,169,.509,.509,39,85,.459,72,110,182,46,22,51,47,185,211
259,Larry Smith\smithla01,PF,24,GSW,74,55,2213,220,412,.534,0,1,.000,220,411,.535,.534,88,159,.553,279,534,813,83,65,54,105,291,528
260,Phil Smith\smithph01,SG,29,TOT,74,41,2042,340,761,.447,5,27,.185,335,734,.456,.450,163,223,.731,51,135,186,307,67,27,155,213,848
260,Phil Smith\smithph01,SG,29,SDC,48,39,1446,253,575,.440,5,24,.208,248,551,.450,.444,123,168,.732,34,83,117,233,45,19,116,151,634
260,Phil Smith\smithph01,SG,29,SEA,26,2,596,87,186,.468,0,3,.000,87,183,.475,.468,40,55,.727,17,52,69,74,22,8,39,62,214
261,Randy Smith\smithra01,SG,33,NYK,82,40,2033,348,748,.465,3,11,.273,345,737,.468,.467,122,151,.808,53,102,155,255,91,1,124,199,821
262,Robert Smith\smithro01,PG,26,MIL,17,1,316,52,110,.473,2,10,.200,50,100,.500,.482,10,12,.833,1,13,14,44,10,1,14,35,116
263,Ricky Sobers\soberri01,SG,29,CHI,80,6,1938,363,801,.453,19,76,.250,344,725,.474,.465,195,254,.768,37,105,142,301,73,18,217,238,940
264,Jim Spanarkel\spanaji01,SG,24,DAL,82,1,1755,270,564,.479,8,24,.333,262,540,.485,.486,279,327,.853,99,111,210,206,86,9,111,140,827
265,Rory Sparrow\sparrro01,PG,23,ATL,82,82,2610,366,730,.501,1,15,.067,365,715,.510,.502,124,148,.838,53,171,224,424,87,13,145,240,857
266,Larry Spriggs\sprigla01,SF,22,HOU,4,0,37,7,11,.636,0,0,,7,11,.636,.636,0,2,.000,2,4,6,4,2,0,4,7,14
267,Kevin Stacom\stacoke01,SG,30,MIL,7,0,90,14,34,.412,1,2,.500,13,32,.406,.426,1,2,.500,2,5,7,7,1,0,9,6,30
268,Brian Taylor\taylobr01,PG,30,SDC,41,40,1274,165,328,.503,23,63,.365,142,265,.536,.538,90,110,.818,26,70,96,229,47,9,82,113,443
269,Carlos Terry\terryca01,SG,25,WSB,13,0,60,3,15,.200,0,3,.000,3,12,.250,.200,3,4,.750,5,7,12,8,3,1,5,15,9
270,Reggie Theus\theusre01,SG,24,CHI,82,82,2838,560,1194,.469,25,100,.250,535,1094,.489,.479,363,449,.808,115,197,312,476,87,16,277,243,1508
271,Isiah Thomas*\thomais01,PG,20,DET,72,72,2433,453,1068,.424,17,59,.288,436,1009,.432,.432,302,429,.704,57,152,209,565,150,17,299,253,1225
272,David Thompson*\thompda01,SG,27,DEN,61,5,1246,313,644,.486,4,14,.286,309,630,.490,.489,276,339,.814,57,91,148,117,34,29,142,149,906
273,Mychal Thompson\thompmy01,C,27,POR,79,78,3129,681,1303,.523,0,0,,681,1303,.523,.523,280,446,.628,258,663,921,319,69,107,245,233,1642
274,Ray Tolbert\tolbera01,PF,23,TOT,64,0,607,100,202,.495,0,2,.000,100,200,.500,.495,19,35,.543,50,76,126,33,12,16,45,83,219
274,Ray Tolbert\tolbera01,PF,23,NJN,12,0,115,20,44,.455,0,1,.000,20,43,.465,.455,4,8,.500,11,16,27,8,4,2,12,19,44
274,Ray Tolbert\tolbera01,PF,23,SEA,52,0,492,80,158,.506,0,1,.000,80,157,.510,.506,15,27,.556,39,60,99,25,8,14,33,64,175
275,Andrew Toney\toneyan01,SG,24,PHI,77,1,1909,511,979,.522,25,59,.424,486,920,.528,.535,227,306,.742,43,91,134,283,64,17,214,269,1274
276,Raymond Townsend\townsra01,SG,26,IND,14,0,95,11,41,.268,2,9,.222,9,32,.281,.293,11,20,.550,2,11,13,10,3,0,6,18,35
277,Kelly Tripucka\tripuke01,SF,22,DET,82,82,3077,636,1281,.496,5,22,.227,631,1259,.501,.498,495,621,.797,219,224,443,270,89,16,280,241,1772
278,Elston Turner\turneel01,SF,22,DAL,80,62,1996,282,639,.441,0,4,.000,282,635,.444,.441,97,138,.703,143,158,301,189,75,2,116,182,661
279,Terry Tyler\tylerte01,PF,25,DET,82,0,1989,336,643,.523,1,4,.250,335,639,.524,.523,142,192,.740,154,339,493,126,77,160,121,182,815
280,Darnell Valentine\valenda01,PG,22,POR,82,14,1387,187,453,.413,0,9,.000,187,444,.421,.413,152,200,.760,48,101,149,270,94,3,127,187,526
281,Jan van Breda Kolff\vanbrja01,SF,30,NJN,41,0,452,41,82,.500,0,2,.000,41,80,.513,.500,62,76,.816,17,31,48,32,12,13,29,63,144
282,Kiki Vandeweghe\vandeki01,PF,23,DEN,82,78,2775,706,1260,.560,1,13,.077,705,1247,.565,.561,347,405,.857,149,312,461,247,52,29,189,217,1760
283,Pete Verhoeven\verhope01,PF,22,POR,71,22,1207,149,296,.503,0,0,,149,296,.503,.503,51,72,.708,106,148,254,52,42,22,55,215,349
284,Jay Vincent\vinceja01,PF,22,DAL,81,62,2626,719,1448,.497,1,4,.250,718,1444,.497,.497,293,409,.716,182,383,565,176,89,22,194,308,1732
285,Danny Vranes\vraneda01,SF,23,SEA,77,1,1075,143,262,.546,0,1,.000,143,261,.548,.546,89,148,.601,71,127,198,56,28,21,68,150,375
286,Foots Walker\walkefo01,PG,30,NJN,77,54,1861,156,378,.413,3,9,.333,153,369,.415,.417,141,194,.727,31,119,150,398,120,6,107,179,456
287,Wally Walker\walkewa01,SF,27,SEA,70,70,1965,302,629,.480,0,2,.000,302,627,.482,.480,90,134,.672,108,197,305,218,36,28,111,215,694
288,Kermit Washington\washike01,PF,30,POR,20,4,418,38,78,.487,0,0,,38,78,.487,.487,24,41,.585,40,77,117,29,9,16,19,56,100
289,Richard Washington\washiri01,PF,26,CLE,18,2,313,50,115,.435,0,2,.000,50,113,.442,.435,9,15,.600,32,43,75,15,8,2,35,51,109
290,Marvin Webster\webstma01,C,29,NYK,82,32,1883,199,405,.491,0,0,,199,405,.491,.491,108,170,.635,184,306,490,99,22,91,90,211,506
291,Scott Wedman\wedmasc01,SF,29,CLE,54,39,1638,260,589,.441,5,23,.217,255,566,.451,.446,66,90,.733,128,176,304,133,73,14,73,189,591
292,Paul Westphal\westppa01,SG,31,NYK,18,12,451,86,194,.443,2,8,.250,84,186,.452,.448,36,47,.766,9,13,22,100,19,8,47,61,210
293,Jerome Whitehead\whiteje01,C,25,SDC,72,63,2214,406,726,.559,0,0,,406,726,.559,.559,184,241,.763,231,433,664,102,48,44,141,290,996
294,Hawkeye Whitney\whitnha02,SG,24,KCK,23,4,266,25,71,.352,0,1,.000,25,70,.357,.352,4,7,.571,13,27,40,19,12,1,14,31,54
295,Michael Wiley\wileymi01,PF,24,SDC,61,1,1013,203,359,.565,0,5,.000,203,354,.573,.565,98,141,.695,67,115,182,52,40,16,71,127,504
296,Bob Wilkerson\wilkebo01,SF,27,CLE,65,38,1805,284,679,.418,3,18,.167,281,661,.425,.420,145,185,.784,60,190,250,237,92,25,138,188,716
297,Jamaal Wilkes*\wilkeja01,SF,28,LAL,82,82,2906,744,1417,.525,0,4,.000,744,1413,.527,.525,246,336,.732,153,240,393,143,89,24,164,240,1734
298,James Wilkes\wilkeja02,SF,23,CHI,57,22,862,128,266,.481,0,1,.000,128,265,.483,.481,58,80,.725,62,97,159,64,30,18,62,112,314
299,Jeff Wilkins\wilkije01,C,26,UTA,82,62,2274,314,718,.437,0,3,.000,314,715,.439,.437,137,176,.778,120,491,611,90,32,77,134,248,765
300,Buck Williams\willibu01,PF,21,NJN,82,82,2825,513,881,.582,0,1,.000,513,880,.583,.582,242,388,.624,347,658,1005,107,84,84,235,285,1268
301,Freeman Williams\willifr01,SG,25,TOT,60,10,997,276,623,.443,28,94,.298,248,529,.469,.465,140,166,.843,23,39,62,86,29,0,107,103,720
301,Freeman Williams\willifr01,SG,25,SDC,37,10,808,234,513,.456,24,74,.324,210,439,.478,.480,118,140,.843,21,29,50,67,23,0,89,85,610
301,Freeman Williams\willifr01,SG,25,ATL,23,0,189,42,110,.382,4,20,.200,38,90,.422,.400,22,26,.846,2,10,12,19,6,0,18,18,110
302,Gus Williams\willigu01,PG,28,SEA,80,80,2876,773,1592,.486,9,40,.225,764,1552,.492,.488,320,436,.734,92,152,244,549,172,36,197,163,1875
303,Herb Williams\willihe01,C,23,IND,82,75,2277,407,854,.477,2,7,.286,405,847,.478,.478,126,188,.670,175,430,605,139,53,178,137,200,942
304,Ray Williams\willira01,SG,27,NJN,82,69,2732,639,1383,.462,9,54,.167,630,1329,.474,.465,387,465,.832,117,208,325,488,199,43,290,302,1674
305,Sam Williams\willisa02,PF,22,GSW,59,22,1073,154,277,.556,0,0,,154,277,.556,.556,49,89,.551,91,217,308,38,45,76,64,156,357
306,Sly Williams\willisl01,SF,24,NYK,60,27,1521,349,628,.556,2,9,.222,347,619,.561,.557,131,173,.757,100,127,227,142,77,16,114,153,831
307,Bill Willoughby\willobi01,SF,24,HOU,69,42,1475,240,464,.517,3,7,.429,237,457,.519,.520,56,77,.727,107,157,264,75,31,59,78,146,539
308,Brian Winters\wintebr01,SG,29,MIL,61,13,1829,404,806,.501,36,93,.387,368,713,.516,.524,123,156,.788,51,119,170,253,57,9,118,187,967
309,Garry Witts\wittsga01,SF,22,WSB,46,0,493,49,84,.583,1,2,.500,48,82,.585,.589,33,40,.825,29,33,62,38,17,4,35,74,132
310,Al Wood\woodal01,SG,23,TOT,48,5,930,179,381,.470,3,24,.125,176,357,.493,.474,93,119,.782,51,83,134,58,31,9,71,108,454
310,Al Wood\woodal01,SG,23,ATL,19,0,238,36,105,.343,0,6,.000,36,99,.364,.343,20,28,.714,22,22,44,11,9,1,11,34,92
310,Al Wood\woodal01,SG,23,SDC,29,5,692,143,276,.518,3,18,.167,140,258,.543,.524,73,91,.802,29,61,90,47,22,8,60,74,362
311,Howard Wood\woodho01,SF,22,UTA,42,3,342,55,120,.458,0,1,.000,55,119,.462,.458,34,52,.654,22,43,65,9,8,6,15,37,144
312,Mike Woodson\woodsmi01,SG,23,TOT,83,74,2331,538,1069,.503,7,25,.280,531,1044,.509,.507,221,286,.773,102,145,247,222,142,35,153,220,1304
312,Mike Woodson\woodsmi01,SG,23,NJN,7,0,145,30,68,.441,0,1,.000,30,67,.448,.441,23,32,.719,5,8,13,16,7,2,9,21,83
312,Mike Woodson\woodsmi01,SG,23,KCK,76,74,2186,508,1001,.507,7,24,.292,501,977,.513,.511,198,254,.780,97,137,234,206,135,33,144,199,1221
313,Orlando Woolridge\woolror01,SF,22,CHI,75,12,1188,202,394,.513,0,3,.000,202,391,.517,.513,144,206,.699,82,145,227,81,23,24,107,152,548
314,Sam Worthen\worthsa01,PG,24,UTA,5,0,22,2,5,.400,0,0,,2,5,.400,.400,0,0,,1,0,1,3,0,0,2,3,4
315,Larry Wright\wrighla01,PG,27,DET,1,0,6,0,1,.000,0,0,,0,1,.000,.000,0,0,,0,0,0,0,0,0,1,2,0
316,Rich Yonakor\yonakri01,PF,23,SAS,10,0,70,14,26,.538,0,0,,14,26,.538,.538,5,7,.714,13,14,27,3,1,2,2,7,33