
Rk,Player,Pos,Age,Tm,G,GS,MP,FG,FGA,FG%,3P,3PA,3P%,2P,2PA,2P%,eFG%,FT,FTA,FT%,ORB,DRB,TRB,AST,STL,BLK,TOV,PF,PTS
1,Kareem Abdul-Jabbar*\abdulka01,C,35,LAL,79,79,2554,722,1228,.588,0,2,.000,722,1226,.589,.588,278,371,.749,167,425,592,200,61,170,200,220,1722
2,Alvan Adams\adamsal01,C,28,PHO,80,75,2447,477,981,.486,1,3,.333,476,978,.487,.487,180,217,.829,161,387,548,376,114,74,242,287,1135
3,Mark Aguirre\aguirma01,SF,23,DAL,81,75,2784,767,1589,.483,16,76,.211,751,1513,.496,.488,429,589,.728,191,317,508,332,80,26,261,247,1979
4,Danny Ainge\aingeda01,SG,23,BOS,80,76,2048,357,720,.496,5,29,.172,352,691,.509,.499,72,97,.742,83,131,214,251,109,6,98,259,791
5,Dwight Anderson\anderdw01,PG,22,DEN,5,0,33,7,14,.500,0,0,,7,14,.500,.500,7,10,.700,0,2,2,3,1,0,5,7,21
6,J.J. Anderson\anderjj01,SF,22,TOT,65,2,1202,190,379,.501,0,4,.000,190,375,.507,.501,100,175,.571,119,175,294,67,63,21,79,153,480
6,J.J. Anderson\anderjj01,SF,22,PHI,13,0,48,8,22,.364,0,1,.000,8,21,.381,.364,1,3,.333,4,8,12,1,1,0,5,6,17
6,J.J. Anderson\anderjj01,SF,22,UTA,52,2,1154,182,357,.510,0,3,.000,182,354,.514,.510,99,172,.576,115,167,282,66,62,21,74,147,463
7,Richard Anderson\anderri01,C,22,SDC,78,5,1274,174,431,.404,7,19,.368,167,412,.405,.412,48,69,.696,111,161,272,120,57,26,93,170,403
8,Tiny Archibald*\architi01,PG,34,BOS,66,19,1811,235,553,.425,5,24,.208,230,529,.435,.429,220,296,.743,25,66,91,409,38,4,163,110,695
9,John Bagley\baglejo01,PG,22,CLE,68,3,990,161,373,.432,0,14,.000,161,359,.448,.432,64,84,.762,17,79,96,167,54,5,118,74,386
10,James Bailey\baileja01,PF,25,TOT,75,39,1765,385,774,.497,0,1,.000,385,773,.498,.497,226,322,.702,171,303,474,67,43,60,196,271,996
10,James Bailey\baileja01,PF,25,NJN,6,0,50,9,18,.500,0,0,,9,18,.500,.500,2,2,1.000,3,3,6,2,1,1,6,15,20
10,James Bailey\baileja01,PF,25,HOU,69,39,1715,376,756,.497,0,1,.000,376,755,.498,.497,224,320,.700,168,300,468,65,42,59,190,256,976
11,Greg Ballard\ballagr01,SF,28,WSB,78,78,2840,603,1274,.473,13,37,.351,590,1237,.477,.478,182,233,.781,123,385,508,262,135,25,157,176,1401
12,Gene Banks\banksge01,PF,23,SAS,81,81,2722,505,919,.550,0,5,.000,505,914,.553,.550,196,278,.705,222,390,612,279,78,21,171,229,1206
13,Billy Ray Bates\batesbi01,SG,26,TOT,19,3,304,55,145,.379,2,5,.400,53,140,.379,.386,11,22,.500,11,8,19,14,14,3,12,19,123
13,Billy Ray Bates\batesbi01,SG,26,WSB,15,3,277,53,129,.411,2,5,.400,51,124,.411,.419,10,20,.500,10,8,18,14,13,3,12,18,118
13,Billy Ray Bates\batesbi01,SG,26,LAL,4,0,27,2,16,.125,0,0,,2,16,.125,.125,1,2,.500,1,0,1,0,1,0,0,1,5
14,Dave Batton\battoda01,C,26,WSB,54,5,558,85,191,.445,0,3,.000,85,188,.452,.445,8,17,.471,45,74,119,29,15,13,28,56,178
15,Kent Benson\bensoke01,C,28,DET,21,15,599,85,182,.467,0,1,.000,85,181,.470,.467,38,50,.760,53,102,155,49,14,17,35,61,208
16,Larry Bird*\birdla01,PF,26,BOS,79,79,2982,747,1481,.504,22,77,.286,725,1404,.516,.512,351,418,.840,193,677,870,458,148,71,240,197,1867
17,Otis Birdsong\birdsot01,SG,27,NJN,62,54,1885,426,834,.511,2,6,.333,424,828,.512,.512,82,145,.566,53,97,150,239,85,16,114,155,936
18,Rolando Blackman\blackro01,SG,23,DAL,75,62,2349,513,1042,.492,3,15,.200,510,1027,.497,.494,297,381,.780,108,185,293,185,37,29,118,116,1326
19,Charles Bradley\bradlch01,SG,23,BOS,51,5,532,69,176,.392,0,3,.000,69,173,.399,.392,46,90,.511,30,48,78,28,32,27,42,84,184
20,Dudley Bradley\bradldu01,SG,25,CHI,58,11,683,82,159,.516,1,5,.200,81,154,.526,.519,36,45,.800,27,78,105,106,49,10,59,91,201
21,Brad Branson\bransbr01,PF,24,IND,62,2,680,131,308,.425,0,1,.000,131,307,.427,.425,76,108,.704,73,100,173,46,27,26,45,81,338
22,Mike Bratz\bratzmi01,PG,27,CHI,15,0,140,14,42,.333,1,8,.125,13,34,.382,.345,10,13,.769,3,16,19,23,7,0,14,20,39
23,Ron Brewer\brewero01,SG,27,TOT,74,52,1964,344,807,.426,7,18,.389,337,789,.427,.431,142,170,.835,59,85,144,96,90,25,97,123,837
23,Ron Brewer\brewero01,SG,27,CLE,21,18,563,98,245,.400,0,3,.000,98,242,.405,.400,44,51,.863,9,28,37,27,20,6,25,27,240
23,Ron Brewer\brewero01,SG,27,GSW,53,34,1401,246,562,.438,7,15,.467,239,547,.437,.444,98,119,.824,50,57,107,69,70,19,72,96,597
24,Junior Bridgeman\bridgju01,SF,29,MIL,70,5,1855,421,856,.492,1,13,.077,420,843,.498,.492,164,196,.837,44,202,246,207,40,9,122,155,1007
25,Allan Bristow\bristal01,SF,31,DAL,37,0,371,44,99,.444,6,13,.462,38,86,.442,.475,10,14,.714,24,35,59,70,6,1,31,46,104
26,Jim Brogan\brogaji01,SG,24,SDC,58,0,466,91,213,.427,3,13,.231,88,200,.440,.434,34,43,.791,33,29,62,66,26,9,43,79,219
27,Michael Brooks\brookmi01,SF,24,SDC,82,26,2457,402,830,.484,5,15,.333,397,815,.487,.487,193,277,.697,239,282,521,262,112,39,177,297,1002
28,Fred Brown\brownfr01,PG,34,SEA,80,1,1432,371,714,.520,14,32,.438,357,682,.523,.529,58,72,.806,32,65,97,242,59,13,110,98,814
29,Rickey Brown\brownri01,C,24,TOT,76,7,1048,167,349,.479,0,3,.000,167,346,.483,.479,65,105,.619,91,175,266,25,13,26,82,172,399
29,Rickey Brown\brownri01,C,24,GSW,50,7,743,118,245,.482,0,2,.000,118,243,.486,.482,40,65,.615,56,122,178,16,8,21,60,126,276
29,Rickey Brown\brownri01,C,24,ATL,26,0,305,49,104,.471,0,1,.000,49,103,.476,.471,25,40,.625,35,53,88,9,5,5,22,46,123
30,Joe Bryant\bryanjo01,SF,28,HOU,81,56,2055,344,768,.448,8,36,.222,336,732,.459,.453,116,165,.703,88,189,277,186,82,30,177,258,812
31,Quinn Buckner\bucknqu01,SG,28,BOS,72,56,1565,248,561,.442,0,4,.000,248,557,.445,.442,74,117,.632,62,125,187,275,108,5,159,195,570
32,Don Buse\busedo01,PG,32,POR,41,1,643,72,182,.396,9,35,.257,63,147,.429,.420,41,46,.891,19,35,54,115,44,2,25,60,194
33,Marty Byrnes\byrnema01,SF,26,IND,80,12,1436,157,374,.420,6,26,.231,151,348,.434,.428,71,95,.747,75,116,191,179,41,6,73,149,391
34,Kenny Carr\carrke01,PF,27,POR,82,26,2331,362,717,.505,2,6,.333,360,711,.506,.506,255,366,.697,182,407,589,116,62,42,185,306,981
35,M.L. Carr\carrml01,SF,32,BOS,77,0,883,135,315,.429,3,19,.158,132,296,.446,.433,60,81,.741,51,86,137,71,48,10,79,140,333
36,Joe Barry Carroll\carrojo01,C,24,GSW,79,79,2988,785,1529,.513,0,3,.000,785,1526,.514,.513,337,469,.719,220,468,688,169,108,155,285,260,1907
37,Butch Carter\cartebu01,SG,24,IND,81,28,1716,354,706,.501,17,51,.333,337,655,.515,.513,124,154,.805,62,88,150,194,78,13,118,207,849
38,Bill Cartwright\cartwbi01,C,25,NYK,82,82,2468,455,804,.566,0,0,,455,804,.566,.566,380,511,.744,185,405,590,136,41,127,204,315,1290
39,Harvey Catchings\catchha01,C,31,MIL,74,33,1554,90,197,.457,0,0,,90,197,.457,.457,62,92,.674,132,276,408,77,26,148,83,224,242
40,Tom Chambers\chambto01,PF,23,SDC,79,79,2665,519,1099,.472,0,8,.000,519,1091,.476,.472,353,488,.723,218,301,519,192,79,57,234,333,1391
41,Maurice Cheeks*\cheekma01,PG,26,PHI,79,79,2465,404,745,.542,1,6,.167,403,739,.545,.543,181,240,.754,53,156,209,543,184,31,179,182,990
42,Don Collins\collido02,SF,24,WSB,65,21,1575,332,635,.523,0,6,.000,332,629,.528,.523,101,136,.743,116,94,210,132,87,30,146,166,765
43,Lester Conner\connele01,PG,23,GSW,75,10,1416,145,303,.479,0,4,.000,145,299,.485,.479,79,113,.699,69,152,221,253,116,7,99,141,369
44,Darwin Cook\cookda01,PG,24,NJN,82,47,2625,443,986,.449,8,38,.211,435,948,.459,.453,186,242,.769,73,167,240,448,194,48,238,213,1080
45,Jeff Cook\cookje01,PF,26,TOT,75,22,1333,148,304,.487,0,3,.000,148,301,.492,.487,79,104,.760,119,216,335,102,39,31,105,181,375
45,Jeff Cook\cookje01,PF,26,PHO,45,2,551,61,142,.430,0,2,.000,61,140,.436,.430,41,54,.759,44,85,129,58,12,13,56,89,163
45,Jeff Cook\cookje01,PF,26,CLE,30,20,782,87,162,.537,0,1,.000,87,161,.540,.537,38,50,.760,75,131,206,44,27,18,49,92,212
46,Joe Cooper\coopejo01,C,25,TOT,20,4,333,37,72,.514,0,0,,37,72,.514,.514,16,29,.552,42,44,86,17,9,20,32,49,90
46,Joe Cooper\coopejo01,C,25,LAL,2,0,11,1,4,.250,0,0,,1,4,.250,.250,0,0,,2,0,2,0,1,1,3,3,2
46,Joe Cooper\coopejo01,C,25,WSB,5,0,47,5,9,.556,0,0,,5,9,.556,.556,5,9,.556,4,9,13,2,0,0,6,7,15
46,Joe Cooper\coopejo01,C,25,SDC,13,4,275,31,59,.525,0,0,,31,59,.525,.525,11,20,.550,36,35,71,15,8,19,23,39,73
47,Michael Cooper\coopemi01,SG,26,LAL,82,3,2148,266,497,.535,5,21,.238,261,476,.548,.540,102,130,.785,82,192,274,315,115,50,128,208,639
48,Wayne Cooper\coopewa01,C,26,POR,80,60,2099,320,723,.443,0,5,.000,320,718,.446,.443,135,197,.685,214,397,611,116,27,136,162,318,775
49,Dave Corzine\corzida01,C,26,CHI,82,71,2496,457,920,.497,0,2,.000,457,918,.498,.497,232,322,.720,243,474,717,154,47,109,228,242,1146
50,Dave Cowens*\cowenda01,PF,34,MIL,40,34,1014,136,306,.444,0,2,.000,136,304,.447,.444,52,63,.825,73,201,274,82,30,15,44,137,324
51,Chubby Cox\coxch01,SG,27,WSB,7,0,78,13,37,.351,0,2,.000,13,35,.371,.351,3,6,.500,7,3,10,6,0,1,9,16,29
52,Charlie Criss\crissch01,PG,34,MIL,66,0,922,169,375,.451,6,31,.194,163,344,.474,.459,68,76,.895,14,65,79,127,27,0,44,44,412
53,Geoff Crompton\crompge01,C,27,SAS,14,0,148,14,34,.412,0,0,,14,34,.412,.412,3,5,.600,18,30,48,7,3,5,5,25,31
54,Pat Cummings\cummipa01,C,26,DAL,81,71,2317,433,878,.493,0,1,.000,433,877,.494,.493,148,196,.755,225,443,668,144,57,35,162,296,1014
55,Terry Cummings\cummite01,PF,21,SDC,70,69,2531,684,1309,.523,0,1,.000,684,1308,.523,.523,292,412,.709,303,441,744,177,129,62,204,294,1660
56,Earl Cureton\curetea01,C,25,PHI,73,3,987,108,258,.419,0,0,,108,258,.419,.419,33,67,.493,84,185,269,43,37,24,76,144,249
57,Quintin Dailey\dailequ01,SG,22,CHI,76,32,2081,470,1008,.466,5,25,.200,465,983,.473,.469,206,282,.730,87,173,260,280,72,10,205,248,1151
58,Adrian Dantley*\dantlad01,SF,26,UTA,22,22,887,233,402,.580,0,0,,233,402,.580,.580,210,248,.847,58,82,140,105,20,0,81,62,676
59,Brad Davis\davisbr01,PG,27,DAL,79,78,2323,359,628,.572,11,43,.256,348,585,.595,.580,186,220,.845,34,164,198,565,80,11,143,176,915
60,Charles Davis\davisch02,SF,24,WSB,74,10,1161,251,534,.470,2,10,.200,249,524,.475,.472,56,89,.629,83,130,213,73,32,22,91,122,560
61,Johnny Davis\davisjo01,SG,27,ATL,53,33,1465,258,567,.455,5,18,.278,253,549,.461,.459,164,206,.796,37,91,128,315,43,7,114,100,685
62,Mike Davis\davismi03,PF,26,NYK,8,0,28,4,10,.400,0,0,,4,10,.400,.400,6,10,.600,3,7,10,0,0,4,0,4,14
63,Walter Davis\daviswa03,SG,28,PHO,80,79,2491,665,1289,.516,7,23,.304,658,1266,.520,.519,184,225,.818,63,134,197,397,117,12,188,186,1521
64,Darryl Dawkins\dawkida01,C,26,NJN,81,81,2093,401,669,.599,0,0,,401,669,.599,.599,166,257,.646,127,293,420,114,67,152,281,379,968
65,Kenny Dennard\dennake01,PF,24,KCK,22,0,224,11,34,.324,0,0,,11,34,.324,.324,6,9,.667,20,32,52,6,16,1,5,27,28
66,Coby Dietrick\dietrco01,C,34,SAS,8,0,34,1,5,.200,0,0,,1,5,.200,.200,0,2,.000,2,6,8,6,1,0,1,6,2
67,James Donaldson\donalja01,C,25,SEA,82,11,1789,289,496,.583,0,0,,289,496,.583,.583,150,218,.688,131,370,501,97,19,101,132,171,728
68,John Douglas\dougljo01,SG,26,SDC,3,1,12,1,6,.167,1,2,.500,0,4,.000,.250,2,2,1.000,0,1,1,1,0,0,0,0,5
69,Leon Douglas\douglle01,C,28,KCK,5,0,46,2,3,.667,0,0,,2,3,.667,.667,0,2,.000,3,4,7,0,0,3,1,13,4
70,John Drew\drewjo01,SF,28,UTA,44,33,1206,318,671,.474,0,5,.000,318,666,.477,.474,296,392,.755,98,137,235,97,35,7,135,152,932
71,Larry Drew\drewla01,PG,24,KCK,75,74,2690,599,1218,.492,2,16,.125,597,1202,.497,.493,310,378,.820,44,163,207,610,126,10,272,207,1510
72,Terry Duerod\duerote01,SG,26,GSW,5,0,49,9,19,.474,0,0,,9,19,.474,.474,0,0,,0,3,3,5,2,1,9,5,18
73,Mike Dunleavy\dunlemi01,PG,28,SAS,79,9,1619,213,510,.418,67,194,.345,146,316,.462,.483,120,154,.779,18,116,134,437,74,4,160,210,613
74,T.R. Dunn\dunntr01,SG,27,DEN,82,80,2640,254,527,.482,0,1,.000,254,526,.483,.482,119,163,.730,231,384,615,189,147,25,113,218,627
75,John Duren\durenjo01,PG,24,IND,82,24,1433,163,360,.453,0,13,.000,163,347,.470,.453,43,54,.796,38,69,107,200,66,5,96,203,369
76,Mark Eaton\eatonma01,C,26,UTA,81,32,1528,146,353,.414,0,1,.000,146,352,.415,.414,59,90,.656,86,376,462,112,24,275,140,257,351
77,Jerry Eaves\eavesje01,PG,23,UTA,82,7,1588,280,575,.487,1,8,.125,279,567,.492,.488,200,247,.810,34,88,122,210,51,3,152,116,761
78,Keith Edmonson\edmonke01,SG,22,ATL,32,2,309,48,139,.345,0,2,.000,48,137,.350,.345,16,27,.593,20,19,39,22,11,6,20,41,112
79,Franklin Edwards\edwarfr01,PG,23,PHI,81,3,1266,228,483,.472,0,8,.000,228,475,.480,.472,86,113,.761,23,62,85,221,81,6,110,119,542
80,James Edwards\edwarja01,C,27,TOT,31,9,667,128,263,.487,0,0,,128,263,.487,.487,69,108,.639,56,99,155,40,12,19,49,110,325
80,James Edwards\edwarja01,C,27,CLE,15,8,382,73,150,.487,0,0,,73,150,.487,.487,38,61,.623,37,59,96,13,7,14,30,61,184
80,James Edwards\edwarja01,C,27,PHO,16,1,285,55,113,.487,0,0,,55,113,.487,.487,31,47,.660,19,40,59,27,5,5,19,49,141
81,Len Elmore\elmorle01,C,30,NJN,74,0,975,97,244,.398,0,1,.000,97,243,.399,.398,54,84,.643,81,157,238,39,44,38,83,125,248
82,Chris Engler\englech01,C,23,GSW,54,1,369,38,94,.404,0,0,,38,94,.404,.404,5,16,.313,43,61,104,11,7,17,24,95,81
83,Alex English*\englial01,SF,29,DEN,82,82,2988,959,1857,.516,2,12,.167,957,1845,.519,.517,406,490,.829,263,338,601,397,116,126,263,235,2326
84,Julius Erving*\ervinju01,SF,32,PHI,72,72,2421,605,1170,.517,2,7,.286,603,1163,.518,.518,330,435,.759,173,318,491,263,112,131,196,202,1542
85,Mike Evans\evansmi01,SG,27,DEN,42,5,695,115,243,.473,0,9,.000,115,234,.491,.473,33,41,.805,4,54,58,113,23,3,71,94,263
86,Bruce Flowers\flowebr01,PF,25,CLE,53,5,699,110,206,.534,0,2,.000,110,204,.539,.534,41,53,.774,71,109,180,47,19,12,43,99,261
87,Sleepy Floyd\floydsl01,PG,22,TOT,76,17,1248,226,527,.429,10,25,.400,216,502,.430,.438,150,180,.833,56,81,137,138,58,17,106,134,612
87,Sleepy Floyd\floydsl01,PG,22,NJN,43,6,494,92,216,.426,4,14,.286,88,202,.436,.435,38,45,.844,16,26,42,67,19,9,40,56,226
87,Sleepy Floyd\floydsl01,PG,22,GSW,33,11,754,134,311,.431,6,11,.545,128,300,.427,.441,112,135,.830,40,55,95,71,39,8,66,78,386
88,Phil Ford\fordph01,PG,26,TOT,77,63,1610,213,445,.479,1,9,.111,212,436,.486,.480,97,123,.789,18,85,103,290,52,3,134,190,524
88,Phil Ford\fordph01,PG,26,NJN,7,7,163,20,35,.571,0,1,.000,20,34,.588,.571,7,10,.700,0,7,7,38,6,0,21,22,47
88,Phil Ford\fordph01,PG,26,MIL,70,56,1447,193,410,.471,1,8,.125,192,402,.478,.472,90,113,.796,18,78,96,252,46,3,113,168,477
89,World B. Free\freewo01,SG,29,TOT,73,69,2638,649,1423,.456,15,45,.333,634,1378,.460,.461,430,583,.738,92,109,201,290,97,15,209,241,1743
89,World B. Free\freewo01,SG,29,GSW,19,18,700,164,364,.451,0,3,.000,164,361,.454,.451,106,149,.711,22,22,44,89,15,3,50,66,434
89,World B. Free\freewo01,SG,29,CLE,54,51,1938,485,1059,.458,15,42,.357,470,1017,.462,.465,324,434,.747,70,87,157,201,82,12,159,175,1309
90,Bill Garnett\garnebi02,C,22,DAL,75,13,1411,170,319,.533,0,3,.000,170,316,.538,.533,129,174,.741,141,265,406,103,48,70,81,245,469
91,Calvin Garrett\garreca01,SF,26,HOU,4,0,34,4,11,.364,0,1,.000,4,10,.400,.364,2,2,1.000,3,4,7,3,0,0,3,4,10
92,George Gervin*\gervige01,SG,30,SAS,78,78,2830,757,1553,.487,12,33,.364,745,1520,.490,.491,517,606,.853,111,246,357,264,88,67,247,243,2043
93,Artis Gilmore*\gilmoar01,C,33,SAS,82,82,2797,556,888,.626,0,6,.000,556,882,.630,.626,367,496,.740,299,685,984,126,40,192,254,273,1479
94,Mike Glenn\glennmi01,SG,27,ATL,73,4,1124,230,444,.518,0,1,.000,230,443,.519,.518,74,89,.831,16,74,90,125,30,9,52,132,534
95,Mike Gminski\gminsmi01,C,23,NJN,80,1,1255,213,426,.500,0,1,.000,213,425,.501,.500,175,225,.778,154,228,382,61,35,116,126,118,601
96,Glen Gondrezick\gondrgl01,PF,27,DEN,76,2,1130,134,294,.456,0,3,.000,134,291,.460,.456,82,114,.719,108,193,301,100,80,9,49,161,350
97,Rickey Green\greenri01,PG,28,UTA,78,78,2783,464,942,.493,2,13,.154,462,929,.497,.494,185,232,.797,62,161,223,697,220,4,222,154,1115
98,Dave Greenwood\greenda01,PF,25,CHI,79,61,2355,312,686,.455,0,4,.000,312,682,.457,.455,165,233,.708,217,548,765,151,54,90,154,261,789
99,John Greig\greigjo01,SF,21,SEA,9,0,26,7,13,.538,0,0,,7,13,.538,.538,5,6,.833,2,4,6,0,0,1,2,4,19
100,Kevin Grevey\greveke01,SF,29,WSB,41,11,756,114,294,.388,15,38,.395,99,256,.387,.413,54,69,.783,18,31,49,49,18,7,27,61,297
101,Paul Griffin\griffpa01,PF,29,SAS,53,0,956,60,116,.517,0,0,,60,116,.517,.517,53,76,.697,77,139,216,86,33,25,68,153,173
102,Darrell Griffith\griffda01,SG,24,UTA,77,76,2787,752,1554,.484,38,132,.288,714,1422,.502,.496,167,246,.679,100,204,304,270,138,33,252,184,1709
103,Bob Gross\grossbo01,SF,29,SDC,27,3,373,35,82,.427,1,3,.333,34,79,.430,.433,12,19,.632,32,34,66,34,22,7,24,69,83
104,Ernie Grunfeld\grunfer01,SF,27,NYK,77,0,1422,167,377,.443,0,4,.000,167,373,.448,.443,81,98,.827,42,121,163,136,40,10,84,172,415
105,Bill Hanzlik\hanzlbi01,SF,25,DEN,82,8,1547,187,437,.428,1,7,.143,186,430,.433,.429,125,160,.781,80,156,236,268,75,15,144,220,500
106,Joe Hassett\hassejo01,SG,27,GSW,6,2,139,19,44,.432,1,9,.111,18,35,.514,.443,0,0,,3,8,11,21,2,0,9,14,39
107,Scott Hastings\hastisc01,C-PF,22,TOT,31,0,140,13,38,.342,0,3,.000,13,35,.371,.342,11,20,.550,15,26,41,3,6,1,9,34,37
107,Scott Hastings\hastisc01,C,22,NYK,21,0,98,8,22,.364,0,1,.000,8,21,.381,.364,7,14,.500,10,21,31,1,5,0,6,31,23
107,Scott Hastings\hastisc01,PF,22,ATL,10,0,42,5,16,.313,0,2,.000,5,14,.357,.313,4,6,.667,5,5,10,2,1,1,3,3,14
108,Steve Hawes\hawesst01,PF,32,TOT,77,4,1416,163,390,.418,5,21,.238,158,369,.428,.424,69,94,.734,81,280,361,95,38,14,107,189,400
108,Steve Hawes\hawesst01,PF,32,ATL,46,3,860,91,244,.373,2,14,.143,89,230,.387,.377,46,62,.742,53,175,228,59,29,8,73,110,230
108,Steve Hawes\hawesst01,PF,32,SEA,31,1,556,72,146,.493,3,7,.429,69,139,.496,.503,23,32,.719,28,105,133,36,9,6,34,79,170
109,Elvin Hayes*\hayesel01,PF,37,HOU,81,43,2302,424,890,.476,2,4,.500,422,886,.476,.478,196,287,.683,199,417,616,158,50,81,200,232,1046
110,Steve Hayes\hayesst01,C,27,CLE,65,3,1058,104,217,.479,0,1,.000,104,216,.481,.479,29,51,.569,102,134,236,36,17,41,49,215,237
111,Spencer Haywood*\haywosp01,PF,33,WSB,38,25,775,125,312,.401,0,1,.000,125,311,.402,.401,63,87,.724,77,106,183,30,12,27,67,94,313
112,Gerald Henderson\hendege01,PG,27,BOS,82,9,1551,286,618,.463,3,16,.188,283,602,.470,.465,96,133,.722,57,67,124,195,95,3,128,190,671
113,Tom Henderson\hendeto01,SG,31,HOU,51,2,789,107,263,.407,0,2,.000,107,261,.410,.407,45,57,.789,18,51,69,138,37,2,50,57,259
114,Rod Higgins\higgiro01,SF,23,CHI,82,42,2196,313,698,.448,13,41,.317,300,657,.457,.458,209,264,.792,159,207,366,175,66,65,127,248,848
115,Johnny High\highjo01,SG,25,PHO,82,2,1155,100,217,.461,1,5,.200,99,212,.467,.463,63,136,.463,45,105,150,153,85,34,106,205,264
116,Armond Hill\hillar01,PG,29,MIL,14,3,169,14,26,.538,0,0,,14,26,.538,.538,18,22,.818,5,15,20,27,9,0,13,20,46
117,Craig Hodges\hodgecr01,SG,22,SDC,76,48,2022,318,704,.452,20,90,.222,298,614,.485,.466,94,130,.723,53,69,122,275,82,4,161,192,750
118,Lionel Hollins\hollili01,PG,29,SDC,56,54,1844,313,717,.437,3,21,.143,310,696,.445,.439,129,179,.721,30,98,128,373,111,14,198,155,758
119,Phil Hubbard\hubbaph01,SF,26,CLE,82,38,1953,288,597,.482,0,2,.000,288,595,.484,.482,204,296,.689,222,249,471,89,87,8,158,271,780
120,Geoff Huston\hustoge01,PG,25,CLE,80,79,2716,401,832,.482,4,12,.333,397,820,.484,.484,168,245,.686,41,118,159,487,74,4,195,215,974
121,Marc Iavaroni\iavarma01,PF,26,PHI,80,77,1612,163,353,.462,0,2,.000,163,351,.464,.462,78,113,.690,117,212,329,83,32,44,133,238,404
122,Dan Issel*\isselda01,C,34,DEN,80,80,2431,661,1296,.510,4,19,.211,657,1277,.514,.512,400,479,.835,151,445,596,223,83,43,174,227,1726
123,Tracy Jackson\jackstr01,SG,23,CHI,78,3,1309,199,426,.467,2,13,.154,197,413,.477,.469,92,126,.730,87,92,179,105,64,11,83,132,492
124,Clay Johnson\johnscl02,SG,26,LAL,48,0,447,53,135,.393,0,2,.000,53,133,.398,.393,38,48,.792,40,29,69,24,22,4,25,62,144
125,Clemon Johnson\johnscl01,C,26,TOT,83,11,1914,299,581,.515,0,1,.000,299,580,.516,.515,111,180,.617,190,334,524,139,67,92,124,221,709
125,Clemon Johnson\johnscl01,C,26,IND,51,7,1216,208,399,.521,0,1,.000,208,398,.523,.521,77,122,.631,115,204,319,115,51,63,88,137,493
125,Clemon Johnson\johnscl01,C,26,PHI,32,4,698,91,182,.500,0,0,,91,182,.500,.500,34,58,.586,75,130,205,24,16,29,36,84,216
126,Dennis Johnson*\johnsde01,PG,28,PHO,77,74,2551,398,861,.462,5,31,.161,393,830,.473,.465,292,369,.791,92,243,335,388,97,39,204,204,1093
127,Eddie Johnson\johnsed02,SG,27,ATL,61,57,1813,389,858,.453,14,41,.341,375,817,.459,.462,186,237,.785,26,98,124,318,61,6,156,138,978
128,Eddie Johnson\johnsed03,SF,23,KCK,82,82,2933,677,1370,.494,20,71,.282,657,1299,.506,.501,247,317,.779,191,310,501,216,70,20,181,259,1621
129,Frank Johnson\johnsfr01,PG,24,WSB,68,65,2324,321,786,.408,14,61,.230,307,725,.423,.417,196,261,.751,46,132,178,549,110,6,238,170,852
130,George Johnson\johnsge02,C,34,ATL,37,0,461,25,57,.439,0,0,,25,57,.439,.439,14,19,.737,44,73,117,17,10,59,19,69,64
131,George Johnson\johnsge03,SF,26,IND,82,64,2297,409,858,.477,7,38,.184,402,820,.490,.481,126,172,.733,176,369,545,220,77,53,242,279,951
132,Magic Johnson*\johnsma02,SG,23,LAL,79,79,2907,511,933,.548,0,21,.000,511,912,.560,.548,304,380,.800,214,469,683,829,176,47,301,200,1326
133,Marques Johnson\johnsma01,SF,26,MIL,80,80,2853,723,1420,.509,4,20,.200,719,1400,.514,.511,264,359,.735,196,366,562,363,100,56,196,211,1714
134,Mickey Johnson\johnsmi01,PF,30,TOT,78,16,2053,391,921,.425,3,36,.083,388,885,.438,.426,312,380,.821,163,331,494,255,82,46,238,288,1097
134,Mickey Johnson\johnsmi01,PF,30,MIL,6,0,153,30,66,.455,0,2,.000,30,64,.469,.455,7,9,.778,9,16,25,11,1,2,12,22,67
134,Mickey Johnson\johnsmi01,PF,30,NJN,42,7,1001,199,496,.401,2,17,.118,197,479,.411,.403,164,201,.816,66,158,224,144,56,21,121,135,564
134,Mickey Johnson\johnsmi01,PF,30,GSW,30,9,899,162,359,.451,1,17,.059,161,342,.471,.453,141,170,.829,88,157,245,100,25,23,105,131,466
135,Reggie Johnson\johnsre01,SF,25,TOT,79,8,1541,247,509,.485,1,4,.250,246,505,.487,.486,95,130,.731,107,184,291,71,26,43,104,232,590
135,Reggie Johnson\johnsre01,SF,25,KCK,50,0,992,178,355,.501,1,4,.250,177,351,.504,.503,73,100,.730,75,126,201,48,18,26,69,150,430
135,Reggie Johnson\johnsre01,SF,25,PHI,29,8,549,69,154,.448,0,0,,69,154,.448,.448,22,30,.733,32,58,90,23,8,17,35,82,160
136,Steve Johnson\johnsst03,C,25,KCK,79,21,1544,371,595,.624,0,0,,371,595,.624,.624,186,324,.574,140,258,398,95,40,83,180,323,928
137,Vinnie Johnson\johnsvi01,SG,26,DET,82,51,2511,520,1013,.513,11,40,.275,509,973,.523,.519,245,315,.778,167,186,353,301,93,49,152,263,1296
138,Jim Johnstone\johnsji01,PF-C,22,TOT,23,0,191,11,30,.367,0,0,,11,30,.367,.367,9,20,.450,15,31,46,11,3,7,15,33,31
138,Jim Johnstone\johnsji01,C,22,SAS,7,0,54,2,10,.200,0,0,,2,10,.200,.200,3,5,.600,4,12,16,1,1,1,4,9,7
138,Jim Johnstone\johnsji01,PF,22,DET,16,0,137,9,20,.450,0,0,,9,20,.450,.450,6,15,.400,11,19,30,10,2,6,11,24,24
139,Bobby Jones\jonesbo01,PF,31,PHI,74,0,1749,250,460,.543,0,1,.000,250,459,.545,.543,165,208,.793,102,242,344,142,85,91,109,199,665
140,Caldwell Jones\jonesca01,C,32,HOU,82,82,2440,307,677,.453,0,2,.000,307,675,.455,.453,162,206,.786,222,446,668,138,46,131,171,278,776
141,Dwight Jones\jonesdw01,PF,30,TOT,81,2,1164,148,325,.455,0,1,.000,148,324,.457,.455,79,123,.642,84,225,309,62,31,23,101,172,375
141,Dwight Jones\jonesdw01,PF,30,CHI,49,2,673,86,193,.446,0,0,,86,193,.446,.446,47,75,.627,56,139,195,40,18,14,66,90,219
141,Dwight Jones\jonesdw01,PF,30,LAL,32,0,491,62,132,.470,0,1,.000,62,131,.473,.470,32,48,.667,28,86,114,22,13,9,35,82,156
142,Edgar Jones\jonesed01,PF,26,TOT,77,28,1658,237,479,.495,2,9,.222,235,470,.500,.497,201,286,.703,136,312,448,89,42,108,146,267,677
142,Edgar Jones\jonesed01,PF,26,DET,49,25,1036,145,294,.493,2,6,.333,143,288,.497,.497,117,172,.680,80,191,271,69,28,77,103,160,409
142,Edgar Jones\jonesed01,PF,26,SAS,28,3,622,92,185,.497,0,3,.000,92,182,.505,.497,84,114,.737,56,121,177,20,14,31,43,107,268
143,Hutch Jones\joneshu01,SF,23,SDC,9,0,85,17,37,.459,0,0,,17,37,.459,.459,6,6,1.000,10,7,17,4,3,0,6,14,40
144,Major Jones\jonesma01,PF,29,HOU,60,4,878,142,311,.457,0,2,.000,142,309,.460,.457,56,102,.549,114,149,263,39,22,22,83,104,340
145,Eddie Jordan\jordaed01,PG,28,LAL,35,0,333,40,132,.303,3,16,.188,37,116,.319,.314,11,17,.647,8,18,26,80,31,1,54,52,94
146,Jeff Judkins\judkije01,SF,26,POR,34,0,309,39,88,.443,2,8,.250,37,80,.463,.455,25,30,.833,18,25,43,17,15,2,17,39,105
147,Rich Kelley\kelleri01,C,29,TOT,70,23,1345,130,293,.444,0,0,,130,293,.444,.444,142,175,.811,131,273,404,138,54,39,118,221,402
147,Rich Kelley\kelleri01,C,29,DEN,38,0,565,59,141,.418,0,0,,59,141,.418,.418,55,70,.786,61,111,172,59,21,18,53,115,173
147,Rich Kelley\kelleri01,C,29,UTA,32,23,780,71,152,.467,0,0,,71,152,.467,.467,87,105,.829,70,162,232,79,33,21,65,106,229
148,Clark Kellogg\kellocl01,PF,21,IND,81,81,2761,680,1420,.479,4,18,.222,676,1402,.482,.480,261,352,.741,340,520,860,223,141,43,217,298,1625
149,Greg Kelser\kelsegr01,SF,25,SEA,80,9,1507,247,450,.549,0,3,.000,247,447,.553,.549,173,257,.673,158,245,403,97,52,35,149,243,667
150,Larry Kenon\kenonla01,PF,30,TOT,48,7,770,119,257,.463,0,1,.000,119,256,.465,.463,42,57,.737,66,81,147,39,23,9,47,64,280
150,Larry Kenon\kenonla01,PF,30,CHI,5,0,25,2,6,.333,0,0,,2,6,.333,.333,0,0,,1,3,4,0,1,0,2,2,4
150,Larry Kenon\kenonla01,PF,30,GSW,11,0,121,17,39,.436,0,0,,17,39,.436,.436,7,11,.636,13,13,26,5,1,0,6,13,41
150,Larry Kenon\kenonla01,PF,30,CLE,32,7,624,100,212,.472,0,1,.000,100,211,.474,.472,35,46,.761,52,65,117,34,21,9,39,49,235
151,Albert King\kingal01,SF,23,NJN,79,75,2447,582,1226,.475,6,23,.261,576,1203,.479,.477,176,227,.775,157,299,456,291,95,41,245,278,1346
152,Bernard King*\kingbe01,SF,26,NYK,68,68,2207,603,1142,.528,0,6,.000,603,1136,.531,.528,280,388,.722,99,227,326,195,90,13,197,233,1486
153,Reggie King\kingre01,SF,25,KCK,58,5,995,104,225,.462,0,0,,104,225,.462,.462,73,96,.760,91,149,240,58,28,11,65,94,281
154,Billy Knight\knighbi01,SG,30,IND,80,54,2262,512,984,.520,3,19,.158,509,965,.527,.522,343,408,.841,152,172,324,192,66,8,193,143,1370
155,Joe Kopicki\kopicjo01,PF,22,WSB,17,1,201,23,51,.451,0,1,.000,23,50,.460,.451,21,25,.840,18,44,62,9,9,2,8,21,67
156,Joel Kramer\kramejo01,C,27,PHO,54,4,458,44,104,.423,0,1,.000,44,103,.427,.423,14,16,.875,41,47,88,37,15,6,22,63,102
157,Sam Lacey\laceysa01,C,34,CLE,60,33,1232,111,264,.420,2,9,.222,109,255,.427,.424,29,37,.784,62,169,231,118,29,25,98,209,253
158,Bill Laimbeer\laimbbi01,C,25,DET,82,82,2871,436,877,.497,2,13,.154,434,864,.502,.498,245,310,.790,282,711,993,263,51,118,176,320,1119
159,Jeff Lamp\lampje01,SF,23,POR,59,1,690,107,252,.425,1,6,.167,106,246,.431,.427,42,52,.808,25,51,76,58,20,3,38,67,257
160,Mark Landsberger\landsma01,PF,27,LAL,39,4,356,43,102,.422,0,0,,43,102,.422,.422,12,25,.480,55,73,128,12,8,4,20,48,98
161,Bob Lanier*\laniebo01,C,34,MIL,39,35,978,163,332,.491,0,1,.000,163,331,.492,.491,91,133,.684,58,142,200,105,34,24,82,125,417
162,Allen Leavell\leaveal01,PG,25,HOU,79,76,2602,439,1059,.415,42,175,.240,397,884,.449,.434,247,297,.832,64,131,195,530,165,14,198,215,1167
163,Ronnie Lester\lestero01,PG,24,CHI,65,38,1437,202,446,.453,0,5,.000,202,441,.458,.453,124,171,.725,46,126,172,332,51,6,134,121,528
164,Fat Lever\leverfa01,PG,22,POR,81,45,2020,256,594,.431,5,15,.333,251,579,.434,.435,116,159,.730,85,140,225,426,153,15,137,179,633
165,Cliff Levingston\levincl01,PF,22,DET,62,5,879,131,270,.485,0,1,.000,131,269,.487,.485,84,147,.571,104,128,232,52,23,36,73,125,346
166,Steve Lingenfelter\lingest01,PF,24,WSB,7,0,53,4,6,.667,0,0,,4,6,.667,.667,0,4,.000,1,11,12,4,1,3,5,16,8
167,Alton Lister\listeal01,PF,24,MIL,80,37,1885,272,514,.529,0,0,,272,514,.529,.529,130,242,.537,168,400,568,111,50,177,186,328,674
168,Lewis Lloyd\lloydle01,SG,23,GSW,73,24,1350,293,566,.518,1,4,.250,292,562,.520,.519,100,139,.719,77,183,260,130,61,31,118,109,687
169,Scott Lloyd\lloydsc01,C,30,DAL,15,0,206,19,50,.380,0,1,.000,19,49,.388,.380,11,17,.647,19,27,46,21,6,6,6,24,49
170,Kevin Loder\loderke01,SF,23,KCK,66,13,818,138,300,.460,5,9,.556,133,291,.457,.468,53,80,.663,37,88,125,72,29,8,64,98,334
171,John Long\longjo01,SG,26,DET,70,30,1485,312,692,.451,2,7,.286,310,685,.453,.452,111,146,.760,56,124,180,105,44,12,144,130,737
172,John Lucas\lucasjo01,PG,29,WSB,35,0,386,62,131,.473,0,5,.000,62,126,.492,.473,21,42,.500,8,21,29,102,25,1,47,18,145
173,Maurice Lucas\lucasma01,PF,30,PHO,77,71,2586,495,1045,.474,1,3,.333,494,1042,.474,.474,278,356,.781,201,598,799,219,56,43,221,274,1269
174,Rudy Macklin\macklru01,SF,24,ATL,73,20,1171,170,360,.472,0,4,.000,170,356,.478,.472,101,131,.771,85,105,190,71,41,10,89,189,441
175,Kyle Macy\macyky01,PG,25,PHO,82,9,1836,328,634,.517,23,76,.303,305,558,.547,.535,129,148,.872,41,124,165,278,64,8,90,130,808
176,Dave Magley\magleda01,SF,23,CLE,14,0,56,4,16,.250,0,1,.000,4,15,.267,.250,4,8,.500,2,8,10,2,2,0,2,5,12
177,Rick Mahorn\mahorri01,PF,24,WSB,82,82,3023,376,768,.490,0,3,.000,376,765,.492,.490,146,254,.575,171,608,779,115,86,148,170,335,898
178,Moses Malone*\malonmo01,C,27,PHI,78,78,2922,654,1305,.501,0,1,.000,654,1304,.502,.501,600,788,.761,445,749,1194,101,89,157,264,206,1908
179,Wes Matthews\matthwe01,PG,23,ATL,64,0,1187,171,424,.403,14,48,.292,157,376,.418,.420,86,112,.768,25,66,91,249,60,8,123,129,442
180,Cedric Maxwell\maxwece01,SF,27,BOS,79,71,2252,331,663,.499,0,1,.000,331,662,.500,.499,280,345,.812,185,237,422,186,65,39,165,202,942
181,Scott May\maysc01,SF,28,DET,9,1,155,21,50,.420,0,0,,21,50,.420,.420,17,21,.810,10,16,26,12,5,2,13,24,59
182,Bob McAdoo*\mcadobo01,C,31,LAL,47,1,1019,292,562,.520,0,1,.000,292,561,.520,.520,119,163,.730,76,171,247,39,40,40,68,153,703
183,Hank McDowell\mcdowha01,PF,23,TOT,56,0,505,58,126,.460,0,2,.000,58,124,.468,.460,47,61,.770,54,65,119,24,8,11,40,84,163
183,Hank McDowell\mcdowha01,PF,23,GSW,14,0,130,13,29,.448,0,0,,13,29,.448,.448,14,18,.778,15,15,30,4,2,4,8,26,40
183,Hank McDowell\mcdowha01,PF,23,POR,42,0,375,45,97,.464,0,2,.000,45,95,.474,.464,33,43,.767,39,50,89,20,6,7,32,58,123
184,Mike McGee\mcgeemi01,SF,23,LAL,39,7,381,69,163,.423,1,7,.143,68,156,.436,.426,17,23,.739,33,20,53,26,11,5,27,50,156
185,Kevin McHale*\mchalke01,PF,25,BOS,82,13,2345,483,893,.541,0,1,.000,483,892,.541,.541,193,269,.717,215,338,553,104,34,192,159,241,1159
186,Billy McKinney\mckinbi01,PG,27,DEN,68,38,1559,266,546,.487,0,7,.000,266,539,.494,.487,136,167,.814,21,100,121,288,39,5,101,142,668
187,Tom McMillen\mcmilto01,C,30,ATL,61,4,1364,198,424,.467,0,1,.000,198,423,.468,.467,108,133,.812,57,160,217,76,17,24,80,143,504
188,Mark McNamara\mcnamma01,C,23,PHI,36,2,182,29,64,.453,0,0,,29,64,.453,.453,20,45,.444,34,42,76,7,3,3,36,42,78
189,Joe Meriweather\meriwjo01,C,29,KCK,78,74,1706,258,453,.570,0,0,,258,453,.570,.570,102,163,.626,150,274,424,64,47,86,118,285,618
190,Mike Mitchell\mitchmi01,SF,27,SAS,80,79,2803,686,1342,.511,0,3,.000,686,1339,.512,.511,219,289,.758,188,349,537,98,57,52,126,248,1591
191,Steve Mix\mixst01,SF,35,TOT,58,20,809,137,283,.484,1,4,.250,136,279,.487,.486,75,88,.852,38,99,137,70,33,3,45,71,350
191,Steve Mix\mixst01,SF,35,MIL,57,20,792,133,273,.487,1,4,.250,132,269,.491,.489,74,87,.851,37,99,136,68,33,3,45,70,341
191,Steve Mix\mixst01,SF,35,LAL,1,0,17,4,10,.400,0,0,,4,10,.400,.400,1,1,1.000,1,0,1,2,0,0,0,1,9
192,Paul Mokeski\mokespa01,C,26,TOT,73,19,1128,119,260,.458,0,1,.000,119,259,.459,.458,50,68,.735,76,184,260,49,21,44,67,223,288
192,Paul Mokeski\mokespa01,C,26,CLE,23,18,539,55,121,.455,0,0,,55,121,.455,.455,16,26,.615,47,91,138,26,12,23,27,85,126
192,Paul Mokeski\mokespa01,C,26,MIL,50,1,589,64,139,.460,0,1,.000,64,138,.464,.460,34,42,.810,29,93,122,23,9,21,40,138,162
193,Sidney Moncrief\moncrsi01,SG,25,MIL,76,76,2710,606,1156,.524,1,10,.100,605,1146,.528,.525,499,604,.826,192,245,437,300,113,23,197,180,1712
194,Johnny Moore\moorejo01,PG,24,SAS,77,73,2552,394,841,.468,5,22,.227,389,819,.475,.471,148,199,.744,65,212,277,753,194,32,226,247,941
195,Lowes Moore\moorelo01,PG,25,SDC,37,3,642,81,190,.426,6,23,.261,75,167,.449,.442,42,56,.750,15,40,55,73,22,1,46,72,210
196,Guy Morgan\morgagu01,SG,22,IND,8,0,46,7,24,.292,0,0,,7,24,.292,.292,1,4,.250,6,11,17,7,2,0,2,7,15
197,Calvin Murphy*\murphca01,PG,34,HOU,64,0,1423,337,754,.447,4,14,.286,333,740,.450,.450,138,150,.920,34,40,74,158,59,4,89,163,816
198,Larry Nance\nancela01,PF,23,PHO,82,82,2914,588,1069,.550,1,3,.333,587,1066,.551,.551,193,287,.672,239,471,710,197,99,217,190,254,1370
199,Swen Nater\natersw01,C,33,SDC,7,0,51,6,20,.300,0,0,,6,20,.300,.300,4,4,1.000,2,11,13,1,1,0,3,1,16
200,Calvin Natt\nattca01,SF,26,POR,80,80,2879,644,1187,.543,3,20,.150,641,1167,.549,.544,339,428,.792,214,385,599,171,63,29,203,184,1630
201,Kenny Natt\nattke01,SG,24,UTA,22,0,210,38,73,.521,0,2,.000,38,71,.535,.521,9,14,.643,6,16,22,28,5,0,22,36,85
202,Ed Nealy\nealyed01,PF,22,KCK,82,61,1643,147,247,.595,0,0,,147,247,.595,.595,70,114,.614,170,315,485,62,68,12,51,247,364
203,Chuck Nevitt\nevitch01,C,23,HOU,6,0,64,11,15,.733,0,0,,11,15,.733,.733,1,4,.250,6,11,17,0,1,12,7,14,23
204,Carl Nicks\nicksca01,SG,24,CLE,9,2,148,26,59,.441,0,1,.000,26,58,.448,.441,11,17,.647,8,18,26,11,6,0,11,17,63
205,Kurt Nimphius\nimphku01,C,24,DAL,81,12,1515,174,355,.490,1,1,1.000,173,354,.489,.492,77,140,.550,157,247,404,115,24,111,66,287,426
206,Norm Nixon\nixonno01,PG,27,LAL,79,79,2711,533,1123,.475,0,13,.000,533,1110,.480,.475,125,168,.744,61,144,205,566,104,4,237,176,1191
207,Audie Norris\norriau01,C,22,POR,30,0,311,26,63,.413,0,0,,26,63,.413,.413,14,30,.467,25,44,69,24,13,2,33,61,66
208,Mike O'Koren\okoremi01,SF,24,NJN,46,14,803,136,259,.525,2,9,.222,134,250,.536,.529,34,48,.708,42,72,114,82,42,11,62,67,308
209,Mark Olberding\olberma01,PF,26,CHI,80,31,1817,251,522,.481,2,12,.167,249,510,.488,.483,194,248,.782,108,250,358,131,50,9,152,246,698
210,Jawann Oldham\oldhaja01,C,25,CHI,16,0,171,31,58,.534,0,0,,31,58,.534,.534,12,22,.545,18,29,47,5,5,13,13,30,74
211,Louis Orr\orrlo01,SF,24,NYK,82,14,1666,274,593,.462,0,2,.000,274,591,.464,.462,140,175,.800,94,134,228,94,64,24,93,134,688
212,Tom Owens\owensto01,C,33,DET,49,4,725,81,192,.422,0,0,,81,192,.422,.422,45,66,.682,66,120,186,44,12,14,48,115,207
213,Robert Parish*\parisro01,C,29,BOS,78,76,2459,619,1125,.550,0,1,.000,619,1124,.551,.550,271,388,.698,260,567,827,141,79,148,185,222,1509
214,Billy Paultz\paultbi01,C,34,TOT,64,0,820,101,227,.445,0,0,,101,227,.445,.445,27,59,.458,64,136,200,61,17,18,47,109,229
214,Billy Paultz\paultbi01,C,34,HOU,57,0,695,89,200,.445,0,0,,89,200,.445,.445,26,57,.456,54,113,167,57,12,12,41,95,204
214,Billy Paultz\paultbi01,C,34,SAS,7,0,125,12,27,.444,0,0,,12,27,.444,.444,1,2,.500,10,23,33,4,5,6,6,14,25
215,Jim Paxson\paxsoji02,SG,25,POR,81,81,2740,682,1323,.515,4,25,.160,678,1298,.522,.517,388,478,.812,68,106,174,231,140,17,156,160,1756
216,Sam Pellom\pellosa01,PF,31,TOT,6,0,29,6,16,.375,0,0,,6,16,.375,.375,0,0,,2,6,8,1,0,0,2,3,12
216,Sam Pellom\pellosa01,PF,31,ATL,2,0,9,2,6,.333,0,0,,2,6,.333,.333,0,0,,0,0,0,1,0,0,0,0,4
216,Sam Pellom\pellosa01,PF,31,MIL,4,0,20,4,10,.400,0,0,,4,10,.400,.400,0,0,,2,6,8,0,0,0,2,3,8
217,Roger Phegley\pheglro01,SG,26,SAS,62,4,599,120,267,.449,3,14,.214,117,253,.462,.455,43,56,.768,39,45,84,60,30,8,49,92,286
218,Eddie Phillips\philled01,SF,21,NJN,48,0,416,56,138,.406,0,2,.000,56,136,.412,.406,40,59,.678,27,50,77,29,14,8,50,58,152
219,Ricky Pierce\piercri01,SG,23,DET,39,1,265,33,88,.375,1,7,.143,32,81,.395,.381,18,32,.563,15,20,35,14,8,4,18,42,85
220,Charles Pittman\pittmch01,PF,24,PHO,28,0,170,19,40,.475,0,1,.000,19,39,.487,.475,25,37,.676,13,18,31,7,2,7,22,41,63
221,Ben Poquette\poquebe01,PF,27,UTA,75,50,2331,329,697,.472,1,5,.200,328,692,.474,.473,166,221,.751,155,366,521,168,64,116,100,264,825
222,Kevin Porter\porteke01,PG,32,WSB,11,0,210,21,40,.525,0,0,,21,40,.525,.525,5,6,.833,2,3,5,46,10,0,21,30,47
223,Paul Pressey\presspa01,SG,24,MIL,79,18,1528,213,466,.457,1,9,.111,212,457,.464,.458,105,176,.597,83,198,281,207,99,47,162,174,532
224,Mark Radford\radfoma01,SG,23,SEA,54,2,439,84,172,.488,4,18,.222,80,154,.519,.500,30,73,.411,12,35,47,104,34,4,74,78,202
225,Ed Rains\rainsed01,SF,26,SAS,34,1,292,33,83,.398,0,1,.000,33,82,.402,.398,29,43,.674,25,19,44,22,10,1,25,35,95
226,Kurt Rambis\rambiku01,PF,24,LAL,78,77,1806,235,413,.569,0,2,.000,235,411,.572,.569,114,166,.687,164,367,531,90,105,63,145,233,584
227,Kelvin Ransey\ranseke01,PG,24,DAL,76,4,1607,343,746,.460,2,16,.125,341,730,.467,.461,152,199,.764,44,103,147,280,58,4,129,109,840
228,James Ray\rayja01,PF,25,DEN,45,3,433,70,153,.458,0,1,.000,70,152,.461,.458,33,51,.647,37,89,126,39,24,19,50,83,173
229,Clint Richardson\richacl01,SG,26,PHI,77,1,1755,259,559,.463,0,6,.000,259,553,.468,.463,71,111,.640,98,149,247,168,71,18,99,164,589
230,Micheal Ray Richardson\richami01,PG,27,TOT,64,51,2076,346,815,.425,8,51,.157,338,764,.442,.429,106,163,.650,113,182,295,432,182,24,244,240,806
230,Micheal Ray Richardson\richami01,PG,27,GSW,33,25,1074,176,427,.412,4,31,.129,172,396,.434,.417,55,87,.632,45,100,145,245,101,9,137,124,411
230,Micheal Ray Richardson\richami01,PG,27,NJN,31,26,1002,170,388,.438,4,20,.200,166,368,.451,.443,51,76,.671,68,82,150,187,81,15,107,116,395
231,Rick Robey\robeyri01,C,27,BOS,59,6,855,100,214,.467,0,0,,100,214,.467,.467,45,78,.577,79,140,219,65,13,8,72,131,245
232,Cliff Robinson\robincl01,PF,22,CLE,77,75,2601,587,1230,.477,0,5,.000,587,1225,.479,.477,213,301,.708,190,666,856,145,61,58,224,272,1387
233,Oliver Robinson\robinol01,SG,22,SAS,35,0,147,35,97,.361,1,11,.091,34,86,.395,.366,30,45,.667,6,11,17,21,4,2,13,18,101
234,Truck Robinson\robintr01,PF,31,NYK,81,76,2426,326,706,.462,0,0,,326,706,.462,.462,118,201,.587,199,458,657,145,57,24,190,241,770
235,Dave Robisch\robisda01,C,33,DEN,61,0,711,96,251,.382,0,1,.000,96,250,.384,.382,92,118,.780,34,117,151,53,10,9,45,61,284
236,Tree Rollins\rollitr01,C,27,ATL,80,80,2472,261,512,.510,0,1,.000,261,511,.511,.510,98,135,.726,210,533,743,75,49,343,95,294,620
237,Lorenzo Romar\romarlo01,PG,24,GSW,82,64,2130,266,572,.465,10,33,.303,256,539,.475,.474,78,105,.743,23,115,138,455,98,5,141,142,620
238,Dan Roundfield\roundda01,PF,29,ATL,77,76,2811,561,1193,.470,5,27,.185,556,1166,.477,.472,337,450,.749,259,621,880,225,60,115,245,239,1464
239,Jeff Ruland\rulanje01,C,24,WSB,79,47,2862,580,1051,.552,1,3,.333,579,1048,.552,.552,375,544,.689,293,578,871,234,74,77,297,312,1536
240,Walker Russell\russewa01,PG,22,DET,68,1,757,67,184,.364,2,18,.111,65,166,.392,.370,47,58,.810,19,54,73,131,16,1,92,71,183
241,Mike Sanders\sandemi01,SF,22,SAS,26,0,393,76,157,.484,0,2,.000,76,155,.490,.484,31,43,.721,31,63,94,19,18,6,28,57,183
242,Danny Schayes\schayda01,C,23,TOT,82,50,2284,342,749,.457,0,1,.000,342,748,.457,.457,228,295,.773,200,435,635,205,54,98,253,325,912
242,Danny Schayes\schayda01,C,23,UTA,50,50,1638,231,514,.449,0,1,.000,231,513,.450,.449,157,195,.805,137,312,449,165,39,68,195,216,619
242,Danny Schayes\schayda01,C,23,DEN,32,0,646,111,235,.472,0,0,,111,235,.472,.472,71,100,.710,63,123,186,40,15,30,58,109,293
243,Russ Schoene\schoeru01,PF,22,TOT,77,7,1222,207,435,.476,1,4,.250,206,431,.478,.477,61,83,.735,96,159,255,59,25,23,81,192,476
243,Russ Schoene\schoeru01,PF,22,PHI,46,2,702,106,207,.512,0,1,.000,106,206,.515,.512,21,28,.750,52,102,154,32,13,9,46,118,233
243,Russ Schoene\schoeru01,PF,22,IND,31,5,520,101,228,.443,1,3,.333,100,225,.444,.445,40,55,.727,44,57,101,27,12,14,35,74,243
244,Alvin Scott\scottal01,SF,27,PHO,81,9,1139,124,259,.479,0,2,.000,124,257,.482,.479,81,110,.736,60,164,224,97,48,31,64,133,329
245,Lonnie Shelton\sheltlo01,PF,27,SEA,82,79,2572,437,915,.478,1,6,.167,436,909,.480,.478,141,187,.754,158,337,495,237,75,72,172,310,1016
246,Ed Sherod\sheroed01,PG,23,NYK,64,37,1624,171,421,.406,1,13,.077,170,408,.417,.407,52,80,.650,43,106,149,311,96,14,104,112,395
247,Purvis Short\shortpu01,SF,25,GSW,67,57,2397,589,1209,.487,4,15,.267,585,1194,.490,.489,255,308,.828,145,209,354,228,94,14,194,242,1437
248,Jerry Sichting\sichtje01,PG,26,IND,78,58,2435,316,661,.478,3,18,.167,313,643,.487,.480,92,107,.860,33,122,155,433,104,2,138,185,727
249,Jack Sikma\sikmaja01,C,27,SEA,75,71,2564,484,1043,.464,0,8,.000,484,1035,.468,.464,400,478,.837,213,645,858,233,87,65,190,263,1368
250,Jose Slaughter\slaugjo01,SG,22,IND,63,1,515,89,238,.374,9,41,.220,80,197,.406,.393,38,59,.644,34,34,68,52,36,7,42,93,225
251,Derek Smith\smithde02,SF,21,GSW,27,0,154,21,51,.412,0,2,.000,21,49,.429,.412,17,25,.680,10,28,38,2,0,4,11,40,59
252,Jim Smith\smithji01,PF,24,DET,4,0,18,3,4,.750,0,0,,3,4,.750,.750,2,4,.500,0,5,5,0,0,0,0,4,8
253,Larry Smith\smithla01,PF,25,GSW,49,41,1433,180,306,.588,0,0,,180,306,.588,.588,53,99,.535,209,276,485,46,36,20,83,186,413
254,Phil Smith\smithph01,SG,30,SEA,79,17,1238,175,400,.438,3,8,.375,172,392,.439,.441,101,133,.759,27,103,130,216,44,8,102,113,454
255,Randy Smith\smithra01,SG,34,TOT,80,16,1406,273,565,.483,3,18,.167,270,547,.494,.486,114,131,.870,37,59,96,206,56,0,98,139,663
255,Randy Smith\smithra01,SG,34,SDC,65,16,1264,244,499,.489,3,16,.188,241,483,.499,.492,101,117,.863,35,53,88,192,54,0,89,122,592
255,Randy Smith\smithra01,SG,34,ATL,15,0,142,29,66,.439,0,2,.000,29,64,.453,.439,13,14,.929,2,6,8,14,2,0,9,17,71
256,Robert Smith\smithro01,PG,27,TOT,12,0,68,7,24,.292,0,2,.000,7,22,.318,.292,9,10,.900,1,5,6,8,5,0,6,13,23
256,Robert Smith\smithro01,PG,27,SDC,5,0,43,2,13,.154,0,1,.000,2,12,.167,.154,7,8,.875,1,2,3,6,4,0,3,7,11
256,Robert Smith\smithro01,PG,27,SAS,7,0,25,5,11,.455,0,1,.000,5,10,.500,.455,2,2,1.000,0,3,3,2,1,0,3,6,12
257,Ricky Sobers\soberri01,SG,30,WSB,41,39,1438,234,534,.438,23,55,.418,211,479,.441,.460,154,185,.832,35,67,102,218,61,14,147,158,645
258,Jim Spanarkel\spanaji01,SG,25,DAL,48,4,722,91,197,.462,2,10,.200,89,187,.476,.467,88,113,.779,27,57,84,78,27,3,55,59,272
259,Rory Sparrow\sparrro01,PG,24,TOT,81,58,2428,392,810,.484,5,22,.227,387,788,.491,.487,147,199,.739,61,169,230,397,107,5,197,255,936
259,Rory Sparrow\sparrro01,PG,24,ATL,49,49,1548,264,512,.516,3,15,.200,261,497,.525,.519,84,113,.743,39,102,141,238,70,1,126,162,615
259,Rory Sparrow\sparrro01,PG,24,NYK,32,9,880,128,298,.430,2,7,.286,126,291,.433,.433,63,86,.733,22,67,89,159,37,4,71,93,321
260,Larry Spriggs\sprigla01,SF,23,CHI,9,0,39,8,20,.400,0,0,,8,20,.400,.400,5,7,.714,2,7,9,3,1,2,2,3,21
261,Brook Steppe\steppbr01,SG,23,KCK,62,6,606,84,176,.477,1,7,.143,83,169,.491,.480,76,100,.760,25,48,73,68,26,3,55,92,245
262,Jeff Taylor\tayloje01,SG,23,HOU,44,5,774,64,160,.400,0,1,.000,64,159,.403,.400,30,46,.652,25,53,78,110,40,15,60,82,158
263,Vince Taylor\taylovi01,SG,22,NYK,31,0,321,37,102,.363,0,0,,37,102,.363,.363,21,32,.656,19,17,36,41,20,2,30,54,95
264,Terry Teagle\teaglte01,SG,22,HOU,73,44,1708,332,776,.428,10,29,.345,322,747,.431,.434,87,125,.696,74,120,194,150,53,18,137,171,761
265,Carlos Terry\terryca01,SG,26,WSB,55,3,514,39,106,.368,0,2,.000,39,104,.375,.368,10,15,.667,27,72,99,46,24,13,20,79,88
266,Reggie Theus\theusre01,PG,25,CHI,82,81,2856,749,1567,.478,21,91,.231,728,1476,.493,.485,434,542,.801,91,209,300,484,143,17,321,281,1953
267,David Thirdkill\thirdda01,SF,22,PHO,49,2,521,74,170,.435,1,7,.143,73,163,.448,.438,45,78,.577,28,44,72,36,19,4,48,93,194
268,Isiah Thomas*\thomais01,PG,21,DET,81,81,3093,725,1537,.472,36,125,.288,689,1412,.488,.483,368,518,.710,105,223,328,634,199,29,326,318,1854
269,Corny Thompson\thompco01,PF,22,DAL,44,2,520,43,137,.314,0,0,,43,137,.314,.314,36,46,.783,41,79,120,34,12,7,31,92,122
270,David Thompson*\thompda01,SG,28,SEA,75,64,2155,445,925,.481,2,10,.200,443,915,.484,.482,298,380,.784,96,174,270,222,47,33,163,142,1190
271,LaSalle Thompson\thompla01,C,21,KCK,71,3,987,147,287,.512,0,1,.000,147,286,.514,.512,89,137,.650,133,242,375,33,40,61,96,186,383
272,Mychal Thompson\thompmy01,C,28,POR,80,80,3017,505,1033,.489,0,1,.000,505,1032,.489,.489,249,401,.621,183,570,753,380,68,110,281,213,1259
273,Darren Tillis\tillida01,C,22,TOT,52,4,526,76,181,.420,0,1,.000,76,180,.422,.420,16,28,.571,41,89,130,18,8,30,22,76,168
273,Darren Tillis\tillida01,C,22,BOS,15,0,44,7,23,.304,0,1,.000,7,22,.318,.304,2,6,.333,4,5,9,2,0,2,4,8,16
273,Darren Tillis\tillida01,C,22,CLE,37,4,482,69,158,.437,0,0,,69,158,.437,.437,14,22,.636,37,84,121,16,8,28,18,68,152
274,Ray Tolbert\tolbera01,PF,24,TOT,73,2,1107,157,314,.500,0,3,.000,157,311,.505,.500,52,103,.505,72,170,242,50,26,47,83,153,366
274,Ray Tolbert\tolbera01,PF,24,SEA,45,2,712,100,190,.526,0,2,.000,100,188,.532,.526,24,44,.545,46,105,151,31,16,24,51,97,224
274,Ray Tolbert\tolbera01,PF,24,DET,28,0,395,57,124,.460,0,1,.000,57,123,.463,.460,28,59,.475,26,65,91,19,10,23,32,56,142
275,Andrew Toney\toneyan01,SG,25,PHI,81,81,2474,626,1250,.501,22,76,.289,604,1174,.514,.510,324,411,.788,42,183,225,365,80,17,271,255,1598
276,Linton Townes\towneli01,SF,23,POR,55,0,516,105,234,.449,9,25,.360,96,209,.459,.468,28,38,.737,30,35,65,31,19,5,33,81,247
277,Kelly Tripucka\tripuke01,SF,23,DET,58,58,2252,565,1156,.489,14,37,.378,551,1119,.492,.495,392,464,.845,126,138,264,237,67,20,187,157,1536
278,Trent Tucker\tucketr01,SG,23,NYK,78,59,1830,299,647,.462,14,30,.467,285,617,.462,.473,43,64,.672,75,141,216,195,56,6,70,235,655
279,Elston Turner\turneel01,SF,23,DAL,59,16,879,96,238,.403,2,3,.667,94,235,.400,.408,20,30,.667,68,84,152,88,47,0,59,75,214
280,Terry Tyler\tylerte01,SF,26,DET,82,56,2543,421,880,.478,2,15,.133,419,865,.484,.480,146,196,.745,180,360,540,157,103,160,120,221,990
281,Darnell Valentine\valenda01,PG,23,POR,47,36,1298,209,460,.454,0,1,.000,209,459,.455,.454,169,213,.793,34,83,117,293,101,5,131,139,587
282,Jan van Breda Kolff\vanbrja01,SF,31,NJN,13,0,63,5,14,.357,0,0,,5,14,.357,.357,5,6,.833,2,11,13,5,2,2,3,9,15
283,Kiki Vandeweghe\vandeki01,PF,24,DEN,82,79,2909,841,1537,.547,15,51,.294,826,1486,.556,.552,489,559,.875,124,313,437,203,66,38,177,198,2186
284,Pete Verhoeven\verhope01,PF,23,POR,48,0,527,87,171,.509,0,1,.000,87,170,.512,.509,21,31,.677,44,52,96,32,18,9,40,95,195
285,Jay Vincent\vinceja01,PF,23,DAL,81,73,2726,622,1272,.489,0,3,.000,622,1269,.490,.489,269,343,.784,217,375,592,212,70,45,188,295,1513
286,Danny Vranes\vraneda01,SF,24,SEA,82,73,2054,226,429,.527,0,1,.000,226,428,.528,.527,115,209,.550,177,248,425,120,53,49,102,254,567
287,Foots Walker\walkefo01,PG,31,NJN,79,10,1388,114,250,.456,2,12,.167,112,238,.471,.460,116,149,.779,30,106,136,264,78,3,104,134,346
288,Wally Walker\walkewa01,SF,28,HOU,82,59,2251,362,806,.449,1,4,.250,361,802,.450,.450,72,116,.621,137,236,373,199,37,22,144,202,797
289,Bill Walton*\waltobi01,C,30,SDC,33,32,1099,200,379,.528,0,0,,200,379,.528,.528,65,117,.556,75,248,323,120,34,119,105,113,465
290,Bryan Warrick\warribr01,PG,23,WSB,43,20,727,65,171,.380,0,5,.000,65,166,.392,.380,42,57,.737,15,54,69,126,21,8,71,103,172
291,Marvin Webster\webstma01,C,30,NYK,82,0,1472,168,331,.508,0,1,.000,168,330,.509,.508,106,180,.589,176,267,443,49,35,131,102,210,442
292,Scott Wedman\wedmasc01,SF,30,TOT,75,35,1793,374,788,.475,10,32,.313,364,756,.481,.481,85,107,.794,98,184,282,117,43,17,126,228,843
292,Scott Wedman\wedmasc01,SF,30,CLE,35,35,1290,280,583,.480,9,22,.409,271,561,.483,.488,65,77,.844,69,139,208,86,23,11,94,145,634
292,Scott Wedman\wedmasc01,SF,30,BOS,40,0,503,94,205,.459,1,10,.100,93,195,.477,.461,20,30,.667,29,45,74,31,20,6,32,83,209
293,Paul Westphal\westppa01,SG,32,NYK,80,59,1978,318,693,.459,14,48,.292,304,645,.471,.469,148,184,.804,19,96,115,439,87,16,196,180,798
294,Rory White\whitero01,SF,23,PHO,65,0,626,127,234,.543,0,1,.000,127,233,.545,.543,70,109,.642,47,58,105,30,16,2,51,54,324
295,Jerome Whitehead\whiteje01,C,26,SDC,46,23,905,164,306,.536,0,0,,164,306,.536,.536,72,87,.828,105,156,261,42,21,15,65,139,400
296,Bob Wilkerson\wilkebo01,SF,28,CLE,77,11,1702,213,511,.417,0,4,.000,213,507,.420,.417,93,124,.750,62,180,242,189,68,16,160,157,519
297,Jamaal Wilkes*\wilkeja01,SF,29,LAL,80,80,2552,684,1290,.530,0,6,.000,684,1284,.533,.530,203,268,.757,146,197,343,182,65,17,150,221,1571
298,James Wilkes\wilkeja02,SF,24,DET,9,0,129,11,34,.324,0,1,.000,11,33,.333,.324,12,15,.800,9,10,19,10,3,1,5,22,34
299,Dominique Wilkins*\wilkido01,SF,23,ATL,82,82,2697,601,1220,.493,2,11,.182,599,1209,.495,.493,230,337,.682,226,252,478,129,84,63,180,210,1434
300,Jeff Wilkins\wilkije01,C,27,UTA,81,34,2307,389,816,.477,0,3,.000,389,813,.478,.477,156,200,.780,154,442,596,132,41,42,186,251,934
301,Buck Williams\willibu01,PF,22,NJN,82,82,2961,536,912,.588,0,4,.000,536,908,.590,.588,324,523,.620,365,662,1027,125,91,110,246,270,1396
302,Freeman Williams\willifr01,SG,26,UTA,18,3,210,36,101,.356,2,7,.286,34,94,.362,.366,18,25,.720,3,14,17,10,6,1,12,30,92
303,Gus Williams\willigu01,PG,29,SEA,80,80,2761,660,1384,.477,2,43,.047,658,1341,.491,.478,278,370,.751,72,133,205,643,182,26,230,117,1600
304,Herb Williams\willihe01,C,24,IND,78,74,2513,580,1163,.499,0,7,.000,580,1156,.502,.499,155,220,.705,151,432,583,262,54,171,229,230,1315
305,Ray Williams\willira01,PG,28,KCK,72,68,2170,419,1068,.392,15,74,.203,404,994,.406,.399,256,333,.769,93,234,327,569,120,26,335,248,1109
306,Rickey Williams\williri01,SG,25,UTA,44,0,346,56,135,.415,0,3,.000,56,132,.424,.415,35,53,.660,15,23,38,37,20,4,38,42,147
307,Rob Williams\williro02,PG,21,DEN,74,33,1443,191,468,.408,2,15,.133,189,453,.417,.410,131,174,.753,37,99,136,361,89,12,185,221,515
308,Sam Williams\willisa02,PF,23,GSW,75,28,1533,252,479,.526,0,1,.000,252,478,.527,.526,123,171,.719,153,240,393,45,71,89,101,244,627
309,Sly Williams\willisl01,PF,25,NYK,68,6,1385,314,647,.485,2,19,.105,312,628,.497,.487,176,259,.680,94,196,290,133,73,3,133,166,806
310,Bill Willoughby\willobi01,SF,25,TOT,62,0,1146,147,324,.454,6,14,.429,141,310,.455,.463,43,55,.782,63,138,201,64,25,17,61,139,343
310,Bill Willoughby\willobi01,SF,25,SAS,52,0,1062,136,295,.461,6,13,.462,130,282,.461,.471,41,53,.774,61,129,190,56,24,16,56,123,319
310,Bill Willoughby\willobi01,SF,25,NJN,10,0,84,11,29,.379,0,1,.000,11,28,.393,.379,2,2,1.000,2,9,11,8,1,1,5,16,24
311,Brian Winters\wintebr01,SG,30,MIL,57,12,1361,255,587,.434,22,68,.324,233,519,.449,.453,73,85,.859,35,75,110,156,45,4,81,132,605
312,Al Wood\woodal01,SF,24,SDC,76,47,1822,343,740,.464,15,50,.300,328,690,.475,.474,124,161,.770,96,140,236,134,55,36,111,188,825
313,Mike Woodson\woodsmi01,SG,24,KCK,81,3,2426,584,1154,.506,7,33,.212,577,1121,.515,.509,298,377,.790,84,164,248,254,137,59,174,203,1473
314,Orlando Woolridge\woolror01,SF,23,CHI,57,38,1627,361,622,.580,0,3,.000,361,619,.583,.580,217,340,.638,122,176,298,97,38,44,157,177,939
315,James Worthy*\worthja01,SF,21,LAL,77,1,1970,447,772,.579,1,4,.250,446,768,.581,.580,138,221,.624,157,242,399,132,91,64,178,221,1033
316,Jim Zoet\zoetji01,C,29,DET,7,0,30,1,5,.200,0,0,,1,5,.200,.200,0,0,,3,5,8,1,1,3,4,9,2