
Rk,Player,Pos,Age,Tm,G,GS,MP,FG,FGA,FG%,3P,3PA,3P%,2P,2PA,2P%,eFG%,FT,FTA,FT%,ORB,DRB,TRB,AST,STL,BLK,TOV,PF,PTS
1,Kareem Abdul-Jabbar*\abdulka01,C,38,LAL,79,79,2629,755,1338,.564,0,2,.000,755,1336,.565,.564,336,439,.765,133,345,478,280,67,130,203,248,1846
2,Alvan Adams\adamsal01,C,31,PHO,78,45,2005,341,679,.502,0,2,.000,341,677,.504,.502,159,203,.783,148,329,477,324,103,46,206,272,841
3,Michael Adams\adamsmi01,PG,23,SAC,18,0,139,16,44,.364,0,3,.000,16,41,.390,.364,8,12,.667,2,4,6,22,9,1,11,9,40
4,Mark Aguirre\aguirma01,SF,26,DAL,74,73,2501,668,1327,.503,16,56,.286,652,1271,.513,.509,318,451,.705,177,268,445,339,62,14,252,229,1670
5,Danny Ainge\aingeda01,SG,26,BOS,80,78,2407,353,701,.504,26,73,.356,327,628,.521,.522,123,136,.904,47,188,235,405,94,7,129,204,855
6,Ron Anderson\anderro01,SF,27,TOT,77,30,1676,310,628,.494,2,9,.222,308,619,.498,.495,85,127,.669,130,144,274,144,56,6,82,125,707
6,Ron Anderson\anderro01,SF,27,CLE,17,3,207,37,74,.500,0,1,.000,37,73,.507,.500,12,16,.750,5,21,26,8,1,0,6,20,86
6,Ron Anderson\anderro01,SF,27,IND,60,27,1469,273,554,.493,2,8,.250,271,546,.496,.495,73,111,.658,125,123,248,136,55,6,76,105,621
7,John Bagley\baglejo01,PG,25,CLE,78,77,2472,366,865,.423,9,37,.243,357,828,.431,.428,170,215,.791,76,199,275,735,122,10,239,165,911
8,James Bailey\baileja01,PF,28,NYK,48,36,1245,202,443,.456,0,4,.000,202,439,.460,.456,129,167,.772,102,232,334,50,33,40,99,207,533
9,Thurl Bailey\baileth01,PF,24,UTA,82,13,2358,483,1077,.448,0,7,.000,483,1070,.451,.448,230,277,.830,148,345,493,153,42,114,144,160,1196
10,Greg Ballard\ballagr01,SF,31,GSW,75,14,1792,272,570,.477,17,35,.486,255,535,.477,.492,101,126,.802,132,285,417,83,65,8,54,174,662
11,Gene Banks\banksge01,SF,26,CHI,82,33,2139,356,688,.517,0,19,.000,356,669,.532,.517,183,255,.718,178,182,360,251,81,10,139,212,895
12,Ken Bannister\bannike01,PF,25,NYK,70,15,1405,235,479,.491,0,1,.000,235,478,.492,.491,131,249,.526,89,233,322,42,42,24,129,208,601
13,Charles Barkley*\barklch01,PF,22,PHI,80,80,2952,595,1041,.572,17,75,.227,578,966,.598,.580,396,578,.685,354,672,1026,312,173,125,350,333,1603
14,John Battle\battljo01,SG,23,ATL,64,0,639,101,222,.455,0,7,.000,101,215,.470,.455,75,103,.728,12,50,62,74,23,3,47,80,277
15,Benoit Benjamin\benjabe01,C,21,LAC,79,37,2088,324,661,.490,1,3,.333,323,658,.491,.491,229,307,.746,161,439,600,79,64,206,145,286,878
16,Kent Benson\bensoke01,C,31,DET,72,51,1344,201,415,.484,1,2,.500,200,413,.484,.486,66,83,.795,118,258,376,80,58,51,58,196,469
17,Larry Bird*\birdla01,SF,29,BOS,82,81,3113,796,1606,.496,82,194,.423,714,1412,.506,.521,441,492,.896,190,615,805,557,166,51,266,182,2115
18,Otis Birdsong\birdsot01,SG,30,NJN,77,74,2395,542,1056,.513,8,22,.364,534,1034,.516,.517,122,210,.581,88,114,202,261,85,17,179,228,1214
19,Uwe Blab\blabuw01,C,23,DAL,48,0,409,44,94,.468,0,0,,44,94,.468,.468,36,67,.537,25,66,91,17,3,12,28,65,124
20,Rolando Blackman\blackro01,SG,26,DAL,82,81,2787,677,1318,.514,4,29,.138,673,1289,.522,.515,404,483,.836,88,203,291,271,79,25,189,138,1762
21,Manute Bol\bolma01,C,23,WSB,80,60,2090,128,278,.460,0,1,.000,128,277,.462,.460,42,86,.488,123,354,477,23,28,397,65,255,298
22,Sam Bowie\bowiesa01,C,24,POR,38,34,1132,167,345,.484,0,0,,167,345,.484,.484,114,161,.708,93,234,327,99,21,96,88,142,448
23,Dudley Bradley\bradldu01,SG,28,WSB,70,7,842,73,209,.349,17,68,.250,56,141,.397,.390,32,56,.571,24,71,95,107,85,3,44,101,195
24,Mike Bratz\bratzmi01,PG,30,SAC,33,0,269,26,70,.371,4,14,.286,22,56,.393,.400,14,18,.778,2,21,23,39,13,0,17,43,70
25,Randy Breuer\breuera01,C,25,MIL,82,63,1792,272,570,.477,0,1,.000,272,569,.478,.477,141,198,.712,159,299,458,114,50,116,122,214,685
26,Ron Brewer\brewero01,SG,30,TOT,44,3,570,86,224,.384,5,17,.294,81,207,.391,.395,34,38,.895,14,39,53,40,17,6,23,44,211
26,Ron Brewer\brewero01,SG,30,CHI,4,0,18,3,9,.333,0,0,,3,9,.333,.333,1,1,1.000,0,0,0,0,0,0,2,1,7
26,Ron Brewer\brewero01,SG,30,CLE,40,3,552,83,215,.386,5,17,.294,78,198,.394,.398,33,37,.892,14,39,53,40,17,6,21,43,204
27,Frank Brickowski\brickfr01,C,26,SEA,40,2,311,30,58,.517,0,0,,30,58,.517,.517,18,27,.667,16,38,54,21,11,7,23,74,78
28,Junior Bridgeman\bridgju01,SF,32,LAC,58,14,1161,199,451,.441,6,18,.333,193,433,.446,.448,106,119,.891,29,94,123,108,31,8,68,81,510
29,Mike Brittain\brittmi01,C,22,SAS,32,2,219,22,43,.512,0,0,,22,43,.512,.512,10,19,.526,10,39,49,5,3,12,20,54,54
30,Tony Brown\brownto01,SG,25,CHI,10,0,132,18,41,.439,0,2,.000,18,39,.462,.439,9,13,.692,5,11,16,14,5,1,4,16,45
31,Wallace Bryant\bryanwa01,C,26,TOT,17,8,218,15,48,.313,0,0,,15,48,.313,.313,11,19,.579,17,36,53,15,5,5,9,38,41
31,Wallace Bryant\bryanwa01,C,26,DAL,9,8,154,11,30,.367,0,0,,11,30,.367,.367,6,11,.545,9,24,33,11,3,2,7,26,28
31,Wallace Bryant\bryanwa01,C,26,LAC,8,0,64,4,18,.222,0,0,,4,18,.222,.222,5,8,.625,8,12,20,4,2,3,2,12,13
32,Quinn Buckner\bucknqu01,PG,31,IND,32,3,419,49,104,.471,0,1,.000,49,103,.476,.471,19,27,.704,9,42,51,86,40,3,55,80,117
33,Michael Cage\cagemi01,PF,24,LAC,78,12,1566,204,426,.479,0,3,.000,204,423,.482,.479,113,174,.649,168,249,417,81,62,34,106,176,521
34,Tony Campbell\campbto01,SF,23,DET,82,1,1292,294,608,.484,2,9,.222,292,599,.487,.485,58,73,.795,83,153,236,45,62,7,86,164,648
35,Rick Carlisle\carliri01,SG,26,BOS,77,1,760,92,189,.487,0,10,.000,92,179,.514,.487,15,23,.652,22,55,77,104,19,4,50,92,199
36,Antoine Carr\carran01,PF,24,ATL,17,0,258,49,93,.527,0,0,,49,93,.527,.527,18,27,.667,16,36,52,14,7,15,14,51,116
37,Kenny Carr\carrke01,PF,30,POR,55,31,1557,232,466,.498,0,4,.000,232,462,.502,.498,149,217,.687,146,346,492,70,38,30,106,203,613
38,Joe Barry Carroll\carrojo01,C,27,GSW,79,79,2801,650,1404,.463,0,2,.000,650,1402,.464,.463,377,501,.752,193,477,670,176,101,143,275,277,1677
39,Butch Carter\cartebu01,SG,27,TOT,9,0,67,7,24,.292,0,1,.000,7,23,.304,.292,6,7,.857,2,2,4,4,1,0,7,14,20
39,Butch Carter\cartebu01,SG,27,NYK,5,0,31,2,8,.250,0,1,.000,2,7,.286,.250,1,1,1.000,2,1,3,3,1,0,6,6,5
39,Butch Carter\cartebu01,SG,27,PHI,4,0,36,5,16,.313,0,0,,5,16,.313,.313,5,6,.833,0,1,1,1,0,0,1,8,15
40,Bill Cartwright\cartwbi01,C,28,NYK,2,0,36,3,7,.429,0,0,,3,7,.429,.429,6,10,.600,2,8,10,5,1,1,6,6,12
41,Terry Catledge\catlete01,PF,22,PHI,64,7,1092,202,431,.469,0,4,.000,202,427,.473,.469,90,139,.647,107,165,272,21,31,8,69,127,494
42,Bobby Cattage\cattabo01,PF,27,NJN,29,1,185,28,83,.337,1,5,.200,27,78,.346,.343,35,44,.795,15,19,34,4,6,0,13,23,92
43,Tom Chambers\chambto01,PF,26,SEA,66,26,2019,432,928,.466,13,48,.271,419,880,.476,.473,346,414,.836,126,305,431,132,55,37,194,248,1223
44,Lorenzo Charles\charllo01,SF,22,ATL,36,0,273,49,88,.557,0,0,,49,88,.557,.557,24,36,.667,13,26,39,8,2,6,18,37,122
45,Maurice Cheeks*\cheekma01,PG,29,PHI,82,82,3270,490,913,.537,4,17,.235,486,896,.542,.539,282,335,.842,55,180,235,753,207,27,238,160,1266
46,Fred Cofield\cofiefr01,PG,24,NYK,45,1,469,75,184,.408,3,15,.200,72,169,.426,.416,12,20,.600,6,40,46,82,20,3,49,65,165
47,Steve Colter\coltest01,PG,23,POR,81,51,1868,272,597,.456,27,83,.325,245,514,.477,.478,135,164,.823,41,136,177,257,113,10,115,188,706
48,Lester Conner\connele01,PG,26,GSW,36,0,413,51,136,.375,2,7,.286,49,129,.380,.382,40,54,.741,25,37,62,43,24,1,15,23,144
49,Darwin Cook\cookda01,PG,27,NJN,79,33,1965,267,627,.426,11,53,.208,256,574,.446,.435,84,111,.757,51,126,177,390,156,22,132,172,629
50,Jeff Cook\cookje01,PF,29,TOT,36,0,373,31,73,.425,0,1,.000,31,72,.431,.425,27,42,.643,33,53,86,21,13,11,14,65,89
50,Jeff Cook\cookje01,PF,29,SAS,34,0,356,28,67,.418,0,1,.000,28,66,.424,.418,26,41,.634,31,50,81,21,13,11,11,64,82
50,Jeff Cook\cookje01,PF,29,UTA,2,0,17,3,6,.500,0,0,,3,6,.500,.500,1,1,1.000,2,3,5,0,0,0,3,1,7
51,David Cooke\cookeda01,PF,22,SAC,6,0,38,2,11,.182,0,0,,2,11,.182,.182,5,10,.500,5,5,10,1,4,0,2,5,9
52,Michael Cooper\coopemi01,SG,29,LAL,82,15,2269,274,606,.452,63,163,.387,211,443,.476,.504,147,170,.865,44,200,244,466,89,43,151,238,758
53,Wayne Cooper\coopewa01,C,29,DEN,78,78,2112,422,906,.466,3,7,.429,419,899,.466,.467,174,219,.795,190,420,610,81,42,227,117,315,1021
54,Tyrone Corbin\corbity01,SF,23,SAS,16,0,174,27,64,.422,0,1,.000,27,63,.429,.422,10,14,.714,11,14,25,11,11,2,12,21,64
55,Dave Corzine\corzida01,C,29,CHI,67,4,1709,255,519,.491,3,12,.250,252,507,.497,.494,127,171,.743,132,301,433,150,28,53,104,133,640
56,Ron Crevier\creviro01,C,27,TOT,3,0,4,0,3,.000,0,0,,0,3,.000,.000,0,2,.000,1,0,1,0,0,0,0,2,0
56,Ron Crevier\creviro01,C,27,GSW,1,0,1,0,1,.000,0,0,,0,1,.000,.000,0,0,,0,0,0,0,0,0,0,0,0
56,Ron Crevier\creviro01,C,27,DET,2,0,3,0,2,.000,0,0,,0,2,.000,.000,0,2,.000,1,0,1,0,0,0,0,2,0
57,Jeff Cross\crossje01,PF,24,LAC,21,0,128,6,24,.250,0,0,,6,24,.250,.250,14,25,.560,9,21,30,1,2,3,6,38,26
58,Pat Cummings\cummipa01,C,29,NYK,31,30,1007,195,408,.478,0,2,.000,195,406,.480,.478,97,139,.698,92,188,280,47,27,12,87,136,487
59,Terry Cummings\cummite01,PF,24,MIL,82,82,2669,681,1438,.474,0,2,.000,681,1436,.474,.474,265,404,.656,222,472,694,193,121,51,191,283,1627
60,Earl Cureton\curetea01,PF,28,DET,80,19,2017,285,564,.505,0,2,.000,285,562,.507,.505,117,211,.555,198,306,504,137,58,58,150,239,687
61,Quintin Dailey\dailequ01,SG,25,CHI,35,0,723,203,470,.432,0,8,.000,203,462,.439,.432,163,198,.823,20,48,68,67,22,5,67,86,569
62,Adrian Dantley*\dantlad01,SF,29,UTA,76,75,2744,818,1453,.563,1,11,.091,817,1442,.567,.563,630,796,.791,178,217,395,264,64,4,231,206,2267
63,Brad Davis\davisbr01,PG,30,DAL,82,43,1971,267,502,.532,32,89,.360,235,413,.569,.564,198,228,.868,26,120,146,467,57,15,110,174,764
64,Charles Davis\davisch02,SF,27,MIL,57,7,873,188,397,.474,3,24,.125,185,373,.496,.477,61,75,.813,60,110,170,55,26,7,50,113,440
65,Johnny Davis\davisjo01,SG,30,TOT,66,7,1014,148,344,.430,3,13,.231,145,331,.438,.435,118,138,.855,8,47,55,217,37,4,78,76,417
65,Johnny Davis\davisjo01,SG,30,CLE,39,0,612,102,237,.430,2,11,.182,100,226,.442,.435,67,79,.848,6,30,36,105,24,4,40,44,273
65,Johnny Davis\davisjo01,SG,30,ATL,27,7,402,46,107,.430,1,2,.500,45,105,.429,.435,51,59,.864,2,17,19,112,13,0,38,32,144
66,Walter Davis\daviswa03,SG,31,PHO,70,62,2239,624,1287,.485,18,76,.237,606,1211,.500,.492,257,305,.843,54,149,203,361,99,3,219,153,1523
67,Darryl Dawkins\dawkida01,C,29,NJN,51,3,1207,284,441,.644,0,1,.000,284,440,.645,.644,210,297,.707,85,166,251,77,16,59,124,227,778
68,Darren Daye\dayeda01,SF,25,WSB,64,4,1075,198,399,.496,1,3,.333,197,396,.497,.497,159,237,.671,71,112,183,109,46,11,98,121,556
69,James Donaldson\donalja01,C,28,TOT,83,78,2682,256,459,.558,0,0,,256,459,.558,.558,204,254,.803,171,624,795,96,28,139,123,189,716
69,James Donaldson\donalja01,C,28,LAC,14,14,441,43,84,.512,0,0,,43,84,.512,.512,57,70,.814,28,103,131,12,5,29,38,33,143
69,James Donaldson\donalja01,C,28,DAL,69,64,2241,213,375,.568,0,0,,213,375,.568,.568,147,184,.799,143,521,664,84,23,110,85,156,573
70,Larry Drew\drewla01,PG,27,SAC,75,31,1971,376,776,.485,10,31,.323,366,745,.491,.491,128,161,.795,25,100,125,338,66,2,133,134,890
71,Clyde Drexler*\drexlcl01,SG,23,POR,75,58,2576,542,1142,.475,12,60,.200,530,1082,.490,.480,293,381,.769,171,250,421,600,197,46,282,270,1389
72,Joe Dumars*\dumarjo01,SG,22,DET,82,45,1957,287,597,.481,5,16,.313,282,581,.485,.485,190,238,.798,60,59,119,390,66,11,158,200,769
73,T.R. Dunn\dunntr01,SG,30,DEN,82,82,2401,172,379,.454,0,1,.000,172,378,.455,.454,68,88,.773,143,234,377,171,155,16,51,228,412
74,Devin Durrant\durrade01,SF,25,PHO,4,0,51,8,21,.381,0,0,,8,21,.381,.381,1,4,.250,2,6,8,5,3,0,4,10,17
75,Mark Eaton\eatonma01,C,29,UTA,80,80,2551,277,589,.470,0,0,,277,589,.470,.470,122,202,.604,172,503,675,101,33,369,157,282,676
76,Franklin Edwards\edwarfr01,PG,26,LAC,73,19,1491,262,577,.454,1,9,.111,261,568,.460,.455,132,151,.874,24,62,86,259,89,4,137,87,657
77,James Edwards\edwarja01,C,30,PHO,52,51,1314,318,587,.542,0,0,,318,587,.542,.542,212,302,.702,79,222,301,74,23,29,128,200,848
78,Craig Ehlo\ehlocr01,SG,24,HOU,36,0,199,36,84,.429,3,9,.333,33,75,.440,.446,23,29,.793,17,29,46,29,11,4,15,22,98
79,Dale Ellis\ellisda01,SF,25,DAL,72,1,1086,193,470,.411,63,173,.364,130,297,.438,.478,59,82,.720,86,82,168,37,40,9,38,78,508
80,Alex English*\englial01,SF,32,DEN,81,81,3024,951,1888,.504,1,5,.200,950,1883,.505,.504,511,593,.862,192,213,405,320,73,29,249,235,2414
81,Julius Erving*\ervinju01,SF,35,PHI,74,74,2474,521,1085,.480,9,32,.281,512,1053,.486,.484,289,368,.785,169,201,370,248,113,82,214,196,1340
82,Mike Evans\evansmi01,PG,30,DEN,81,1,1389,304,715,.425,39,176,.222,265,539,.492,.452,126,149,.846,30,71,101,177,61,1,124,159,773
83,Patrick Ewing*\ewingpa01,C,23,NYK,50,50,1771,386,814,.474,0,5,.000,386,809,.477,.474,226,306,.739,124,327,451,102,54,103,172,191,998
84,Kenny Fields\fieldke01,SF,23,MIL,78,3,1120,204,398,.513,0,4,.000,204,394,.518,.513,91,132,.689,59,144,203,79,51,15,77,170,499
85,Vern Fleming\flemive01,PG,23,IND,80,77,2870,436,862,.506,1,6,.167,435,856,.508,.506,263,353,.745,102,284,386,505,131,5,208,230,1136
86,Sleepy Floyd\floydsl01,PG,25,GSW,82,82,2764,510,1007,.506,39,119,.328,471,888,.530,.526,351,441,.796,76,221,297,746,157,16,290,199,1410
87,Rod Foster\fostero01,PG,25,PHO,48,0,704,85,218,.390,9,32,.281,76,186,.409,.411,23,32,.719,9,49,58,121,22,1,61,77,202
88,World B. Free\freewo01,SG,32,CLE,75,75,2535,652,1433,.455,71,169,.420,581,1264,.460,.480,379,486,.780,72,146,218,314,91,19,172,186,1754
89,Bill Garnett\garnebi02,PF,25,IND,80,2,1197,112,239,.469,0,2,.000,112,237,.473,.469,116,162,.716,106,169,275,95,39,22,91,174,340
90,George Gervin*\gervige01,SG,33,CHI,82,75,2065,519,1100,.472,4,19,.211,515,1081,.476,.474,283,322,.879,78,137,215,144,49,23,161,210,1325
91,Mike Gibson\gibsomi01,PF,25,DET,32,0,161,20,51,.392,0,0,,20,51,.392,.392,8,11,.727,15,25,40,5,8,4,6,35,48
92,Artis Gilmore*\gilmoar01,C,36,SAS,71,71,2395,423,684,.618,0,1,.000,423,683,.619,.618,338,482,.701,166,434,600,102,39,108,186,239,1184
93,Mike Glenn\glennmi01,SG,30,MIL,38,1,573,94,190,.495,0,0,,94,190,.495,.495,47,49,.959,4,53,57,39,9,3,18,42,235
94,Georgi Glouchkov\gloucge01,PF,26,PHO,49,16,772,84,209,.402,1,1,1.000,83,208,.399,.404,70,122,.574,31,132,163,32,26,25,76,124,239
95,Mike Gminski\gminsmi01,C,26,NJN,81,78,2525,491,949,.517,0,1,.000,491,948,.518,.517,351,393,.893,206,462,668,133,56,71,140,163,1333
96,Lancaster Gordon\gordola01,SG,23,LAC,60,1,704,130,345,.377,7,28,.250,123,317,.388,.387,45,56,.804,24,44,68,60,33,10,62,91,312
97,Stuart Gray\grayst01,C,22,IND,67,3,423,54,108,.500,0,0,,54,108,.500,.500,47,74,.635,45,73,118,15,8,11,32,94,155
98,A.C. Green\greenac01,PF,22,LAL,82,1,1542,209,388,.539,1,6,.167,208,382,.545,.540,102,167,.611,160,221,381,54,49,49,99,229,521
99,Ken Green\greenke01,PF,26,NYK,7,0,72,13,27,.481,0,0,,13,27,.481,.481,5,9,.556,12,15,27,2,4,0,1,8,31
100,Kenny Green\greenke02,SF,21,TOT,41,0,453,83,192,.432,0,1,.000,83,191,.435,.432,35,49,.714,27,46,73,9,5,9,35,53,201
100,Kenny Green\greenke02,SF,21,WSB,20,0,221,44,101,.436,0,1,.000,44,100,.440,.436,21,26,.808,17,21,38,3,4,7,17,26,109
100,Kenny Green\greenke02,SF,21,PHI,21,0,232,39,91,.429,0,0,,39,91,.429,.429,14,23,.609,10,25,35,6,1,2,18,27,92
101,Rickey Green\greenri01,PG,31,UTA,80,44,2012,357,758,.471,5,29,.172,352,729,.483,.474,213,250,.852,32,103,135,411,106,6,132,130,932
102,Sidney Green\greensi02,PF,25,CHI,80,68,2307,407,875,.465,0,8,.000,407,867,.469,.465,262,335,.782,208,450,658,139,70,37,220,292,1076
103,Dave Greenwood\greenda01,PF,28,SAS,68,24,1910,198,388,.510,0,1,.000,198,387,.512,.510,142,184,.772,151,380,531,90,37,52,113,207,538
104,Claude Gregory\gregocl01,PF,27,WSB,2,0,2,1,2,.500,0,0,,1,2,.500,.500,0,0,,2,0,2,0,1,0,2,1,2
105,Ernie Grunfeld\grunfer01,SF,30,NYK,76,0,1402,148,355,.417,26,61,.426,122,294,.415,.454,90,108,.833,42,164,206,119,39,13,50,192,412
106,Petur Gudmundsson\gudmupe01,C,27,LAL,8,2,128,20,37,.541,0,0,,20,37,.541,.541,18,27,.667,17,21,38,3,3,4,11,25,58
107,Bob Hansen\hansebo01,SG,25,UTA,82,82,2032,299,628,.476,17,50,.340,282,578,.488,.490,95,132,.720,82,162,244,193,74,9,126,205,710
108,Bill Hanzlik\hanzlbi01,SF,28,DEN,79,0,1982,331,741,.447,8,41,.195,323,700,.461,.452,318,405,.785,88,176,264,316,107,16,165,277,988
109,Derek Harper\harpede01,PG,24,DAL,79,39,2150,390,730,.534,12,51,.235,378,679,.557,.542,171,229,.747,75,151,226,416,153,23,144,166,963
110,Steve Harris\harrist01,SG,22,HOU,57,0,482,103,233,.442,1,5,.200,102,228,.447,.444,50,54,.926,25,32,57,50,21,4,34,55,257
111,Scott Hastings\hastisc01,PF,25,ATL,62,0,650,65,159,.409,3,4,.750,62,155,.400,.418,60,70,.857,44,80,124,26,14,8,40,118,193
112,Steve Hayes\hayesst01,C,30,UTA,58,0,397,39,87,.448,0,0,,39,87,.448,.448,11,36,.306,32,45,77,7,5,19,16,81,89
113,Gerald Henderson\hendege01,PG,30,SEA,82,82,2568,434,900,.482,18,52,.346,416,848,.491,.492,185,223,.830,89,98,187,487,138,11,184,230,1071
114,Jerome Henderson\hendeje01,C,26,LAL,1,0,3,2,3,.667,0,0,,2,3,.667,.667,0,0,,0,1,1,0,0,0,0,1,4
115,Carl Henry\henryca01,SG,25,SAC,28,0,149,31,67,.463,4,10,.400,27,57,.474,.493,12,17,.706,8,11,19,4,5,0,9,11,78
116,Rod Higgins\higgiro01,SF,26,TOT,30,0,332,39,106,.368,1,9,.111,38,97,.392,.373,19,27,.704,14,37,51,24,9,11,13,49,98
116,Rod Higgins\higgiro01,SF,26,SEA,12,0,94,9,27,.333,1,4,.250,8,23,.348,.352,3,5,.600,3,9,12,6,2,1,4,11,22
116,Rod Higgins\higgiro01,SF,26,SAS,11,0,128,18,40,.450,0,2,.000,18,38,.474,.450,11,16,.688,5,19,24,12,2,3,5,21,47
116,Rod Higgins\higgiro01,SF,26,NJN,2,0,29,3,16,.188,0,2,.000,3,14,.214,.188,0,0,,3,5,8,1,1,4,2,6,6
116,Rod Higgins\higgiro01,SF,26,CHI,5,0,81,9,23,.391,0,1,.000,9,22,.409,.391,5,6,.833,3,4,7,5,4,3,2,11,23
117,Roy Hinson\hinsoro01,SF,24,CLE,82,82,2834,621,1167,.532,0,4,.000,621,1163,.534,.532,364,506,.719,167,472,639,102,62,112,188,316,1606
118,Craig Hodges\hodgecr01,SG,25,MIL,66,66,1739,284,568,.500,73,162,.451,211,406,.520,.564,75,86,.872,39,78,117,229,74,2,89,157,716
119,Mike Holton\holtomi01,PG-SG,24,TOT,28,0,512,77,175,.440,1,12,.083,76,163,.466,.443,28,44,.636,11,22,33,55,25,0,27,47,183
119,Mike Holton\holtomi01,SG,24,PHO,4,0,65,4,20,.200,0,2,.000,4,18,.222,.200,4,6,.667,1,2,3,7,2,0,4,7,12
119,Mike Holton\holtomi01,PG,24,CHI,24,0,447,73,155,.471,1,10,.100,72,145,.497,.474,24,38,.632,10,20,30,48,23,0,23,40,171
120,Phil Hubbard\hubbaph01,SF,29,CLE,23,21,640,93,198,.470,0,1,.000,93,197,.472,.470,76,112,.679,48,72,120,29,20,3,66,78,262
121,Alfredrick Hughes\hugheri01,SG,23,SAS,68,0,866,152,372,.409,3,17,.176,149,355,.420,.413,49,84,.583,49,64,113,61,26,5,63,79,356
122,Jay Humphries\humphja01,PG,23,PHO,82,82,2733,352,735,.479,4,29,.138,348,706,.493,.482,197,257,.767,56,204,260,526,132,9,190,222,905
123,Geoff Huston\hustoge01,PG,28,GSW,82,0,1208,140,273,.513,2,6,.333,138,267,.517,.516,63,92,.685,10,55,65,342,38,4,83,67,345
124,Marc Iavaroni\iavarma01,PF,29,TOT,68,9,1014,110,244,.451,0,2,.000,110,242,.455,.451,76,115,.661,63,146,209,82,32,17,72,163,296
124,Marc Iavaroni\iavarma01,PF,29,SAS,42,7,669,74,163,.454,0,2,.000,74,161,.460,.454,43,67,.642,42,90,132,53,22,14,51,109,191
124,Marc Iavaroni\iavarma01,PF,29,UTA,26,2,345,36,81,.444,0,0,,36,81,.444,.444,33,48,.688,21,56,77,29,10,3,21,54,105
125,Clemon Johnson\johnscl01,C,29,PHI,75,2,1069,105,223,.471,0,0,,105,223,.471,.471,51,81,.630,106,149,255,15,23,62,38,129,261
126,Dennis Johnson*\johnsde01,PG,31,BOS,78,78,2732,482,1060,.455,6,42,.143,476,1018,.468,.458,243,297,.818,69,199,268,456,110,35,173,206,1213
127,Eddie Johnson\johnsed03,SF,26,SAC,82,30,2514,623,1311,.475,4,20,.200,619,1291,.479,.477,280,343,.816,173,246,419,214,54,17,191,237,1530
128,Eddie Johnson\johnsed02,SG,30,TOT,71,9,1477,284,621,.457,29,85,.341,255,536,.476,.481,112,155,.723,30,91,121,333,18,2,150,128,709
128,Eddie Johnson\johnsed02,SG,30,ATL,39,5,862,155,328,.473,5,20,.250,150,308,.487,.480,79,110,.718,17,58,75,219,10,1,90,72,394
128,Eddie Johnson\johnsed02,SG,30,CLE,32,4,615,129,293,.440,24,65,.369,105,228,.461,.481,33,45,.733,13,33,46,114,8,1,60,56,315
129,Frank Johnson\johnsfr01,PG,27,WSB,14,9,402,69,154,.448,0,3,.000,69,151,.457,.448,38,54,.704,7,21,28,76,11,1,29,30,176
130,George Johnson\johnsge02,C,37,SEA,41,0,264,12,23,.522,0,0,,12,23,.522,.522,11,16,.688,26,34,60,13,6,37,14,46,35
131,George Johnson\johnsge03,PF,29,WSB,2,0,7,1,3,.333,0,0,,1,3,.333,.333,2,2,1.000,1,1,2,0,0,0,1,1,4
132,Ken Johnson\johnske01,PF,23,POR,64,0,815,113,214,.528,0,0,,113,214,.528,.528,37,85,.435,90,153,243,19,13,22,59,147,263
133,Magic Johnson*\johnsma02,PG,26,LAL,72,70,2578,483,918,.526,10,43,.233,473,875,.541,.532,378,434,.871,85,341,426,907,113,16,273,133,1354
134,Marques Johnson\johnsma01,SG,29,LAC,75,75,2605,613,1201,.510,1,15,.067,612,1186,.516,.511,298,392,.760,156,260,416,283,107,50,183,214,1525
135,Mickey Johnson\johnsmi01,PF,33,NJN,79,4,1574,214,507,.422,5,24,.208,209,483,.433,.427,183,233,.785,98,234,332,217,67,25,165,248,616
136,Steve Johnson\johnsst03,C,28,SAS,71,55,1828,362,573,.632,0,0,,362,573,.632,.632,259,373,.694,143,319,462,95,44,66,191,291,983
137,Vinnie Johnson\johnsvi01,SG,29,DET,79,12,1978,465,996,.467,2,13,.154,463,983,.471,.468,165,214,.771,119,107,226,269,80,23,88,180,1097
138,Bobby Jones\jonesbo01,PF,34,PHI,70,42,1519,189,338,.559,0,1,.000,189,337,.561,.559,114,145,.786,49,120,169,126,48,50,90,159,492
139,Caldwell Jones\jonesca01,C,35,POR,80,19,1437,126,254,.496,0,7,.000,126,247,.510,.496,124,150,.827,105,250,355,74,38,61,102,244,376
140,Charles Jones\jonesch01,C,28,WSB,81,58,1609,129,254,.508,0,1,.000,129,253,.510,.508,54,86,.628,122,199,321,76,57,133,71,235,312
141,Charles Jones\jonesch02,PF,24,PHO,43,18,742,75,164,.457,0,1,.000,75,163,.460,.457,50,98,.510,65,128,193,52,32,25,57,87,200
142,Earl Jones\jonesea01,C,25,MIL,12,0,43,5,12,.417,0,0,,5,12,.417,.417,3,4,.750,4,6,10,4,0,1,7,13,13
143,Edgar Jones\jonesed01,PF,29,CLE,53,6,1011,187,370,.505,7,23,.304,180,347,.519,.515,132,178,.742,71,136,207,45,30,38,64,142,513
144,Ozell Jones\jonesoz01,C,25,LAC,3,0,18,0,2,.000,0,0,,0,2,.000,.000,0,0,,0,2,2,0,2,1,3,5,0
145,Michael Jordan*\jordami01,SG,22,CHI,18,7,451,150,328,.457,3,18,.167,147,310,.474,.462,105,125,.840,23,41,64,53,37,21,45,46,408
146,Yvon Joseph\josepyv01,C,28,NJN,1,0,5,0,0,,0,0,,0,0,,,2,2,1.000,0,0,0,0,0,0,0,1,2
147,Harold Keeling\keeliha01,SG,22,DAL,20,0,75,17,39,.436,0,0,,17,39,.436,.436,10,14,.714,3,3,6,10,7,0,7,9,44
148,Rich Kelley\kelleri01,C,32,SAC,37,0,324,28,49,.571,0,2,.000,28,47,.596,.571,18,22,.818,29,52,81,43,10,3,22,62,74
149,Clark Kellogg\kellocl01,PF,24,IND,19,12,568,139,294,.473,4,13,.308,135,281,.480,.480,53,69,.768,51,117,168,57,28,8,61,59,335
150,Jerome Kersey\kerseje01,SF,23,POR,79,2,1217,258,470,.549,0,6,.000,258,464,.556,.549,156,229,.681,137,156,293,83,85,32,113,208,672
151,Albert King\kingal01,SF,26,NJN,73,69,1998,438,961,.456,4,23,.174,434,938,.463,.458,167,203,.823,116,250,366,181,58,24,181,205,1047
152,Greg Kite\kitegr01,C,24,BOS,64,2,464,34,91,.374,0,1,.000,34,90,.378,.374,15,39,.385,35,93,128,17,3,28,32,81,83
153,Joe Kleine\kleinjo01,C,24,SAC,80,18,1180,160,344,.465,0,0,,160,344,.465,.465,94,130,.723,113,260,373,46,24,34,107,224,414
154,Jon Koncak\koncajo01,C,22,ATL,82,15,1695,263,519,.507,0,1,.000,263,518,.508,.507,156,257,.607,171,296,467,55,37,69,111,296,682
155,Mitch Kupchak\kupchmi01,PF,31,LAL,55,0,783,124,257,.482,0,1,.000,124,256,.484,.482,84,112,.750,69,122,191,17,12,7,64,102,332
156,Bill Laimbeer\laimbbi01,C,28,DET,82,82,2891,545,1107,.492,4,14,.286,541,1093,.495,.494,266,319,.834,305,770,1075,146,59,65,133,291,1360
157,Jeff Lamp\lampje01,SF,26,TOT,74,2,1321,245,514,.477,7,30,.233,238,484,.492,.483,111,133,.835,53,147,200,117,39,4,68,155,608
157,Jeff Lamp\lampje01,SF,26,MIL,44,1,701,109,243,.449,3,13,.231,106,230,.461,.455,55,64,.859,34,87,121,64,20,3,30,88,276
157,Jeff Lamp\lampje01,SF,26,SAS,30,1,620,136,271,.502,4,17,.235,132,254,.520,.509,56,69,.812,19,60,79,53,19,1,38,67,332
158,Allen Leavell\leaveal01,PG,28,HOU,74,12,1190,212,458,.463,24,67,.358,188,391,.481,.489,135,158,.854,6,61,67,234,58,8,88,126,583
159,Keith Lee\leeke01,PF,23,CLE,58,38,1197,177,380,.466,2,9,.222,175,371,.472,.468,75,96,.781,116,235,351,67,29,37,78,204,431
160,Ronnie Lester\lestero01,PG,27,LAL,27,0,222,26,52,.500,0,3,.000,26,49,.531,.500,15,19,.789,0,10,10,54,9,3,42,27,67
161,Fat Lever\leverfa01,PG,25,DEN,78,77,2616,468,1061,.441,12,38,.316,456,1023,.446,.447,132,182,.725,136,284,420,584,178,15,210,204,1080
162,Cliff Levingston\levincl01,PF,25,ATL,81,35,1945,294,551,.534,0,1,.000,294,550,.535,.534,164,242,.678,193,341,534,72,76,39,113,260,752
163,Alton Lister\listeal01,C,27,MIL,81,19,1812,318,577,.551,0,2,.000,318,575,.553,.551,160,266,.602,199,393,592,101,49,142,161,300,796
164,Lewis Lloyd\lloydle01,SG,26,HOU,82,82,2444,592,1119,.529,3,15,.200,589,1104,.534,.530,199,236,.843,155,169,324,300,102,24,194,216,1386
165,John Long\longjo01,SG,29,DET,62,30,1176,264,548,.482,3,16,.188,261,532,.491,.484,89,104,.856,47,51,98,82,41,13,59,92,620
166,John Lucas\lucasjo01,PG,32,HOU,65,65,2120,365,818,.446,45,146,.308,320,672,.476,.474,231,298,.775,33,110,143,571,77,5,149,124,1006
167,Maurice Lucas\lucasma01,PF,33,LAL,77,8,1750,302,653,.462,1,2,.500,301,651,.462,.463,180,230,.783,164,402,566,84,45,24,121,253,785
168,Kyle Macy\macyky01,PG,28,CHI,82,79,2426,286,592,.483,58,141,.411,228,451,.506,.532,73,90,.811,41,137,178,446,81,11,117,201,703
169,Rick Mahorn\mahorri01,PF,27,DET,80,12,1442,157,345,.455,0,1,.000,157,344,.456,.455,81,119,.681,121,291,412,64,40,61,109,261,395
170,Jeff Malone\malonje01,SG,24,WSB,80,80,2992,735,1522,.483,3,17,.176,732,1505,.486,.484,322,371,.868,66,222,288,191,70,12,168,180,1795
171,Karl Malone*\malonka01,PF,22,UTA,81,76,2475,504,1016,.496,0,2,.000,504,1014,.497,.496,195,405,.481,174,544,718,236,105,44,279,295,1203
172,Moses Malone*\malonmo01,C,30,PHI,74,74,2706,571,1246,.458,0,1,.000,571,1245,.459,.458,617,784,.787,339,533,872,90,67,71,261,194,1759
173,Pace Mannion\mannipa01,SF,25,UTA,57,0,673,97,214,.453,8,42,.190,89,172,.517,.472,53,82,.646,26,56,82,55,32,5,41,68,255
174,Bill Martin\martibi01,SF,23,IND,66,0,691,143,298,.480,0,8,.000,143,290,.493,.480,46,54,.852,42,60,102,52,21,7,58,108,332
175,Brian Martin\martibr01,SF-PF,23,TOT,8,0,21,3,7,.429,0,0,,3,7,.429,.429,0,2,.000,1,3,4,0,0,1,2,7,6
175,Brian Martin\martibr01,PF,23,SEA,3,0,7,1,2,.500,0,0,,1,2,.500,.500,0,0,,1,3,4,0,0,1,2,2,2
175,Brian Martin\martibr01,SF,23,POR,5,0,14,2,5,.400,0,0,,2,5,.400,.400,0,2,.000,0,0,0,0,0,0,0,5,4
176,Wes Matthews\matthwe01,PG,26,SAS,75,46,1853,320,603,.531,4,25,.160,316,578,.547,.534,173,211,.820,30,101,131,476,87,32,232,168,817
177,Cedric Maxwell\maxwece01,SF,30,LAC,76,72,2458,314,661,.475,0,3,.000,314,658,.477,.475,447,562,.795,241,383,624,215,61,29,206,252,1075
178,Bob McAdoo*\mcadobo01,C,34,PHI,29,0,609,116,251,.462,0,0,,116,251,.462,.462,62,81,.765,25,78,103,35,10,18,49,64,294
179,Dwayne McClain\mccladw01,SF,22,IND,45,4,461,69,180,.383,1,9,.111,68,171,.398,.386,18,35,.514,14,16,30,67,38,4,40,61,157
180,Tim McCormick\mccorti01,C,23,SEA,77,42,1705,253,444,.570,1,2,.500,252,442,.570,.571,174,244,.713,140,263,403,83,19,28,110,219,681
181,Rodney McCray\mccraro01,SF,24,HOU,82,82,2610,338,629,.537,0,3,.000,338,626,.540,.537,171,222,.770,159,361,520,292,50,58,130,197,847
182,Xavier McDaniel\mcdanxa01,SF,22,SEA,82,80,2706,576,1176,.490,2,10,.200,574,1166,.492,.491,250,364,.687,307,348,655,193,101,37,248,305,1404
183,Ben McDonald\mcdonbe01,SF,23,CLE,21,0,266,28,58,.483,0,1,.000,28,57,.491,.483,5,8,.625,15,23,38,9,7,1,10,30,61
184,Hank McDowell\mcdowha01,PF,26,HOU,22,0,204,24,42,.571,0,1,.000,24,41,.585,.571,17,25,.680,12,37,49,6,1,3,10,25,65
185,Mike McGee\mcgeemi01,SF,26,LAL,71,19,1213,252,544,.463,41,114,.360,211,430,.491,.501,42,64,.656,51,89,140,83,53,7,70,131,587
186,Kevin McHale*\mchalke01,PF,28,BOS,68,62,2397,561,978,.574,0,0,,561,978,.574,.574,326,420,.776,171,380,551,181,29,134,149,192,1448
187,Kevin McKenna\mckenke01,SG,27,WSB,30,1,430,61,166,.367,27,75,.360,34,91,.374,.449,25,30,.833,9,27,36,23,29,2,18,54,174
188,Billy McKinney\mckinbi01,PG,30,CHI,9,0,83,10,23,.435,0,0,,10,23,.435,.435,2,2,1.000,1,4,5,13,3,0,2,9,22
189,Tom McMillen\mcmilto01,C,33,WSB,56,1,863,131,285,.460,0,3,.000,131,282,.465,.460,64,79,.810,44,69,113,35,9,10,34,85,326
190,Chris McNealy\mcneach01,PF,24,NYK,30,6,627,70,144,.486,0,0,,70,144,.486,.486,31,47,.660,62,141,203,41,38,12,35,88,171
191,Dirk Minniefield\minnidi01,PG,25,CLE,76,2,1131,167,347,.481,10,37,.270,157,310,.506,.496,73,93,.785,43,88,131,269,65,1,108,165,417
192,Mike Mitchell\mitchmi01,SF,30,SAS,82,82,2970,802,1697,.473,0,12,.000,802,1685,.476,.473,317,392,.809,134,275,409,188,56,25,184,175,1921
193,Paul Mokeski\mokespa01,C,29,MIL,45,0,521,59,139,.424,0,0,,59,139,.424,.424,25,34,.735,36,103,139,30,6,6,25,92,143
194,Sidney Moncrief\moncrsi01,PG,28,MIL,73,72,2567,470,962,.489,33,103,.320,437,859,.509,.506,498,580,.859,115,219,334,357,103,18,174,178,1471
195,Johnny Moore\moorejo01,PG,27,SAS,28,23,856,150,303,.495,4,22,.182,146,281,.520,.502,59,86,.686,25,61,86,252,70,6,81,78,363
196,Perry Moss\mosspe01,PG,27,TOT,72,0,1012,116,292,.397,7,32,.219,109,260,.419,.409,65,89,.730,34,81,115,108,56,15,79,132,304
196,Perry Moss\mosspe01,PG,27,WSB,12,0,160,21,53,.396,2,7,.286,19,46,.413,.415,11,15,.733,9,16,25,19,6,3,18,26,55
196,Perry Moss\mosspe01,PG,27,PHI,60,0,852,95,239,.397,5,25,.200,90,214,.421,.408,54,74,.730,25,65,90,89,50,12,61,106,249
197,Chris Mullin*\mullich01,SG,22,GSW,55,30,1391,287,620,.463,5,27,.185,282,593,.476,.467,189,211,.896,42,73,115,105,70,23,75,130,768
198,Jay Murphy\murphja01,SF,23,LAC,14,0,100,16,45,.356,0,2,.000,16,43,.372,.356,9,14,.643,7,8,15,3,4,3,5,12,41
199,Larry Nance\nancela01,PF,26,PHO,73,69,2484,582,1001,.581,0,8,.000,582,993,.586,.581,310,444,.698,169,449,618,240,70,130,210,247,1474
200,Calvin Natt\nattca01,PF,29,DEN,69,62,2007,469,930,.504,2,6,.333,467,924,.505,.505,278,347,.801,125,311,436,164,58,13,130,143,1218
201,Chuck Nevitt\nevitch01,C,26,TOT,29,0,126,15,43,.349,0,0,,15,43,.349,.349,19,26,.731,13,19,32,7,4,19,12,35,49
201,Chuck Nevitt\nevitch01,C,26,LAL,4,0,25,3,11,.273,0,0,,3,11,.273,.273,4,6,.667,3,4,7,2,2,2,5,6,10
201,Chuck Nevitt\nevitch01,C,26,DET,25,0,101,12,32,.375,0,0,,12,32,.375,.375,15,20,.750,10,15,25,5,2,17,7,29,39
202,Kurt Nimphius\nimphku01,PF,27,TOT,80,66,2226,351,694,.506,0,3,.000,351,691,.508,.506,194,262,.740,152,301,453,62,33,105,120,267,896
202,Kurt Nimphius\nimphku01,PF,27,DAL,13,4,280,37,72,.514,0,1,.000,37,71,.521,.514,17,29,.586,23,37,60,14,3,12,13,38,91
202,Kurt Nimphius\nimphku01,PF,27,LAC,67,62,1946,314,622,.505,0,2,.000,314,620,.506,.505,177,233,.760,129,264,393,48,30,93,107,229,805
203,Norm Nixon\nixonno01,PG,30,LAC,67,62,2138,403,921,.438,42,121,.347,361,800,.451,.460,131,162,.809,45,135,180,576,84,3,190,143,979
204,Mike O'Koren\okoremi01,SF,27,NJN,67,11,1031,160,336,.476,7,27,.259,153,309,.495,.487,23,39,.590,33,102,135,118,29,9,54,134,350
205,Charles Oakley\oaklech01,PF,22,CHI,77,30,1772,281,541,.519,0,3,.000,281,538,.522,.519,178,269,.662,255,409,664,133,68,30,175,250,740
206,Hakeem Olajuwon*\olajuha01,C,23,HOU,68,68,2467,625,1188,.526,0,0,,625,1188,.526,.526,347,538,.645,333,448,781,137,134,231,195,271,1597
207,Mark Olberding\olberma01,PF,29,SAC,81,64,2157,225,403,.558,0,2,.000,225,401,.561,.558,162,210,.771,113,310,423,266,43,23,148,276,612
208,Jawann Oldham\oldhaja01,C,28,CHI,52,47,1276,167,323,.517,0,1,.000,167,322,.519,.517,53,91,.582,112,194,306,37,28,134,86,206,387
209,Louis Orr\orrlo01,SF,27,NYK,74,64,2237,330,741,.445,0,4,.000,330,737,.448,.445,218,278,.784,123,189,312,179,61,26,118,177,878
210,Robert Parish*\parisro01,C,32,BOS,81,80,2567,530,966,.549,0,0,,530,966,.549,.549,245,335,.731,246,524,770,145,65,116,187,215,1305
211,Jim Paxson\paxsoji02,SG,28,POR,75,31,1931,372,792,.470,20,62,.323,352,730,.482,.482,217,244,.889,42,106,148,278,94,5,112,156,981
212,John Paxson\paxsojo01,PG,25,CHI,75,3,1570,153,328,.466,15,50,.300,138,278,.496,.489,74,92,.804,18,76,94,274,55,2,63,172,395
213,Sam Perkins\perkisa01,PF,24,DAL,80,79,2626,458,910,.503,11,33,.333,447,877,.510,.509,307,377,.814,195,490,685,153,75,94,145,212,1234
214,Jim Petersen\peterji01,PF,23,HOU,82,20,1664,196,411,.477,0,3,.000,196,408,.480,.477,113,160,.706,149,247,396,85,38,54,84,231,505
215,Michael Phelps\phelpmi01,SG,24,SEA,70,18,880,117,286,.409,1,12,.083,116,274,.423,.411,44,74,.595,29,60,89,71,45,1,62,86,279
216,Ricky Pierce\piercri01,SG,26,MIL,81,8,2147,429,798,.538,3,23,.130,426,775,.550,.539,266,310,.858,94,137,231,177,83,6,107,252,1127
217,Ed Pinckney\pincked01,SF,22,PHO,80,24,1602,255,457,.558,0,2,.000,255,455,.560,.558,171,254,.673,95,213,308,90,71,37,148,190,681
218,Charles Pittman\pittmch01,PF,27,PHO,69,17,1132,127,218,.583,0,0,,127,218,.583,.583,99,141,.702,99,147,246,58,37,23,107,140,353
219,David Pope\popeda01,SF,23,SEA,11,0,74,9,20,.450,1,1,1.000,8,19,.421,.475,2,4,.500,6,5,11,4,2,1,2,11,21
220,Ben Poquette\poquebe01,PF,30,CLE,81,3,1496,166,348,.477,2,10,.200,164,338,.485,.480,72,100,.720,121,252,373,78,33,32,68,187,406
221,Terry Porter\portete01,PG,22,POR,79,3,1214,212,447,.474,13,42,.310,199,405,.491,.489,125,155,.806,35,82,117,198,81,1,106,136,562
222,Paul Pressey\presspa01,SF,27,MIL,80,80,2704,411,843,.488,8,44,.182,403,799,.504,.492,316,392,.806,127,272,399,623,168,71,240,247,1146
223,Kurt Rambis\rambiku01,PF,27,LAL,74,74,1573,160,269,.595,0,0,,160,269,.595,.595,88,122,.721,156,361,517,69,66,33,97,198,408
224,Kelvin Ransey\ranseke01,PG,27,NJN,79,15,1504,231,505,.457,3,24,.125,228,481,.474,.460,121,148,.818,34,82,116,252,51,4,114,128,586
225,Blair Rasmussen\rasmubl01,C,23,DEN,48,1,330,61,150,.407,0,0,,61,150,.407,.407,31,39,.795,37,60,97,16,3,10,40,63,153
226,Robert Reid\reidro01,SF,30,HOU,82,5,2157,409,881,.464,6,33,.182,403,848,.475,.468,162,214,.757,67,234,301,222,91,16,96,231,986
227,Jerry Reynolds\reynoje01,SF,23,MIL,55,8,508,72,162,.444,1,2,.500,71,160,.444,.448,58,104,.558,37,43,80,86,43,19,52,57,203
228,Clint Richardson\richacl01,SG,29,IND,82,61,2224,335,736,.455,1,9,.111,334,727,.459,.456,123,147,.837,69,182,251,372,58,8,136,153,794
229,Micheal Ray Richardson\richami01,PG,30,NJN,47,39,1604,296,661,.448,4,27,.148,292,634,.461,.451,141,179,.788,77,173,250,340,125,11,150,163,737
230,Doc Rivers\riverdo01,PG,24,ATL,53,50,1571,220,464,.474,0,16,.000,220,448,.491,.474,172,283,.608,49,113,162,443,120,13,141,185,612
231,Fred Roberts\roberfr01,PF,25,UTA,58,0,469,74,167,.443,1,2,.500,73,165,.442,.446,67,87,.770,31,49,80,27,8,6,53,72,216
232,Alvin Robertson\roberal01,SG,23,SAS,82,82,2878,562,1093,.514,8,29,.276,554,1064,.521,.518,260,327,.795,184,332,516,448,301,40,256,296,1392
233,Rick Robey\robeyri01,C,30,PHO,46,1,629,72,191,.377,0,3,.000,72,188,.383,.377,33,48,.688,40,108,148,58,19,5,66,92,177
234,Cliff Robinson\robincl01,SF,25,WSB,78,78,2563,595,1255,.474,1,4,.250,594,1251,.475,.475,269,353,.762,180,500,680,186,98,44,206,217,1460
235,Tree Rollins\rollitr01,C,30,ATL,74,61,1781,173,347,.499,0,1,.000,173,346,.500,.499,69,90,.767,131,327,458,41,38,167,91,239,415
236,Dan Roundfield\roundda01,PF,32,WSB,79,21,2321,322,660,.488,0,6,.000,322,654,.492,.488,273,362,.754,210,432,642,167,36,51,187,194,917
237,Derrick Rowland\rowlade01,SG,26,MIL,2,0,9,1,3,.333,0,0,,1,3,.333,.333,1,2,.500,0,1,1,1,0,0,0,1,3
238,Jeff Ruland\rulanje01,PF,27,WSB,30,24,1114,212,383,.554,0,4,.000,212,379,.559,.554,145,200,.725,107,213,320,159,23,25,121,100,569
239,Walker Russell\russewa01,PG,25,DET,1,0,2,0,1,.000,0,0,,0,1,.000,.000,0,0,,0,0,0,1,0,0,0,0,0
240,Ralph Sampson*\sampsra01,PF,25,HOU,79,76,2864,624,1280,.488,2,15,.133,622,1265,.492,.488,241,376,.641,258,621,879,283,99,129,285,308,1491
241,Mike Sanders\sandemi01,SF,25,PHO,82,5,1644,347,676,.513,3,15,.200,344,661,.520,.516,208,257,.809,104,169,273,150,76,31,143,236,905
242,Danny Schayes\schayda01,C,26,DEN,80,13,1654,221,440,.502,0,1,.000,221,439,.503,.502,216,278,.777,154,285,439,79,42,63,105,298,658
243,Detlef Schrempf\schrede01,SF,23,DAL,64,12,969,142,315,.451,3,7,.429,139,308,.451,.456,110,152,.724,70,128,198,88,23,10,84,166,397
244,Byron Scott\scottby01,SG,24,LAL,76,62,2190,507,989,.513,22,61,.361,485,928,.523,.524,138,176,.784,55,134,189,164,85,15,110,167,1174
245,Carey Scurry\scurrca01,SF,23,UTA,78,0,1168,142,301,.472,1,11,.091,141,290,.486,.473,78,126,.619,97,145,242,85,78,66,96,171,363
246,Lonnie Shelton\sheltlo01,PF,30,CLE,44,1,682,92,188,.489,0,2,.000,92,186,.495,.489,14,16,.875,38,105,143,61,21,4,48,128,198
247,Purvis Short\shortpu01,SF,28,GSW,64,63,2427,633,1313,.482,15,49,.306,618,1264,.489,.488,351,406,.865,126,203,329,237,92,22,184,229,1632
248,Jerry Sichting\sichtje01,PG,29,BOS,82,7,1596,235,412,.570,6,16,.375,229,396,.578,.578,61,66,.924,27,77,104,188,50,0,73,118,537
249,Jack Sikma\sikmaja01,C,30,SEA,80,78,2790,508,1100,.462,0,13,.000,508,1087,.467,.462,355,411,.864,146,602,748,301,92,73,214,293,1371
250,Derek Smith\smithde02,SG,24,LAC,11,9,339,100,181,.552,1,2,.500,99,179,.553,.555,58,84,.690,20,21,41,31,9,13,33,35,259
251,Larry Smith\smithla01,PF,28,GSW,77,74,2441,314,586,.536,0,1,.000,314,585,.537,.536,112,227,.493,384,472,856,95,62,50,135,286,740
252,Mike Smrek\smrekmi01,C,23,CHI,38,5,408,46,122,.377,0,2,.000,46,120,.383,.377,16,29,.552,46,64,110,19,6,23,29,95,108
253,Ricky Sobers\soberri01,SG,33,SEA,78,0,1279,240,541,.444,13,43,.302,227,498,.456,.456,110,125,.880,29,70,99,180,44,2,85,139,603
254,Rory Sparrow\sparrro01,PG,27,NYK,74,74,2344,345,723,.477,5,20,.250,340,703,.484,.481,101,127,.795,50,120,170,472,85,14,154,182,796
255,Larry Spriggs\sprigla01,SF,26,LAL,43,7,471,88,192,.458,0,1,.000,88,191,.461,.458,38,49,.776,28,53,81,49,18,9,54,78,214
256,Terence Stansbury\stanste01,SG,24,IND,74,17,1331,191,441,.433,9,53,.170,182,388,.469,.443,107,132,.811,29,110,139,206,59,8,139,200,498
257,Steve Stipanovich\stipast01,C,25,IND,79,65,2397,416,885,.470,2,10,.200,414,875,.473,.471,242,315,.768,173,450,623,206,75,69,146,261,1076
258,Alex Stivrins\stivral01,SF,23,SEA,3,0,14,1,4,.250,0,0,,1,4,.250,.250,1,4,.250,3,0,3,1,0,0,3,2,3
259,John Stockton*\stockjo01,PG,23,UTA,82,38,1935,228,466,.489,2,15,.133,226,451,.501,.491,172,205,.839,33,146,179,610,157,10,168,227,630
260,Greg Stokes\stokegr01,PF,22,PHI,31,13,350,56,119,.471,0,1,.000,56,118,.475,.471,14,21,.667,27,30,57,17,14,11,19,56,126
261,Jon Sundvold\sundvjo01,PG,24,SAS,70,4,1150,220,476,.462,21,60,.350,199,416,.478,.484,39,48,.813,22,58,80,261,34,0,85,110,500
262,Terry Teagle\teaglte01,SG,25,GSW,82,52,2158,475,958,.496,4,25,.160,471,933,.505,.498,211,265,.796,96,139,235,115,71,34,136,241,1165
263,Reggie Theus\theusre01,SG,28,SAC,82,82,2919,546,1137,.480,6,35,.171,540,1102,.490,.483,405,490,.827,73,231,304,788,112,20,327,231,1503
264,Peter Thibeaux\thibepe01,SF,24,GSW,42,8,531,100,233,.429,2,5,.400,98,228,.430,.433,29,48,.604,28,47,75,28,23,15,39,82,231
265,David Thirdkill\thirdda01,PF,25,BOS,49,0,385,54,110,.491,0,1,.000,54,109,.495,.491,55,88,.625,27,43,70,15,11,3,19,55,163
266,Isiah Thomas*\thomais01,PG,24,DET,77,77,2790,609,1248,.488,26,84,.310,583,1164,.501,.498,365,462,.790,83,194,277,830,171,20,289,245,1609
267,Jim Thomas\thomaji01,SG,25,LAC,6,0,69,6,15,.400,0,0,,6,15,.400,.400,1,2,.500,3,5,8,12,5,1,9,12,13
268,Bernard Thompson\thompbe01,SG,23,PHO,61,20,1281,195,399,.489,0,2,.000,195,397,.491,.489,127,157,.809,58,83,141,132,51,10,90,151,517
269,LaSalle Thompson\thompla01,C,24,SAC,80,64,2377,411,794,.518,0,1,.000,411,793,.518,.518,202,276,.732,252,518,770,168,71,109,184,295,1024
270,Mychal Thompson\thompmy01,C,31,POR,82,78,2569,503,1011,.498,0,0,,503,1011,.498,.498,198,309,.641,181,427,608,176,76,35,196,267,1204
271,Paul Thompson\thomppa01,SF,24,PHI,23,8,432,70,194,.361,2,12,.167,68,182,.374,.366,37,43,.860,27,36,63,24,15,17,30,49,179
272,Bob Thornton\thornbo01,PF,23,NYK,71,23,1323,125,274,.456,0,0,,125,274,.456,.456,86,162,.531,113,177,290,43,30,7,83,209,336
273,Otis Thorpe\thorpot01,PF,23,SAC,75,18,1675,289,492,.587,0,0,,289,492,.587,.587,164,248,.661,137,283,420,84,35,34,123,233,742
274,Sedale Threatt\threase01,SG,24,PHI,70,27,1754,310,684,.453,1,24,.042,309,660,.468,.454,75,90,.833,21,100,121,193,93,5,102,157,696
275,Wayman Tisdale\tisdawa01,PF,21,IND,81,60,2277,516,1002,.515,0,2,.000,516,1000,.516,.515,160,234,.684,191,393,584,79,32,44,188,290,1192
276,Andrew Toney\toneyan01,SG,28,PHI,6,0,84,11,36,.306,0,2,.000,11,34,.324,.306,3,8,.375,2,3,5,12,2,0,7,8,25
277,Sedric Toney\toneyse01,PG,23,TOT,13,0,230,28,66,.424,3,10,.300,25,56,.446,.447,21,31,.677,3,22,25,26,6,0,22,24,80
277,Sedric Toney\toneyse01,PG,23,ATL,3,0,24,2,7,.286,0,0,,2,7,.286,.286,1,1,1.000,0,2,2,0,1,0,3,6,5
277,Sedric Toney\toneyse01,PG,23,PHO,10,0,206,26,59,.441,3,10,.300,23,49,.469,.466,20,30,.667,3,20,23,26,5,0,19,18,75
278,Kelly Tripucka\tripuke01,SF,26,DET,81,81,2626,615,1236,.498,12,25,.480,603,1211,.498,.502,380,444,.856,116,232,348,265,93,10,183,167,1622
279,Trent Tucker\tucketr01,SG,26,NYK,77,23,1788,349,740,.472,41,91,.451,308,649,.475,.499,79,100,.790,70,99,169,192,65,8,70,167,818
280,Elston Turner\turneel01,SG,26,DEN,73,0,1324,165,379,.435,0,9,.000,165,370,.446,.435,39,53,.736,64,137,201,165,70,6,80,150,369
281,Jeff Turner\turneje01,PF,23,NJN,53,1,650,84,171,.491,0,1,.000,84,170,.494,.491,58,78,.744,45,92,137,14,21,3,49,125,226
282,Melvin Turpin\turpime01,C,25,CLE,80,69,2292,456,838,.544,0,4,.000,456,834,.547,.544,185,228,.811,182,374,556,55,65,106,134,260,1097
283,Terry Tyler\tylerte01,SF,29,SAC,71,52,1651,295,649,.455,0,3,.000,295,646,.457,.455,84,112,.750,109,204,313,94,64,108,94,159,674
284,Darnell Valentine\valenda01,PG,26,TOT,62,29,1217,161,388,.415,4,14,.286,157,374,.420,.420,130,175,.743,32,93,125,246,72,2,115,123,456
284,Darnell Valentine\valenda01,PG,26,POR,28,27,734,92,206,.447,1,3,.333,91,203,.448,.449,71,100,.710,20,52,72,139,49,1,58,78,256
284,Darnell Valentine\valenda01,PG,26,LAC,34,2,483,69,182,.379,3,11,.273,66,171,.386,.387,59,75,.787,12,41,53,107,23,1,57,45,200
285,Kiki Vandeweghe\vandeki01,SF,27,POR,79,76,2791,719,1332,.540,1,8,.125,718,1324,.542,.540,523,602,.869,92,124,216,187,54,17,177,161,1962
286,Nick Vanos\vanosni01,C,22,PHO,11,0,202,23,72,.319,0,0,,23,72,.319,.319,8,23,.348,21,39,60,16,2,5,20,34,54
287,Pete Verhoeven\verhope01,PF,26,GSW,61,5,749,90,167,.539,1,2,.500,89,165,.539,.542,25,43,.581,65,95,160,29,29,17,30,141,206
288,Jay Vincent\vinceja01,PF,26,DAL,80,3,1994,442,919,.481,0,3,.000,442,916,.483,.481,222,274,.810,107,261,368,180,66,21,145,193,1106
289,Sam Vincent\vincesa01,SG,22,BOS,57,0,432,59,162,.364,1,4,.250,58,158,.367,.367,65,70,.929,11,37,48,69,17,4,49,59,184
290,Danny Vranes\vraneda01,SF,27,SEA,80,19,1569,131,284,.461,0,4,.000,131,280,.468,.461,39,75,.520,115,166,281,68,63,31,58,218,301
291,Granville Waiters\waitegr01,C,25,HOU,43,0,156,13,39,.333,0,1,.000,13,38,.342,.333,1,6,.167,15,13,28,8,4,10,11,30,27
292,Darrell Walker\walkeda01,PG,24,NYK,81,35,2023,324,753,.430,0,10,.000,324,743,.436,.430,190,277,.686,100,120,220,337,146,36,192,216,838
293,Bill Walton*\waltobi01,C,33,BOS,80,2,1546,231,411,.562,0,0,,231,411,.562,.562,144,202,.713,136,408,544,165,38,106,151,210,606
294,Bryan Warrick\warribr01,PG,26,TOT,36,5,685,85,182,.467,3,12,.250,82,170,.482,.475,54,68,.794,10,59,69,115,27,2,53,79,227
294,Bryan Warrick\warribr01,PG,26,MIL,5,0,27,4,10,.400,1,2,.500,3,8,.375,.450,1,1,1.000,0,3,3,6,2,0,5,3,10
294,Bryan Warrick\warribr01,PG,26,IND,31,5,658,81,172,.471,2,10,.200,79,162,.488,.477,53,67,.791,10,56,66,109,25,2,48,76,217
295,Spud Webb\webbsp01,PG,22,ATL,79,8,1229,199,412,.483,2,11,.182,197,401,.491,.485,216,275,.785,27,96,123,337,82,5,159,164,616
296,Scott Wedman\wedmasc01,SF,33,BOS,79,19,1402,286,605,.473,17,48,.354,269,557,.483,.487,45,68,.662,66,126,192,83,38,22,54,127,634
297,Bill Wennington\wennibi01,C,22,DAL,56,3,562,72,153,.471,0,4,.000,72,149,.483,.471,45,62,.726,32,100,132,21,11,22,21,83,189
298,Mark West\westma01,C,25,CLE,67,26,1172,113,209,.541,0,0,,113,209,.541,.541,54,103,.524,97,225,322,20,27,62,91,235,280
299,Ennis Whatley\whatlen01,PG,23,TOT,14,1,107,15,35,.429,0,0,,15,35,.429,.429,5,10,.500,4,10,14,23,5,1,10,10,35
299,Ennis Whatley\whatlen01,PG,23,CLE,8,0,66,9,19,.474,0,0,,9,19,.474,.474,4,7,.571,2,5,7,13,5,0,6,8,22
299,Ennis Whatley\whatlen01,PG,23,WSB,4,0,27,5,14,.357,0,0,,5,14,.357,.357,1,3,.333,2,5,7,7,0,1,0,1,11
299,Ennis Whatley\whatlen01,PG,23,SAS,2,1,14,1,2,.500,0,0,,1,2,.500,.500,0,0,,0,0,0,3,0,0,4,1,2
300,Rory White\whitero01,SF,26,LAC,75,30,1761,355,684,.519,1,9,.111,354,675,.524,.520,164,222,.739,82,99,181,74,74,8,95,161,875
301,Willie White\whitewi01,SG,23,DEN,43,4,343,74,168,.440,6,21,.286,68,147,.463,.458,19,23,.826,17,27,44,53,18,2,25,24,173
302,Jerome Whitehead\whiteje01,C,29,GSW,81,3,1079,126,294,.429,0,0,,126,294,.429,.429,60,97,.619,94,234,328,19,18,19,64,176,312
303,Mitchell Wiggins\wiggimi01,SG,26,HOU,78,0,1198,222,489,.454,1,12,.083,221,477,.463,.455,86,118,.729,87,72,159,101,59,5,62,155,531
304,Jamaal Wilkes*\wilkeja01,SF,32,LAC,13,1,195,26,65,.400,1,3,.333,25,62,.403,.408,22,27,.815,13,16,29,15,7,2,16,19,75
305,Dominique Wilkins*\wilkido01,SF,26,ATL,78,78,3049,888,1897,.468,13,70,.186,875,1827,.479,.472,577,705,.818,261,357,618,206,138,49,251,170,2366
306,Gerald Wilkins\wilkige01,SG,22,NYK,81,53,2025,437,934,.468,7,25,.280,430,909,.473,.472,132,237,.557,92,116,208,161,68,9,157,155,1013
307,Jeff Wilkins\wilkije01,C,30,TOT,75,4,1126,147,374,.393,0,0,,147,374,.393,.393,58,93,.624,74,198,272,46,11,21,52,157,352
307,Jeff Wilkins\wilkije01,C,30,UTA,48,0,604,96,240,.400,0,0,,96,240,.400,.400,30,47,.638,40,105,145,28,3,11,32,86,222
307,Jeff Wilkins\wilkije01,C,30,SAS,27,4,522,51,134,.381,0,0,,51,134,.381,.381,28,46,.609,34,93,127,18,8,10,20,71,130
308,Buck Williams\willibu01,PF,25,NJN,82,82,3070,500,956,.523,0,2,.000,500,954,.524,.523,301,445,.676,329,657,986,131,73,96,244,294,1301
309,Freeman Williams\willifr01,SG,29,WSB,9,0,110,25,67,.373,7,14,.500,18,53,.340,.425,12,17,.706,4,8,12,7,7,1,13,10,69
310,Gus Williams\willigu01,PG,32,WSB,77,67,2284,434,1013,.428,30,116,.259,404,897,.450,.443,138,188,.734,52,114,166,453,96,15,160,113,1036
311,Guy Williams\willigu02,PF,25,GSW,5,0,25,2,5,.400,0,0,,2,5,.400,.400,3,6,.500,0,6,6,0,1,2,0,7,7
312,Herb Williams\willihe01,C,27,IND,78,74,2770,627,1275,.492,1,12,.083,626,1263,.496,.492,294,403,.730,172,538,710,174,50,184,210,244,1549
313,Pete Williams\willipe01,PF,20,DEN,53,11,573,67,111,.604,0,0,,67,111,.604,.604,17,40,.425,47,99,146,14,19,23,19,68,151
314,Ray Williams\willira01,PG,31,TOT,47,21,827,117,306,.382,6,19,.316,111,287,.387,.392,115,126,.913,35,51,86,187,61,4,101,124,355
314,Ray Williams\willira01,PG,31,ATL,19,13,367,57,143,.399,4,11,.364,53,132,.402,.413,41,48,.854,19,26,45,67,28,1,41,48,159
314,Ray Williams\willira01,PG,31,SAS,23,8,397,50,131,.382,2,6,.333,48,125,.384,.389,62,64,.969,13,24,37,111,28,3,51,64,164
314,Ray Williams\willira01,PG,31,NJN,5,0,63,10,32,.313,0,2,.000,10,30,.333,.313,12,14,.857,3,1,4,9,5,0,9,12,32
315,Sly Williams\willisl01,SF,28,BOS,6,0,54,5,21,.238,0,4,.000,5,17,.294,.238,7,12,.583,7,8,15,2,1,1,7,15,17
316,Kevin Willis\willike02,PF,23,ATL,82,59,2300,419,811,.517,0,6,.000,419,805,.520,.517,172,263,.654,243,461,704,45,66,44,177,294,1010
317,Voise Winters\wintevo01,SF,23,PHI,4,0,17,3,13,.231,0,1,.000,3,12,.250,.231,0,0,,1,2,3,0,1,0,2,1,6
318,Randy Wittman\wittmra01,SG,26,ATL,81,79,2760,467,881,.530,5,16,.313,462,865,.534,.533,104,135,.770,51,119,170,306,81,14,114,118,1043
319,Al Wood\woodal01,SG,27,SEA,78,34,1749,355,817,.435,5,37,.135,350,780,.449,.438,187,239,.782,80,164,244,114,57,19,107,171,902
320,Leon Wood\woodle01,PG,23,TOT,68,1,1198,184,466,.395,41,114,.360,143,352,.406,.439,123,155,.794,25,65,90,182,34,0,74,70,532
320,Leon Wood\woodle01,PG,23,PHI,29,1,455,57,136,.419,13,29,.448,44,107,.411,.467,27,34,.794,9,18,27,75,14,0,7,24,154
320,Leon Wood\woodle01,PG,23,WSB,39,0,743,127,330,.385,28,85,.329,99,245,.404,.427,96,121,.793,16,47,63,107,20,0,67,46,378
321,Mike Woodson\woodsmi01,SG,27,SAC,81,51,2417,510,1073,.475,2,13,.154,508,1060,.479,.476,242,289,.837,94,132,226,197,92,37,145,215,1264
322,Orlando Woolridge\woolror01,SF,26,CHI,70,59,2248,540,1090,.495,4,23,.174,536,1067,.502,.497,364,462,.788,150,200,350,213,49,47,174,186,1448
323,James Worthy*\worthja01,SF,24,LAL,75,73,2454,629,1086,.579,0,13,.000,629,1073,.586,.579,242,314,.771,136,251,387,201,82,77,149,195,1500
324,Danny Young\youngda01,PG,23,SEA,82,29,1901,227,449,.506,24,74,.324,203,375,.541,.532,90,106,.849,29,91,120,303,110,9,92,113,568
325,Michael Young\youngmi01,SF,25,PHI,2,0,2,0,2,.000,0,0,,0,2,.000,.000,0,0,,0,0,0,0,0,0,0,0,0