
Rk,Player,Pos,Age,Tm,G,GS,MP,FG,FGA,FG%,3P,3PA,3P%,2P,2PA,2P%,eFG%,FT,FTA,FT%,ORB,DRB,TRB,AST,STL,BLK,TOV,PF,PTS
1,Kareem Abdul-Jabbar*\abdulka01,C,39,LAL,78,78,2441,560,993,.564,1,3,.333,559,990,.565,.564,245,343,.714,152,371,523,203,49,97,186,245,1366
2,Alvan Adams\adamsal01,C,32,PHO,68,40,1690,311,618,.503,0,1,.000,311,617,.504,.503,134,170,.788,91,247,338,223,62,37,139,207,756
3,Michael Adams\adamsmi01,PG,24,WSB,63,0,1303,160,393,.407,28,102,.275,132,291,.454,.443,105,124,.847,38,85,123,244,85,6,81,88,453
4,Rafael Addison\addisra01,SF,22,PHO,62,12,711,146,331,.441,16,50,.320,130,281,.463,.465,51,64,.797,41,65,106,45,27,7,54,75,359
5,Mark Aguirre\aguirma01,SF,27,DAL,80,80,2663,787,1590,.495,53,150,.353,734,1440,.510,.512,429,557,.770,181,246,427,254,84,30,217,243,2056
6,Danny Ainge\aingeda01,SG,27,BOS,71,66,2499,410,844,.486,85,192,.443,325,652,.498,.536,148,165,.897,49,193,242,400,101,14,141,189,1053
7,Mark Alarie\alarima01,PF,23,DEN,64,25,1110,217,443,.490,2,9,.222,215,434,.495,.492,67,101,.663,73,141,214,74,22,28,56,138,503
8,Richard Anderson\anderri01,PF,26,HOU,51,0,312,59,139,.424,4,16,.250,55,123,.447,.439,22,29,.759,24,55,79,33,7,3,19,37,144
9,Ron Anderson\anderro01,SF,28,IND,63,0,721,139,294,.473,0,5,.000,139,289,.481,.473,85,108,.787,73,78,151,54,31,3,55,65,363
10,John Bagley\baglejo01,PG,26,CLE,72,67,2182,312,732,.426,31,103,.301,281,629,.447,.447,113,136,.831,55,197,252,379,91,7,163,114,768
11,James Bailey\baileja01,PF,29,NJN,34,2,542,112,239,.469,0,0,,112,239,.469,.469,58,80,.725,48,89,137,20,12,23,54,119,282
12,Thurl Bailey\baileth01,PF,25,UTA,81,2,2155,463,1036,.447,0,2,.000,463,1034,.448,.447,190,236,.805,145,287,432,102,38,88,123,150,1116
13,Greg Ballard\ballagr01,SF,32,GSW,82,7,1579,248,564,.440,15,40,.375,233,524,.445,.453,68,91,.747,99,241,340,108,50,15,70,167,579
14,Gene Banks\banksge01,SF,27,CHI,63,39,1822,249,462,.539,0,5,.000,249,457,.545,.539,112,146,.767,115,193,308,170,52,17,113,173,610
15,Charles Barkley*\barklch01,PF,23,PHI,68,62,2740,557,937,.594,21,104,.202,536,833,.643,.606,429,564,.761,390,604,994,331,119,104,322,252,1564
16,John Battle\battljo01,SG,24,ATL,64,8,804,144,315,.457,0,10,.000,144,305,.472,.457,93,126,.738,16,44,60,124,29,5,60,76,381
17,William Bedford\bedfowi01,C,23,PHO,50,18,979,142,358,.397,0,1,.000,142,357,.398,.397,50,86,.581,79,167,246,57,18,37,85,125,334
18,Benoit Benjamin\benjabe01,C,22,LAC,72,61,2230,320,713,.449,0,2,.000,320,711,.450,.449,188,263,.715,134,452,586,135,60,187,184,251,828
19,Kent Benson\bensoke01,C,32,UTA,73,2,895,140,316,.443,2,7,.286,138,309,.447,.446,47,58,.810,80,151,231,39,39,28,45,138,329
20,Walter Berry\berrywa01,SF-PF,22,TOT,63,45,1586,407,766,.531,0,3,.000,407,763,.533,.531,187,288,.649,136,173,309,105,38,40,153,196,1001
20,Walter Berry\berrywa01,PF,22,POR,7,0,19,6,8,.750,0,0,,6,8,.750,.750,1,1,1.000,4,3,7,1,2,0,0,8,13
20,Walter Berry\berrywa01,SF,22,SAS,56,45,1567,401,758,.529,0,3,.000,401,755,.531,.529,186,287,.648,132,170,302,104,36,40,153,188,988
21,Joe Binion\biniojo01,PF,25,POR,11,0,51,4,10,.400,0,0,,4,10,.400,.400,6,10,.600,8,10,18,1,2,2,3,5,14
22,Larry Bird*\birdla01,SF,30,BOS,74,73,3005,786,1497,.525,90,225,.400,696,1272,.547,.555,414,455,.910,124,558,682,566,135,70,240,185,2076
23,Otis Birdsong\birdsot01,SG,31,NJN,7,6,127,19,42,.452,0,1,.000,19,41,.463,.452,6,9,.667,3,4,7,17,3,0,9,16,44
24,Uwe Blab\blabuw01,C,24,DAL,30,0,160,20,51,.392,0,0,,20,51,.392,.392,13,28,.464,11,25,36,13,4,9,15,33,53
25,Rolando Blackman\blackro01,SG,27,DAL,80,80,2758,626,1264,.495,5,15,.333,621,1249,.497,.497,419,474,.884,96,182,278,266,64,21,174,142,1676
26,Manute Bol\bolma01,C,24,WSB,82,12,1552,103,231,.446,0,1,.000,103,230,.448,.446,45,67,.672,84,278,362,11,20,302,61,189,251
27,Sam Bowie\bowiesa01,C,25,POR,5,5,163,30,66,.455,0,0,,30,66,.455,.455,20,30,.667,14,19,33,9,1,10,15,19,80
28,Dudley Bradley\bradldu01,SG,29,MIL,68,2,900,76,213,.357,13,50,.260,63,163,.387,.387,47,58,.810,31,71,102,66,105,8,34,118,212
29,Adrian Branch\brancad01,SF,23,LAL,32,0,219,48,96,.500,0,2,.000,48,94,.511,.500,42,54,.778,23,30,53,16,16,3,24,39,138
30,Randy Breuer\breuera01,C,26,MIL,76,10,1467,241,497,.485,0,0,,241,497,.485,.485,118,202,.584,129,221,350,47,56,61,100,229,600
31,Frank Brickowski\brickfr01,PF-C,27,TOT,44,0,487,63,124,.508,0,4,.000,63,120,.525,.508,50,70,.714,48,68,116,17,20,6,32,118,176
31,Frank Brickowski\brickfr01,PF,27,LAL,37,0,404,53,94,.564,0,0,,53,94,.564,.564,40,59,.678,40,57,97,12,14,4,25,105,146
31,Frank Brickowski\brickfr01,C,27,SAS,7,0,83,10,30,.333,0,4,.000,10,26,.385,.333,10,11,.909,8,11,19,5,6,2,7,13,30
32,Junior Bridgeman\bridgju01,SF,33,MIL,34,4,418,79,171,.462,1,6,.167,78,165,.473,.465,16,20,.800,14,38,52,35,10,2,15,50,175
33,Mike Brittain\brittmi01,C,23,SAS,6,0,29,4,9,.444,0,0,,4,9,.444,.444,1,2,.500,2,2,4,2,1,0,2,3,9
34,Michael Brooks\brookmi01,SF,28,IND,10,0,148,13,37,.351,0,0,,13,37,.351,.351,7,10,.700,9,19,28,11,9,0,11,19,33
35,Mike Brown\brownmi01,C,23,CHI,62,3,818,106,201,.527,0,0,,106,201,.527,.527,46,72,.639,71,143,214,24,20,7,59,129,258
36,Tony Brown\brownto01,SG,26,NJN,77,67,2339,358,810,.442,5,20,.250,353,790,.447,.445,152,206,.738,84,135,219,259,89,14,153,273,873
37,Michael Cage\cagemi01,PF,25,LAC,80,76,2922,457,878,.521,0,3,.000,457,875,.522,.521,341,467,.730,354,568,922,131,99,67,171,221,1255
38,Tony Campbell\campbto01,SF,24,DET,40,0,332,57,145,.393,0,3,.000,57,142,.401,.393,24,39,.615,21,37,58,19,12,1,34,40,138
39,Rick Carlisle\carliri01,SG,27,BOS,42,0,297,30,92,.326,5,16,.313,25,76,.329,.353,15,20,.750,8,22,30,35,8,0,25,28,80
40,Antoine Carr\carran01,PF,25,ATL,65,2,695,134,265,.506,1,3,.333,133,262,.508,.508,73,103,.709,60,96,156,34,14,48,40,146,342
41,Kenny Carr\carrke01,PF,31,POR,49,43,1443,201,399,.504,0,2,.000,201,397,.506,.504,126,169,.746,131,368,499,83,29,13,103,159,528
42,Joe Barry Carroll\carrojo01,C,28,GSW,81,81,2724,690,1461,.472,0,0,,690,1461,.472,.472,340,432,.787,173,416,589,214,92,123,226,255,1720
43,Bill Cartwright\cartwbi01,C,29,NYK,58,50,1989,335,631,.531,0,0,,335,631,.531,.531,346,438,.790,132,313,445,96,40,26,128,188,1016
44,Terry Catledge\catlete01,PF,23,WSB,78,77,2149,413,835,.495,0,4,.000,413,831,.497,.495,199,335,.594,248,312,560,56,43,14,145,195,1025
45,Tom Chambers\chambto01,PF,27,SEA,82,82,3018,660,1446,.456,54,145,.372,606,1301,.466,.475,535,630,.849,163,382,545,245,81,50,268,307,1909
46,Maurice Cheeks*\cheekma01,PG,30,PHI,68,68,2624,415,788,.527,4,17,.235,411,771,.533,.529,227,292,.777,47,168,215,538,180,15,173,109,1061
47,Fred Cofield\cofiefr01,PG,25,CHI,5,0,27,2,11,.182,0,1,.000,2,10,.200,.182,0,0,,1,4,5,4,2,0,1,1,4
48,Ben Coleman\colembe01,C,25,NJN,68,7,1029,182,313,.581,0,1,.000,182,312,.583,.581,88,121,.727,99,189,288,37,32,31,94,200,452
49,Don Collins\collido02,SF,28,MIL,6,0,57,10,28,.357,0,0,,10,28,.357,.357,5,7,.714,11,4,15,2,2,1,5,11,25
50,Steve Colter\coltest01,PG,24,TOT,70,31,1322,169,397,.426,4,17,.235,165,380,.434,.431,82,107,.766,23,85,108,210,56,12,70,99,424
50,Steve Colter\coltest01,PG,24,CHI,27,18,473,49,142,.345,0,9,.000,49,133,.368,.345,33,39,.846,9,33,42,94,19,6,32,38,131
50,Steve Colter\coltest01,PG,24,PHI,43,13,849,120,255,.471,4,8,.500,116,247,.470,.478,49,68,.721,14,52,66,116,37,6,38,61,293
51,Darwin Cook\cookda01,SG,28,WSB,82,2,1420,265,622,.426,2,23,.087,263,599,.439,.428,82,103,.796,46,99,145,151,98,17,96,136,614
52,Michael Cooper\coopemi01,SG,30,LAL,82,2,2253,322,736,.438,89,231,.385,233,505,.461,.498,126,148,.851,58,196,254,373,78,43,102,199,859
53,Wayne Cooper\coopewa01,C,30,DEN,69,64,1561,235,524,.448,0,3,.000,235,521,.451,.448,79,109,.725,162,311,473,68,13,101,78,257,549
54,Tyrone Corbin\corbity01,SF,24,TOT,63,15,1170,156,381,.409,1,4,.250,155,377,.411,.411,91,124,.734,88,127,215,97,55,5,66,129,404
54,Tyrone Corbin\corbity01,SF,24,SAS,31,15,732,113,264,.428,0,0,,113,264,.428,.428,49,67,.731,52,67,119,80,38,3,46,81,275
54,Tyrone Corbin\corbity01,SF,24,CLE,32,0,438,43,117,.368,1,4,.250,42,113,.372,.372,42,57,.737,36,60,96,17,17,2,20,48,129
55,Dave Corzine\corzida01,C,30,CHI,82,39,2287,294,619,.475,0,5,.000,294,614,.479,.475,95,129,.736,199,341,540,209,38,87,114,202,683
56,Pat Cummings\cummipa01,PF,30,NYK,49,11,1056,172,382,.450,0,0,,172,382,.450,.450,79,110,.718,123,189,312,38,26,7,85,145,423
57,Terry Cummings\cummite01,PF,25,MIL,82,77,2770,729,1426,.511,0,3,.000,729,1423,.512,.511,249,376,.662,214,486,700,229,129,81,172,296,1707
58,Earl Cureton\curetea01,C,29,TOT,78,47,1973,243,510,.476,0,2,.000,243,508,.478,.476,82,152,.539,212,240,452,122,33,56,80,188,568
58,Earl Cureton\curetea01,C,29,CHI,43,36,1105,129,276,.467,0,1,.000,129,275,.469,.467,39,73,.534,113,114,227,70,15,26,45,102,297
58,Earl Cureton\curetea01,C,29,LAC,35,11,868,114,234,.487,0,1,.000,114,233,.489,.487,43,79,.544,99,126,225,52,18,30,35,86,271
59,Dell Curry\curryde01,SG,22,UTA,67,0,636,139,326,.426,17,60,.283,122,266,.459,.452,30,38,.789,30,48,78,58,27,4,44,86,325
60,Quintin Dailey\dailequ01,SG,26,LAC,49,5,924,200,491,.407,1,10,.100,199,481,.414,.408,119,155,.768,34,49,83,79,43,8,71,113,520
61,Adrian Dantley*\dantlad01,SF,30,DET,81,81,2736,601,1126,.534,1,6,.167,600,1120,.536,.534,539,664,.812,104,228,332,162,63,7,181,193,1742
62,Brad Daugherty\daughbr01,C,21,CLE,80,80,2695,487,905,.538,0,0,,487,905,.538,.538,279,401,.696,152,495,647,304,49,63,248,248,1253
63,Brad Davis\davisbr01,PG,31,DAL,82,6,1582,199,436,.456,32,106,.302,167,330,.506,.493,147,171,.860,27,87,114,373,63,10,114,159,577
64,Walter Davis\daviswa03,SG,32,PHO,79,79,2646,779,1515,.514,21,81,.259,758,1434,.529,.521,288,334,.862,90,154,244,364,96,5,226,184,1867
65,Darryl Dawkins\dawkida01,C,30,NJN,6,2,106,20,32,.625,0,0,,20,32,.625,.625,17,24,.708,9,10,19,2,2,3,15,25,57
66,Johnny Dawkins\dawkijo01,PG,23,SAS,81,14,1682,334,764,.437,14,47,.298,320,717,.446,.446,153,191,.801,56,113,169,290,67,3,120,118,835
67,Darren Daye\dayeda01,SF,26,TOT,62,2,731,101,202,.500,0,0,,101,202,.500,.500,34,65,.523,37,88,125,76,25,7,57,100,236
67,Darren Daye\dayeda01,SF,26,CHI,1,0,7,0,0,,0,0,,0,0,,,0,0,,0,1,1,1,0,0,1,2,0
67,Darren Daye\dayeda01,SF,26,BOS,61,2,724,101,202,.500,0,0,,101,202,.500,.500,34,65,.523,37,87,124,75,25,7,56,98,236
68,James Donaldson\donalja01,C,29,DAL,82,82,3028,311,531,.586,0,0,,311,531,.586,.586,267,329,.812,295,678,973,63,51,136,104,191,889
69,Bruce Douglas\douglbr01,SG,22,SAC,8,1,98,7,24,.292,0,1,.000,7,23,.304,.292,0,4,.000,5,9,14,17,9,0,9,9,14
70,Greg Dreiling\dreilgr01,C,24,IND,24,0,128,16,37,.432,0,0,,16,37,.432,.432,10,12,.833,12,31,43,7,2,2,7,42,42
71,Larry Drew\drewla01,PG,28,LAC,60,22,1566,295,683,.432,12,72,.167,283,611,.463,.441,139,166,.837,26,77,103,326,60,2,151,107,741
72,Clyde Drexler*\drexlcl01,SG,24,POR,82,82,3114,707,1408,.502,11,47,.234,696,1361,.511,.506,357,470,.760,227,291,518,566,204,71,253,281,1782
73,Kevin Duckworth\duckwke01,C,22,TOT,65,1,875,130,273,.476,0,1,.000,130,272,.478,.476,92,134,.687,76,147,223,29,21,21,78,192,352
73,Kevin Duckworth\duckwke01,C,22,SAS,14,1,122,18,45,.400,0,0,,18,45,.400,.400,9,14,.643,13,18,31,6,5,3,4,27,45
73,Kevin Duckworth\duckwke01,C,22,POR,51,0,753,112,228,.491,0,1,.000,112,227,.493,.491,83,120,.692,63,129,192,23,16,18,74,165,307
74,Joe Dumars*\dumarjo01,SG,23,DET,79,75,2439,369,749,.493,9,22,.409,360,727,.495,.499,184,246,.748,50,117,167,352,83,5,171,194,931
75,T.R. Dunn\dunntr01,SG,31,DEN,81,53,1932,118,276,.428,0,2,.000,118,274,.431,.428,36,55,.655,91,174,265,147,100,21,33,160,272
76,Mark Eaton\eatonma01,C,30,UTA,79,79,2505,234,585,.400,0,0,,234,585,.400,.400,140,213,.657,211,486,697,105,43,321,142,273,608
77,Jerry Eaves\eavesje01,PG,27,SAC,3,0,26,1,8,.125,0,0,,1,8,.125,.125,2,2,1.000,1,0,1,0,1,0,2,6,4
78,Franklin Edwards\edwarfr01,PG,27,SAC,8,0,122,9,32,.281,0,4,.000,9,28,.321,.281,10,14,.714,2,8,10,29,5,0,17,7,28
79,James Edwards\edwarja01,C,31,PHO,14,9,304,57,110,.518,0,0,,57,110,.518,.518,54,70,.771,20,40,60,19,6,7,15,42,168
80,Craig Ehlo\ehlocr01,SG,25,CLE,44,15,890,99,239,.414,5,29,.172,94,210,.448,.425,70,99,.707,55,106,161,92,40,30,61,80,273
81,Dale Ellis\ellisda01,SG,26,SEA,82,76,3073,785,1520,.516,86,240,.358,699,1280,.546,.545,385,489,.787,187,260,447,238,104,32,238,267,2041
82,Chris Engler\englech01,C,27,TOT,30,0,195,23,51,.451,0,0,,23,51,.451,.451,12,16,.750,23,34,57,8,5,11,12,33,58
82,Chris Engler\englech01,C,27,POR,7,0,17,4,8,.500,0,0,,4,8,.500,.500,3,3,1.000,6,2,8,1,1,1,2,0,11
82,Chris Engler\englech01,C,27,MIL,5,0,48,3,12,.250,0,0,,3,12,.250,.250,1,1,1.000,3,13,16,3,1,1,0,10,7
82,Chris Engler\englech01,C,27,NJN,18,0,130,16,31,.516,0,0,,16,31,.516,.516,8,12,.667,14,19,33,4,3,9,10,23,40
83,Alex English*\englial01,SF,33,DEN,82,82,3085,965,1920,.503,4,15,.267,961,1905,.504,.504,411,487,.844,146,198,344,422,73,21,214,216,2345
84,Julius Erving*\ervinju01,SF,36,PHI,60,60,1918,400,850,.471,14,53,.264,386,797,.484,.479,191,235,.813,115,149,264,191,76,94,158,137,1005
85,Mike Evans\evansmi01,SG,31,DEN,81,4,1567,334,729,.458,53,169,.314,281,560,.502,.495,96,123,.780,36,92,128,185,79,12,107,149,817
86,Patrick Ewing*\ewingpa01,PF,24,NYK,63,63,2206,530,1053,.503,0,7,.000,530,1046,.507,.503,296,415,.713,157,398,555,104,89,147,229,248,1356
87,Dave Feitl\feitlda01,C,24,HOU,62,1,498,88,202,.436,0,1,.000,88,201,.438,.436,53,71,.746,39,78,117,22,9,4,38,83,229
88,Kenny Fields\fieldke01,SF,24,TOT,48,17,883,159,352,.452,3,12,.250,156,340,.459,.456,73,94,.777,63,85,148,61,32,11,53,123,394
88,Kenny Fields\fieldke01,SF,24,MIL,4,0,22,6,8,.750,0,0,,6,8,.750,.750,1,5,.200,0,2,2,1,1,0,1,3,13
88,Kenny Fields\fieldke01,SF,24,LAC,44,17,861,153,344,.445,3,12,.250,150,332,.452,.449,72,89,.809,63,83,146,60,31,11,52,120,381
89,Vern Fleming\flemive01,PG,24,IND,82,82,2549,370,727,.509,2,10,.200,368,717,.513,.510,238,302,.788,109,225,334,473,109,18,167,222,980
90,Sleepy Floyd\floydsl01,PG,26,GSW,82,82,3064,503,1030,.488,73,190,.384,430,840,.512,.524,462,537,.860,56,212,268,848,146,18,280,199,1541
91,World B. Free\freewo01,SG,33,PHI,20,2,285,39,123,.317,2,9,.222,37,114,.325,.325,36,47,.766,5,14,19,30,5,4,18,26,116
92,Kenny Gattison\gattike01,PF,22,PHO,77,14,1104,148,311,.476,0,3,.000,148,308,.481,.476,108,171,.632,87,183,270,36,24,33,88,178,404
93,Artis Gilmore*\gilmoar01,C,37,SAS,82,74,2405,346,580,.597,0,0,,346,580,.597,.597,242,356,.680,185,394,579,150,39,95,178,235,934
94,Mike Glenn\glennmi01,SG,31,MIL,4,0,34,5,13,.385,0,0,,5,13,.385,.385,5,7,.714,0,2,2,1,1,0,0,3,15
95,Mike Gminski\gminsmi01,C,27,NJN,72,66,2272,433,947,.457,0,0,,433,947,.457,.457,313,370,.846,192,438,630,99,52,69,129,159,1179
96,Grant Gondrezick\gondrgr01,SG,24,PHO,64,1,836,135,300,.450,4,17,.235,131,283,.463,.457,75,107,.701,47,63,110,81,25,4,56,91,349
97,Lancaster Gordon\gordola01,SG,24,LAC,70,4,1130,221,545,.406,14,48,.292,207,497,.416,.418,70,95,.737,64,62,126,139,61,13,102,106,526
98,Stewart Granger\grangst01,PG,25,NYK,15,0,166,20,54,.370,0,3,.000,20,51,.392,.370,9,11,.818,6,11,17,27,7,1,22,17,49
99,Stuart Gray\grayst01,C,23,IND,55,1,456,41,101,.406,0,0,,41,101,.406,.406,28,39,.718,39,90,129,26,10,28,36,93,110
100,A.C. Green\greenac01,PF,23,LAL,79,72,2240,316,587,.538,0,5,.000,316,582,.543,.538,220,282,.780,210,405,615,84,70,80,102,171,852
101,Kenny Green\greenke02,SF,22,PHI,19,0,172,25,70,.357,0,0,,25,70,.357,.357,14,19,.737,6,22,28,7,4,2,15,8,64
102,Rickey Green\greenri01,PG,32,UTA,81,80,2090,301,644,.467,7,19,.368,294,625,.470,.473,172,208,.827,38,125,163,541,110,2,133,108,781
103,Sidney Green\greensi02,PF,26,DET,80,69,1792,256,542,.472,0,2,.000,256,540,.474,.472,119,177,.672,196,457,653,62,41,50,127,197,631
104,Dave Greenwood\greenda01,PF,29,SAS,79,78,2587,336,655,.513,3,6,.500,333,649,.513,.515,241,307,.785,256,527,783,237,71,50,161,248,916
105,Darrell Griffith\griffda01,SG,28,UTA,76,10,1843,463,1038,.446,67,200,.335,396,838,.473,.478,149,212,.703,81,146,227,129,97,29,135,167,1142
106,Bob Hansen\hansebo01,SG,26,UTA,72,72,1453,272,601,.453,16,45,.356,256,556,.460,.466,136,179,.760,84,119,203,102,44,6,77,146,696
107,Bill Hanzlik\hanzlbi01,PF,29,DEN,73,10,1990,307,746,.412,22,80,.275,285,666,.428,.426,316,402,.786,79,177,256,280,87,28,132,245,952
108,Derek Harper\harpede01,PG,25,DAL,77,76,2556,497,993,.501,76,212,.358,421,781,.539,.539,160,234,.684,51,148,199,609,167,25,138,195,1230
109,Ron Harper\harpero01,SG,23,CLE,82,82,3064,734,1614,.455,20,94,.213,714,1520,.470,.461,386,564,.684,169,223,392,394,209,84,345,247,1874
110,Steve Harris\harrist01,SG,23,HOU,74,3,1174,251,599,.419,0,8,.000,251,591,.425,.419,111,130,.854,71,99,170,100,37,16,74,111,613
111,Scott Hastings\hastisc01,PF,26,ATL,40,0,256,23,68,.338,2,12,.167,21,56,.375,.353,23,29,.793,16,54,70,13,10,7,13,35,71
112,Cedric Henderson\hendece01,PF,21,TOT,8,0,16,4,8,.500,0,0,,4,8,.500,.500,3,3,1.000,3,5,8,0,0,0,4,2,11
112,Cedric Henderson\hendece01,PF,21,ATL,6,0,10,2,5,.400,0,0,,2,5,.400,.400,1,1,1.000,2,1,3,0,0,0,1,1,5
112,Cedric Henderson\hendece01,PF,21,MIL,2,0,6,2,3,.667,0,0,,2,3,.667,.667,2,2,1.000,1,4,5,0,0,0,3,1,6
113,Gerald Henderson\hendege01,PG,31,TOT,74,59,2045,298,674,.442,19,77,.247,279,597,.467,.456,190,230,.826,50,125,175,471,101,11,172,208,805
113,Gerald Henderson\hendege01,PG,31,SEA,6,6,155,25,50,.500,0,3,.000,25,47,.532,.500,17,18,.944,6,3,9,32,6,0,15,17,67
113,Gerald Henderson\hendege01,PG,31,NYK,68,53,1890,273,624,.438,19,74,.257,254,550,.462,.453,173,212,.816,44,122,166,439,95,11,157,191,738
114,Jerome Henderson\hendeje01,PF,27,MIL,6,0,36,4,13,.308,0,0,,4,13,.308,.308,4,4,1.000,2,5,7,0,1,1,6,12,12
115,Kevin Henderson\hendeke01,PG,22,GSW,5,0,45,3,8,.375,0,0,,3,8,.375,.375,2,2,1.000,1,2,3,11,1,0,4,9,8
116,Conner Henry\henryco01,SG,23,TOT,54,0,323,46,136,.338,13,42,.310,33,94,.351,.386,17,27,.630,7,27,34,35,9,1,26,34,122
116,Conner Henry\henryco01,SG,23,HOU,18,0,92,8,33,.242,1,11,.091,7,22,.318,.258,7,10,.700,0,7,7,8,3,0,9,7,24
116,Conner Henry\henryco01,SG,23,BOS,36,0,231,38,103,.369,12,31,.387,26,72,.361,.427,10,17,.588,7,20,27,27,6,1,17,27,98
117,Rod Higgins\higgiro01,SF,27,GSW,73,28,1497,214,412,.519,3,17,.176,211,395,.534,.523,200,240,.833,72,165,237,96,40,21,76,145,631
118,Roy Hinson\hinsoro01,SF,25,PHI,76,58,2489,393,823,.478,0,1,.000,393,822,.478,.478,273,360,.758,150,338,488,60,45,161,149,281,1059
119,Craig Hodges\hodgecr01,PG,26,MIL,78,43,2147,315,682,.462,85,228,.373,230,454,.507,.524,131,147,.891,48,92,140,240,76,7,124,189,846
120,Mike Holton\holtomi01,PG,25,POR,58,1,479,70,171,.409,7,23,.304,63,148,.426,.430,44,55,.800,9,29,38,73,16,2,41,51,191
121,Jeff Hornacek\hornaje01,SG,23,PHO,80,3,1561,159,350,.454,12,43,.279,147,307,.479,.471,94,121,.777,41,143,184,361,70,5,153,130,424
122,Phil Hubbard\hubbaph01,SF,30,CLE,68,68,2083,321,605,.531,0,4,.000,321,601,.534,.531,162,272,.596,178,210,388,136,66,7,156,224,804
123,Jay Humphries\humphja01,PG,24,PHO,82,82,2579,359,753,.477,5,27,.185,354,726,.488,.480,200,260,.769,62,198,260,632,112,9,195,239,923
124,Geoff Huston\hustoge01,PG,29,LAC,19,8,428,55,121,.455,1,2,.500,54,119,.454,.459,18,34,.529,6,11,17,101,14,0,45,28,129
125,Marc Iavaroni\iavarma01,PF,30,UTA,78,0,845,100,215,.465,0,4,.000,100,211,.474,.465,78,116,.672,64,109,173,36,16,11,56,154,278
126,Myron Jackson\jacksmy01,PG,22,DAL,8,0,22,2,9,.222,0,0,,2,9,.222,.222,7,8,.875,1,2,3,6,1,0,5,1,11
127,Buck Johnson\johnsbu01,SF,23,HOU,60,3,520,94,201,.468,0,1,.000,94,200,.470,.468,40,58,.690,38,50,88,40,17,15,37,81,228
128,Clemon Johnson\johnscl01,C,30,SEA,78,7,1051,88,178,.494,0,2,.000,88,176,.500,.494,70,110,.636,106,171,277,21,21,42,36,137,246
129,Dennis Johnson*\johnsde01,PG,32,BOS,79,78,2933,423,953,.444,7,62,.113,416,891,.467,.448,209,251,.833,45,216,261,594,87,38,177,201,1062
130,Eddie Johnson\johnsed02,SG,31,SEA,24,0,508,85,186,.457,5,15,.333,80,171,.468,.470,42,55,.764,11,35,46,115,12,1,41,36,217
131,Eddie Johnson\johnsed03,SF,27,SAC,81,30,2457,606,1309,.463,37,118,.314,569,1191,.478,.477,267,322,.829,146,207,353,251,42,19,163,218,1516
132,Frank Johnson\johnsfr01,PG,28,WSB,18,10,399,59,128,.461,0,1,.000,59,127,.465,.461,35,49,.714,10,20,30,58,21,0,31,31,153
133,Magic Johnson*\johnsma02,PG,27,LAL,80,80,2904,683,1308,.522,8,39,.205,675,1269,.532,.525,535,631,.848,122,382,504,977,138,36,300,168,1909
134,Marques Johnson\johnsma01,SF,30,LAC,10,10,302,68,155,.439,0,6,.000,68,149,.456,.439,30,42,.714,9,24,33,28,12,5,17,24,166
135,Steffond Johnson\johnsst02,PF,24,LAC,29,0,234,27,64,.422,0,3,.000,27,61,.443,.422,20,38,.526,15,28,43,5,9,2,18,55,74
136,Steve Johnson\johnsst03,C,29,POR,79,74,2345,494,889,.556,0,0,,494,889,.556,.556,342,490,.698,194,372,566,155,49,76,276,340,1330
137,Vinnie Johnson\johnsvi01,SG,30,DET,78,8,2166,533,1154,.462,4,14,.286,529,1140,.464,.464,158,201,.786,123,134,257,300,92,16,133,159,1228
138,Anthony Jones\jonesan01,SF-SG,24,TOT,65,4,858,133,322,.413,7,20,.350,126,302,.417,.424,50,65,.769,40,64,104,73,42,19,49,79,323
138,Anthony Jones\jonesan01,SG,24,WSB,16,1,114,14,33,.424,0,1,.000,14,32,.438,.424,9,13,.692,1,8,9,7,10,1,11,11,37
138,Anthony Jones\jonesan01,SF,24,SAS,49,3,744,119,289,.412,7,19,.368,112,270,.415,.424,41,52,.788,39,56,95,66,32,18,38,68,286
139,Caldwell Jones\jonesca01,PF,36,POR,78,37,1578,111,224,.496,0,2,.000,111,222,.500,.496,97,124,.782,114,341,455,64,23,77,87,227,319
140,Charles Jones\jonesch01,PF,29,WSB,79,64,1609,118,249,.474,0,1,.000,118,248,.476,.474,48,76,.632,144,212,356,80,67,165,77,252,284
141,Michael Jordan*\jordami01,SG,23,CHI,82,82,3281,1098,2279,.482,12,66,.182,1086,2213,.491,.484,833,972,.857,166,264,430,377,236,125,272,237,3041
142,Clark Kellogg\kellocl01,PF,25,IND,4,4,60,8,22,.364,1,2,.500,7,20,.350,.386,3,4,.750,7,4,11,6,5,0,4,12,20
143,Tim Kempton\kemptti01,PF,23,LAC,66,6,936,97,206,.471,0,1,.000,97,205,.473,.471,95,137,.693,70,124,194,53,38,12,49,162,289
144,Jerome Kersey\kerseje01,SF,24,POR,82,8,2088,373,733,.509,1,23,.043,372,710,.524,.510,262,364,.720,201,295,496,194,122,77,149,328,1009
145,Albert King\kingal01,SF,27,NJN,61,15,1291,244,573,.426,13,32,.406,231,541,.427,.437,81,100,.810,82,132,214,103,34,28,103,177,582
146,Bernard King*\kingbe01,SF,30,NYK,6,4,214,52,105,.495,0,0,,52,105,.495,.495,32,43,.744,13,19,32,19,2,0,15,14,136
147,Curtis Kitchen\kitchcu01,PF,23,SEA,6,0,31,3,6,.500,0,1,.000,3,5,.600,.500,3,4,.750,4,5,9,1,2,3,0,4,9
148,Greg Kite\kitegr01,C,25,BOS,74,1,745,47,110,.427,0,1,.000,47,109,.431,.427,29,76,.382,61,108,169,27,17,46,34,148,123
149,Joe Kleine\kleinjo01,C,25,SAC,79,31,1658,256,543,.471,0,1,.000,256,542,.472,.471,110,140,.786,173,310,483,71,35,30,90,213,622
150,Jon Koncak\koncajo01,C,23,ATL,82,19,1684,169,352,.480,0,1,.000,169,351,.481,.480,125,191,.654,153,340,493,31,52,76,92,262,463
151,Larry Krystkowiak\krystla01,PF,22,SAS,68,2,1004,170,373,.456,1,12,.083,169,361,.468,.457,110,148,.743,77,162,239,85,22,12,67,141,451
152,Bill Laimbeer\laimbbi01,C,29,DET,82,82,2854,506,1010,.501,6,21,.286,500,989,.506,.504,245,274,.894,243,712,955,151,72,69,120,283,1263
153,Jim Lampley\lamplji01,C,26,PHI,1,0,16,1,3,.333,0,0,,1,3,.333,.333,1,2,.500,1,4,5,0,1,0,1,0,3
154,Allen Leavell\leaveal01,PG,29,HOU,53,11,1175,147,358,.411,18,57,.316,129,301,.429,.436,100,119,.840,14,47,61,224,53,10,64,126,412
155,Keith Lee\leeke01,PF,24,CLE,67,1,870,170,374,.455,0,1,.000,170,373,.456,.455,72,101,.713,93,158,251,69,25,40,85,147,412
156,Fat Lever\leverfa01,PG,26,DEN,82,82,3054,643,1370,.469,22,92,.239,621,1278,.486,.477,244,312,.782,216,513,729,654,201,34,167,219,1552
157,Cliff Levingston\levincl01,PF,26,ATL,82,10,1848,251,496,.506,0,3,.000,251,493,.509,.506,155,212,.731,219,314,533,40,48,68,72,261,657
158,Alton Lister\listeal01,C,28,SEA,75,75,2288,346,687,.504,0,1,.000,346,686,.504,.504,179,265,.675,223,482,705,110,32,180,169,289,871
159,Lewis Lloyd\lloydle01,SG,27,HOU,32,14,688,165,310,.532,1,7,.143,164,303,.541,.534,65,86,.756,13,35,48,90,19,5,52,69,396
160,John Long\longjo01,SG,30,IND,80,68,2265,490,1170,.419,19,67,.284,471,1103,.427,.427,219,246,.890,75,142,217,258,96,8,153,167,1218
161,John Lucas\lucasjo01,PG,33,MIL,43,40,1358,285,624,.457,46,126,.365,239,498,.480,.494,137,174,.787,29,96,125,290,71,6,89,82,753
162,Maurice Lucas\lucasma01,PF,34,SEA,63,0,1120,175,388,.451,0,5,.000,175,383,.457,.451,150,187,.802,88,219,307,65,34,21,75,171,500
163,Kyle Macy\macyky01,PG,29,IND,76,0,1250,164,341,.481,14,46,.304,150,295,.508,.501,34,41,.829,25,88,113,197,59,7,58,136,376
164,Rick Mahorn\mahorri01,PF,28,DET,63,6,1278,144,322,.447,0,0,,144,322,.447,.447,96,117,.821,93,282,375,38,32,50,73,221,384
165,Jeff Malone\malonje01,SG,25,WSB,80,79,2763,689,1509,.457,4,26,.154,685,1483,.462,.458,376,425,.885,50,168,218,298,75,13,182,154,1758
166,Karl Malone*\malonka01,PF,23,UTA,82,82,2857,728,1422,.512,0,7,.000,728,1415,.514,.512,323,540,.598,278,577,855,158,104,60,237,323,1779
167,Moses Malone*\malonmo01,C,31,WSB,73,70,2488,595,1311,.454,0,11,.000,595,1300,.458,.454,570,692,.824,340,484,824,120,59,92,202,139,1760
168,Pace Mannion\mannipa01,SF,26,NJN,23,3,284,31,94,.330,3,9,.333,28,85,.329,.346,18,31,.581,10,29,39,45,18,4,23,32,83
169,Bill Martin\martibi01,SF,24,NYK,8,0,68,9,25,.360,0,0,,9,25,.360,.360,7,8,.875,2,5,7,0,4,2,7,5,25
170,Fernando Martin\martife01,C,24,POR,24,0,146,9,31,.290,0,1,.000,9,30,.300,.290,4,11,.364,8,20,28,9,7,1,20,24,22
171,Maurice Martin\martima01,SF,22,DEN,43,0,286,51,135,.378,3,15,.200,48,120,.400,.389,42,66,.636,12,29,41,35,13,6,33,48,147
172,Wes Matthews\matthwe01,PG,27,LAL,50,0,532,89,187,.476,1,3,.333,88,184,.478,.479,29,36,.806,13,34,47,100,23,4,51,53,208
173,Cedric Maxwell\maxwece01,SF,31,TOT,81,31,1968,253,477,.530,0,1,.000,253,476,.532,.530,303,391,.775,175,260,435,197,39,14,136,178,809
173,Cedric Maxwell\maxwece01,SF,31,LAC,35,31,1132,150,289,.519,0,0,,150,289,.519,.519,177,228,.776,103,148,251,122,26,9,88,102,477
173,Cedric Maxwell\maxwece01,SF,31,HOU,46,0,836,103,188,.548,0,1,.000,103,187,.551,.548,126,163,.773,72,112,184,75,13,5,48,76,332
174,Tim McCormick\mccorti01,C,24,PHI,81,79,2817,391,718,.545,0,4,.000,391,714,.548,.545,251,349,.719,180,431,611,114,36,64,153,270,1033
175,Rodney McCray\mccraro01,SF,25,HOU,81,81,3136,432,783,.552,0,9,.000,432,774,.558,.552,306,393,.779,190,388,578,434,88,53,208,172,1170
176,Scooter McCray\mccrasc01,PF,26,CLE,24,2,279,30,65,.462,0,0,,30,65,.462,.462,20,41,.488,19,39,58,23,9,4,24,28,80
177,Xavier McDaniel\mcdanxa01,SF,23,SEA,82,82,3031,806,1583,.509,3,14,.214,803,1569,.512,.510,275,395,.696,338,367,705,207,115,52,234,300,1890
178,Ben McDonald\mcdonbe01,PF,24,GSW,63,34,1284,164,360,.456,1,8,.125,163,352,.463,.457,24,38,.632,63,120,183,84,27,8,43,200,353
179,Hank McDowell\mcdowha01,PF,27,MIL,7,0,70,8,17,.471,0,0,,8,17,.471,.471,6,7,.857,9,10,19,2,2,0,3,14,22
180,Mike McGee\mcgeemi01,SF,27,ATL,76,6,1420,311,677,.459,86,229,.376,225,448,.502,.523,80,137,.584,71,88,159,149,61,2,104,156,788
181,Kevin McHale*\mchalke01,PF,29,BOS,77,77,3060,790,1307,.604,0,4,.000,790,1303,.606,.604,428,512,.836,247,516,763,198,38,172,197,240,2008
182,Kevin McKenna\mckenke01,SG,28,NJN,56,3,942,153,337,.454,52,124,.419,101,213,.474,.531,43,57,.754,21,56,77,93,54,7,53,141,401
183,Forrest McKenzie\mckenfo01,SF,23,SAS,6,0,42,7,28,.250,1,2,.500,6,26,.231,.268,2,2,1.000,2,5,7,1,1,0,3,9,17
184,Nate McMillan\mcmilna01,PG,22,SEA,71,50,1972,143,301,.475,0,7,.000,143,294,.486,.475,87,141,.617,101,230,331,583,125,45,155,238,373
185,Mark McNamara\mcnamma01,C,27,PHI,11,1,113,14,30,.467,0,0,,14,30,.467,.467,7,19,.368,17,19,36,2,1,0,8,17,35
186,Chris McNealy\mcneach01,PF,25,NYK,59,16,972,88,179,.492,0,0,,88,179,.492,.492,52,80,.650,74,153,227,46,36,16,64,136,228
187,Cozell McQueen\mcqueco01,PF,25,DET,3,0,7,3,3,1.000,0,0,,3,3,1.000,1.000,0,0,,3,5,8,0,0,1,0,1,6
188,Dirk Minniefield\minnidi01,PG,26,TOT,74,52,1600,218,482,.452,11,39,.282,207,443,.467,.464,62,90,.689,29,111,140,348,72,7,157,174,509
188,Dirk Minniefield\minnidi01,PG,26,CLE,11,0,122,13,42,.310,0,5,.000,13,37,.351,.310,1,4,.250,1,9,10,13,6,1,12,8,27
188,Dirk Minniefield\minnidi01,PG,26,HOU,63,52,1478,205,440,.466,11,34,.324,194,406,.478,.478,61,86,.709,28,102,130,335,66,6,145,166,482
189,Mike Mitchell\mitchmi01,SF,31,SAS,40,18,922,208,478,.435,1,2,.500,207,476,.435,.436,92,112,.821,38,65,103,38,19,9,51,68,509
190,Paul Mokeski\mokespa01,C,30,MIL,62,3,626,52,129,.403,0,1,.000,52,128,.406,.403,46,64,.719,45,93,138,22,18,13,22,126,150
191,Sidney Moncrief\moncrsi01,SG,29,MIL,39,30,992,158,324,.488,8,31,.258,150,293,.512,.500,136,162,.840,57,70,127,121,27,10,63,73,460
192,Johnny Moore\moorejo01,PG,28,SAS,55,27,1234,198,448,.442,22,79,.278,176,369,.477,.467,56,70,.800,32,68,100,250,83,3,102,97,474
193,Perry Moss\mosspe01,PG,28,GSW,64,0,698,91,207,.440,1,14,.071,90,193,.466,.442,49,69,.710,29,66,95,90,42,3,57,96,232
194,Chris Mullin*\mullich01,SG,23,GSW,82,82,2377,477,928,.514,19,63,.302,458,865,.529,.524,269,326,.825,39,142,181,261,98,36,154,217,1242
195,Jay Murphy\murphja01,PF,24,WSB,21,0,141,31,72,.431,0,0,,31,72,.431,.431,9,16,.563,17,22,39,5,3,2,6,21,71
196,Pete Myers\myerspe01,SG,23,CHI,29,0,155,19,52,.365,0,6,.000,19,46,.413,.365,28,43,.651,8,9,17,21,14,2,10,25,66
197,Larry Nance\nancela01,PF,27,PHO,69,67,2569,585,1062,.551,1,5,.200,584,1057,.553,.551,381,493,.773,188,411,599,233,86,148,149,223,1552
198,Calvin Natt\nattca01,PF,30,DEN,1,1,20,4,10,.400,0,0,,4,10,.400,.400,2,2,1.000,2,3,5,2,1,0,1,2,10
199,Ed Nealy\nealyed01,PF,26,SAS,60,7,980,84,192,.438,4,31,.129,80,161,.497,.448,51,69,.739,96,188,284,83,40,11,36,144,223
200,Chuck Nevitt\nevitch01,C,27,DET,41,0,267,31,63,.492,0,0,,31,63,.492,.492,14,24,.583,36,47,83,4,7,30,21,73,76
201,Johnny Newman\newmajo01,SF,23,CLE,59,0,630,113,275,.411,1,22,.045,112,253,.443,.413,66,76,.868,36,34,70,27,20,7,46,67,293
202,Kurt Nimphius\nimphku01,PF,28,TOT,66,11,1088,155,330,.470,0,4,.000,155,326,.475,.470,81,120,.675,80,107,187,25,20,54,63,156,391
202,Kurt Nimphius\nimphku01,PF,28,LAC,38,6,811,119,252,.472,0,3,.000,119,249,.478,.472,57,88,.648,58,75,133,18,16,41,47,118,295
202,Kurt Nimphius\nimphku01,PF,28,DET,28,5,277,36,78,.462,0,1,.000,36,77,.468,.462,24,32,.750,22,32,54,7,4,13,16,38,96
203,Dennis Nutt\nuttde01,PG,23,DAL,25,0,91,16,40,.400,5,17,.294,11,23,.478,.463,20,22,.909,1,7,8,16,7,0,10,6,57
204,Mike O'Koren\okoremi01,SF,28,WSB,15,0,123,16,42,.381,0,2,.000,16,40,.400,.381,0,2,.000,6,8,14,13,2,0,6,10,32
205,Charles Oakley\oaklech01,PF,23,CHI,82,81,2980,468,1052,.445,11,30,.367,457,1022,.447,.450,245,357,.686,299,775,1074,296,85,36,299,315,1192
206,Hakeem Olajuwon*\olajuha01,C,24,HOU,75,75,2760,677,1332,.508,1,5,.200,676,1327,.509,.509,400,570,.702,315,543,858,220,140,254,228,294,1755
207,Mark Olberding\olberma01,PF,30,SAC,76,0,1002,69,165,.418,0,1,.000,69,164,.421,.418,116,131,.885,50,135,185,91,18,9,56,144,254
208,Jawann Oldham\oldhaja01,C,29,NYK,44,9,776,71,174,.408,0,1,.000,71,173,.410,.408,31,57,.544,51,128,179,19,22,71,48,95,173
209,Louis Orr\orrlo01,SF,28,NYK,65,8,1440,166,389,.427,1,5,.200,165,384,.430,.428,125,172,.727,102,130,232,110,47,18,70,123,458
210,Robert Parish*\parisro01,C,33,BOS,80,80,2995,588,1057,.556,0,1,.000,588,1056,.557,.556,227,309,.735,254,597,851,173,64,144,191,266,1403
211,Jim Paxson\paxsoji02,SG,29,POR,72,1,1798,337,733,.460,26,98,.265,311,635,.490,.477,174,216,.806,41,98,139,237,76,12,108,134,874
212,John Paxson\paxsojo01,PG,26,CHI,82,64,2689,386,793,.487,52,140,.371,334,653,.511,.520,106,131,.809,22,117,139,467,66,8,105,207,930
213,Sam Perkins\perkisa01,PF,25,DAL,80,80,2687,461,957,.482,19,54,.352,442,903,.489,.492,245,296,.828,197,419,616,146,109,77,132,269,1186
214,Chuck Person\persoch01,SF,22,IND,82,78,2956,635,1358,.468,49,138,.355,586,1220,.480,.486,222,297,.747,168,509,677,295,90,16,211,310,1541
215,Jim Petersen\peterji01,PF,24,HOU,82,56,2403,386,755,.511,0,4,.000,386,751,.514,.511,152,209,.727,177,380,557,127,43,102,152,268,924
216,Michael Phelps\phelpmi01,SG,25,SEA,60,6,469,75,176,.426,1,10,.100,74,166,.446,.429,31,44,.705,16,34,50,64,21,2,32,60,182
217,Ricky Pierce\piercri01,SG,27,MIL,79,31,2505,575,1077,.534,3,28,.107,572,1049,.545,.535,387,440,.880,117,149,266,144,64,24,120,222,1540
218,Ed Pinckney\pincked01,SF,23,PHO,80,65,2250,290,497,.584,0,2,.000,290,495,.586,.584,257,348,.739,179,401,580,116,86,54,135,196,837
219,Dwayne Polee\poleedw01,SG,23,LAC,1,0,6,1,4,.250,0,3,.000,1,1,1.000,.250,0,0,,0,0,0,0,1,0,1,3,2
220,Ben Poquette\poquebe01,PF,31,TOT,58,2,604,62,122,.508,0,4,.000,62,118,.525,.508,40,50,.800,30,71,101,35,9,34,21,77,164
220,Ben Poquette\poquebe01,PF,31,CLE,37,1,437,41,82,.500,0,3,.000,41,79,.519,.500,31,39,.795,20,57,77,28,6,22,17,51,113
220,Ben Poquette\poquebe01,PF,31,CHI,21,1,167,21,40,.525,0,1,.000,21,39,.538,.525,9,11,.818,10,14,24,7,3,12,4,26,51
221,Terry Porter\portete01,PG,23,POR,80,80,2714,376,770,.488,13,60,.217,363,710,.511,.497,280,334,.838,70,267,337,715,159,9,255,192,1045
222,Paul Pressey\presspa01,SF,28,MIL,61,60,2057,294,616,.477,16,55,.291,278,561,.496,.490,242,328,.738,98,198,296,441,110,47,186,213,846
223,Harold Pressley\pressha01,SF,23,SAC,67,23,913,134,317,.423,7,28,.250,127,289,.439,.434,35,48,.729,68,108,176,120,40,21,63,96,310
224,Mark Price\pricema01,PG,22,CLE,67,0,1217,173,424,.408,23,70,.329,150,354,.424,.435,95,114,.833,33,84,117,202,43,4,105,75,464
225,Kurt Rambis\rambiku01,PF,28,LAL,78,10,1514,163,313,.521,0,0,,163,313,.521,.521,120,157,.764,159,294,453,63,74,41,104,201,446
226,Blair Rasmussen\rasmubl01,C,24,DEN,74,23,1421,268,570,.470,0,0,,268,570,.470,.470,169,231,.732,183,282,465,60,24,58,79,224,705
227,Robert Reid\reidro01,SG,31,HOU,75,63,2594,420,1006,.417,53,162,.327,367,844,.435,.444,136,177,.768,47,242,289,323,75,21,104,232,1029
228,Jerry Reynolds\reynoje01,SF,24,MIL,58,24,963,140,356,.393,6,18,.333,134,338,.396,.402,118,184,.641,72,101,173,106,50,30,82,91,404
229,Clint Richardson\richacl01,SG,30,IND,78,14,1396,218,467,.467,6,17,.353,212,450,.471,.473,59,74,.797,51,92,143,241,49,7,85,106,501
230,Doc Rivers\riverdo01,PG,25,ATL,82,82,2590,342,758,.451,4,21,.190,338,737,.459,.454,365,441,.828,83,216,299,823,171,30,217,287,1053
231,Fred Roberts\roberfr01,PF,26,BOS,73,11,1079,139,270,.515,0,3,.000,139,267,.521,.515,124,153,.810,54,136,190,62,22,20,89,129,402
232,Alvin Robertson\roberal01,SG,24,SAS,81,78,2697,589,1264,.466,13,48,.271,576,1216,.474,.471,244,324,.753,186,238,424,421,260,35,243,264,1435
233,Cliff Robinson\robincl01,PF,26,PHI,55,30,1586,338,729,.464,0,4,.000,338,725,.466,.464,139,184,.755,86,221,307,89,86,30,123,150,815
234,Dennis Rodman*\rodmade01,SF,25,DET,77,1,1155,213,391,.545,0,1,.000,213,390,.546,.545,74,126,.587,163,169,332,56,38,48,93,166,500
235,Johnny Rogers\rogerjo01,PF,23,SAC,45,15,468,90,185,.486,0,5,.000,90,180,.500,.486,9,15,.600,30,47,77,26,9,8,20,66,189
236,Tree Rollins\rollitr01,C,31,ATL,75,58,1764,171,313,.546,0,0,,171,313,.546,.546,63,87,.724,155,333,488,22,43,140,61,240,405
237,Dan Roundfield\roundda01,PF,33,WSB,36,0,669,90,220,.409,1,5,.200,89,215,.414,.411,57,72,.792,64,106,170,39,11,16,49,77,238
238,Ron Rowan\rowanro01,SG,24,POR,7,0,16,4,9,.444,1,1,1.000,3,8,.375,.500,3,4,.750,1,0,1,1,4,0,3,1,12
239,Jeff Ruland\rulanje01,PF,28,PHI,5,2,116,19,28,.679,0,0,,19,28,.679,.679,9,12,.750,12,16,28,10,0,4,10,13,47
240,Walker Russell\russewa01,PG,26,IND,48,0,511,64,165,.388,2,16,.125,62,149,.416,.394,27,37,.730,18,37,55,129,20,5,60,62,157
241,John Salley\sallejo01,C,22,DET,82,2,1463,163,290,.562,0,1,.000,163,289,.564,.562,105,171,.614,108,188,296,54,44,125,74,256,431
242,Ralph Sampson*\sampsra01,PF,26,HOU,43,32,1326,277,566,.489,0,3,.000,277,563,.492,.489,118,189,.624,88,284,372,120,40,58,126,169,672
243,Mike Sanders\sandemi01,SF,26,PHO,82,4,1655,357,722,.494,2,17,.118,355,705,.504,.496,143,183,.781,101,170,271,126,61,23,105,210,859
244,Danny Schayes\schayda01,C,27,DEN,76,41,1556,210,405,.519,0,0,,210,405,.519,.519,229,294,.779,120,260,380,85,20,74,95,266,649
245,Russ Schoene\schoeru01,PF,26,SEA,63,0,579,71,190,.374,2,13,.154,69,177,.390,.379,29,46,.630,52,65,117,27,20,11,42,94,173
246,Detlef Schrempf\schrede01,SF,24,DAL,81,5,1711,265,561,.472,33,69,.478,232,492,.472,.502,193,260,.742,87,216,303,161,50,16,110,224,756
247,John Schweitz\schwejo01,SG,26,DET,3,0,7,0,1,.000,0,0,,0,1,.000,.000,0,0,,0,1,1,0,0,0,2,2,0
248,Byron Scott\scottby01,SG,25,LAL,82,82,2729,554,1134,.489,65,149,.436,489,985,.496,.517,224,251,.892,63,223,286,281,125,18,144,163,1397
249,Carey Scurry\scurrca01,SF,24,UTA,69,5,753,123,247,.498,4,13,.308,119,234,.509,.506,94,134,.701,97,101,198,57,55,54,56,124,344
250,Brad Sellers\sellebr01,PF,24,CHI,80,17,1751,276,606,.455,2,10,.200,274,596,.460,.457,126,173,.728,155,218,373,102,44,68,84,194,680
251,Purvis Short\shortpu01,SF,29,GSW,34,15,950,240,501,.479,4,17,.235,236,484,.488,.483,137,160,.856,55,82,137,86,45,7,68,103,621
252,Jerry Sichting\sichtje01,PG,30,BOS,78,15,1566,202,398,.508,7,26,.269,195,372,.524,.516,37,42,.881,22,69,91,187,40,1,61,124,448
253,Jack Sikma\sikmaja01,C,31,MIL,82,82,2536,390,842,.463,0,2,.000,390,840,.464,.463,265,313,.847,208,614,822,203,88,90,160,328,1045
254,McKinley Singleton\singlmc01,PG,25,NYK,2,0,10,2,3,.667,0,1,.000,2,2,1.000,.667,0,0,,0,0,0,1,0,0,0,1,4
255,Scott Skiles\skilesc01,PG,22,MIL,13,0,205,18,62,.290,3,14,.214,15,48,.313,.315,10,12,.833,6,20,26,45,5,1,21,18,49
256,Clinton Smith\smithcl01,SG,23,GSW,41,0,341,50,117,.427,0,2,.000,50,115,.435,.427,27,36,.750,26,30,56,45,13,1,26,36,127
257,Derek Smith\smithde02,SG,25,SAC,52,42,1658,338,757,.446,9,33,.273,329,724,.454,.452,178,228,.781,60,122,182,204,46,23,126,184,863
258,Keith Smith\smithke03,SG,22,MIL,42,4,461,57,150,.380,3,9,.333,54,141,.383,.390,21,28,.750,13,19,32,43,25,3,30,74,138
259,Larry Smith\smithla01,PF,29,GSW,80,78,2374,297,544,.546,0,1,.000,297,543,.547,.546,113,197,.574,366,551,917,95,71,56,135,295,707
260,Otis Smith\smithot01,SG,23,DEN,28,0,168,33,79,.418,0,2,.000,33,77,.429,.418,12,21,.571,17,17,34,22,1,1,19,30,78
261,Mike Smrek\smrekmi01,C,24,LAL,35,3,233,30,60,.500,0,0,,30,60,.500,.500,16,25,.640,13,24,37,5,4,13,19,70,76
262,Rory Sparrow\sparrro01,PG,28,NYK,80,30,1951,263,590,.446,11,42,.262,252,548,.460,.455,71,89,.798,29,86,115,432,67,6,140,160,608
263,Terence Stansbury\stanste01,SG,25,SEA,44,0,375,67,156,.429,11,29,.379,56,127,.441,.465,31,50,.620,8,16,24,57,13,0,29,78,176
264,Brook Steppe\steppbr01,SG,27,SAC,34,7,665,95,199,.477,3,9,.333,92,190,.484,.485,73,88,.830,21,40,61,81,18,3,54,56,266
265,Steve Stipanovich\stipast01,C,26,IND,81,81,2761,382,760,.503,1,4,.250,381,756,.504,.503,307,367,.837,184,486,670,180,106,97,130,304,1072
266,John Stockton*\stockjo01,PG,24,UTA,82,2,1858,231,463,.499,7,39,.179,224,424,.528,.506,179,229,.782,32,119,151,670,177,14,164,224,648
267,Jon Sundvold\sundvjo01,PG,25,SAS,76,42,1765,365,751,.486,50,149,.336,315,602,.523,.519,70,84,.833,20,78,98,315,35,0,97,109,850
268,Roy Tarpley\tarplro01,PF,22,DAL,75,1,1405,233,499,.467,1,3,.333,232,496,.468,.468,94,139,.676,180,353,533,52,56,79,101,232,561
269,Jeff Taylor\tayloje01,SG,27,DET,12,0,44,6,10,.600,0,0,,6,10,.600,.600,9,10,.900,1,3,4,3,2,1,8,4,21
270,Terry Teagle\teaglte01,SG,26,GSW,82,0,1650,370,808,.458,0,10,.000,370,798,.464,.458,182,234,.778,68,107,175,105,68,13,117,190,922
271,Reggie Theus\theusre01,PG,29,SAC,79,76,2872,577,1223,.472,17,78,.218,560,1145,.489,.479,429,495,.867,86,180,266,692,78,16,289,208,1600
272,David Thirdkill\thirdda01,SF,26,BOS,17,0,89,10,24,.417,0,1,.000,10,23,.435,.417,5,16,.313,5,14,19,2,2,0,5,12,25
273,Isiah Thomas*\thomais01,PG,25,DET,81,81,3013,626,1353,.463,19,98,.194,607,1255,.484,.470,400,521,.768,82,237,319,813,153,20,343,251,1671
274,Bernard Thompson\thompbe01,SF,24,PHO,24,2,331,42,105,.400,0,3,.000,42,102,.412,.400,27,33,.818,20,11,31,18,11,5,16,53,111
275,Billy Thompson\thompbi01,SF,23,LAL,59,0,762,142,261,.544,0,1,.000,142,260,.546,.544,48,74,.649,69,102,171,60,15,30,61,148,332
276,LaSalle Thompson\thompla01,C,25,SAC,82,53,2166,362,752,.481,0,5,.000,362,747,.485,.481,188,255,.737,237,450,687,122,69,126,143,290,912
277,Mychal Thompson\thompmy01,PF,32,TOT,82,7,1890,359,797,.450,1,2,.500,358,795,.450,.451,219,297,.737,138,274,412,115,45,71,134,202,938
277,Mychal Thompson\thompmy01,PF,32,SAS,49,6,1210,230,528,.436,1,1,1.000,229,527,.435,.437,144,196,.735,91,185,276,87,31,41,77,117,605
277,Mychal Thompson\thompmy01,PF,32,LAL,33,1,680,129,269,.480,0,1,.000,129,268,.481,.480,75,101,.743,47,89,136,28,14,30,57,85,333
278,Bob Thornton\thornbo01,PF,24,NYK,33,4,282,29,67,.433,0,1,.000,29,66,.439,.433,13,20,.650,18,38,56,8,4,3,24,48,71
279,Otis Thorpe\thorpot01,PF,24,SAC,82,82,2956,567,1050,.540,0,3,.000,567,1047,.542,.540,413,543,.761,259,560,819,201,46,60,189,292,1547
280,Sedale Threatt\threase01,PG,25,TOT,68,8,1446,239,534,.448,7,32,.219,232,502,.462,.454,95,119,.798,26,82,108,259,74,13,89,164,580
280,Sedale Threatt\threase01,PG,25,PHI,28,8,668,108,261,.414,7,16,.438,101,245,.412,.427,42,53,.792,18,39,57,82,32,4,47,76,265
280,Sedale Threatt\threase01,PG,25,CHI,40,0,778,131,273,.480,0,16,.000,131,257,.510,.480,53,66,.803,8,43,51,177,42,9,42,88,315
281,Wayman Tisdale\tisdawa01,PF,22,IND,81,15,2159,458,892,.513,0,2,.000,458,890,.515,.513,258,364,.709,217,258,475,117,50,26,139,293,1174
282,Andrew Toney\toneyan01,SG,29,PHI,52,12,1058,197,437,.451,22,67,.328,175,370,.473,.476,133,167,.796,16,69,85,188,18,8,112,78,549
283,Kelly Tripucka\tripuke01,SF,27,UTA,79,76,1865,291,621,.469,19,52,.365,272,569,.478,.484,197,226,.872,54,188,242,243,85,11,167,147,798
284,Trent Tucker\tucketr01,SG,27,NYK,70,15,1691,325,691,.470,68,161,.422,257,530,.485,.520,77,101,.762,49,86,135,166,116,13,78,169,795
285,Andre Turner\turnean01,PG,22,BOS,3,0,18,2,5,.400,0,1,.000,2,4,.500,.400,0,0,,1,1,2,1,0,0,5,1,4
286,Elston Turner\turneel01,SF,27,CHI,70,4,936,112,252,.444,1,8,.125,111,244,.455,.446,23,31,.742,34,81,115,102,30,4,31,97,248
287,Jeff Turner\turneje01,PF,24,NJN,76,22,1003,151,325,.465,0,1,.000,151,324,.466,.465,76,104,.731,80,117,197,60,33,13,81,200,378
288,Melvin Turpin\turpime01,C,26,CLE,64,1,801,169,366,.462,0,0,,169,366,.462,.462,55,77,.714,62,128,190,33,11,40,63,90,393
289,Terry Tyler\tylerte01,SF,30,SAC,82,48,1930,329,664,.495,1,3,.333,328,661,.496,.496,101,140,.721,116,212,328,73,55,78,78,151,760
290,Darnell Valentine\valenda01,PG,27,LAC,65,52,1759,275,671,.410,13,56,.232,262,615,.426,.420,163,200,.815,38,112,150,447,116,10,167,148,726
291,Kiki Vandeweghe\vandeki01,SF,28,POR,79,79,3029,808,1545,.523,39,81,.481,769,1464,.525,.536,467,527,.886,86,165,251,220,52,17,139,137,2122
292,Nick Vanos\vanosni01,C,23,PHO,57,14,640,65,158,.411,0,2,.000,65,156,.417,.411,38,59,.644,67,113,180,43,19,23,48,94,168
293,Pete Verhoeven\verhope01,PF,27,IND,5,0,44,5,14,.357,0,0,,5,14,.357,.357,0,0,,2,5,7,2,2,1,0,11,10
294,Jay Vincent\vinceja01,SF,27,WSB,51,17,1386,274,613,.447,0,3,.000,274,610,.449,.447,130,169,.769,69,141,210,85,40,17,77,127,678
295,Sam Vincent\vincesa01,PG,23,BOS,46,5,374,60,136,.441,0,0,,60,136,.441,.441,51,55,.927,5,22,27,59,13,1,33,33,171
296,Danny Vranes\vraneda01,SF,28,PHI,58,6,817,59,138,.428,1,5,.200,58,133,.436,.431,21,45,.467,51,95,146,30,35,25,26,127,140
297,Granville Waiters\waitegr01,C,26,CHI,44,26,534,40,93,.430,0,1,.000,40,92,.435,.430,5,9,.556,38,49,87,22,10,31,16,83,85
298,Darrell Walker\walkeda01,PG,25,DEN,81,25,2020,358,742,.482,0,4,.000,358,738,.485,.482,272,365,.745,157,170,327,282,120,37,187,229,988
299,Kenny Walker\walkeke01,SF,22,NYK,68,64,1719,285,581,.491,0,4,.000,285,577,.494,.491,140,185,.757,118,220,338,75,49,49,75,236,710
300,Bill Walton*\waltobi01,C,34,BOS,10,0,112,10,26,.385,0,0,,10,26,.385,.385,8,15,.533,11,20,31,9,1,10,15,23,28
301,Chris Washburn\washbch01,C,21,GSW,35,2,385,57,145,.393,0,1,.000,57,144,.396,.393,18,51,.353,36,65,101,16,6,8,39,51,132
302,Pearl Washington\washipe01,PG,23,NJN,72,61,1600,257,538,.478,4,24,.167,253,514,.492,.481,98,125,.784,37,92,129,301,92,7,175,184,616
303,Spud Webb\webbsp01,PG,23,ATL,33,0,532,71,162,.438,1,6,.167,70,156,.449,.441,80,105,.762,6,54,60,167,34,2,70,65,223
304,Marvin Webster\webstma01,C,34,MIL,15,0,102,10,19,.526,1,1,1.000,9,18,.500,.553,6,8,.750,12,14,26,3,3,7,8,17,27
305,Scott Wedman\wedmasc01,SF,34,BOS,6,2,78,9,27,.333,1,2,.500,8,25,.320,.352,1,2,.500,3,6,9,6,2,2,3,6,20
306,Bill Wennington\wennibi01,C,23,DAL,58,0,560,56,132,.424,0,2,.000,56,130,.431,.424,45,60,.750,53,76,129,24,13,10,39,95,157
307,Mark West\westma01,C,26,CLE,78,13,1333,209,385,.543,0,2,.000,209,383,.546,.543,89,173,.514,126,213,339,41,22,81,106,229,507
308,Ennis Whatley\whatlen01,PG,24,WSB,73,72,1816,246,515,.478,0,2,.000,246,513,.480,.478,126,165,.764,58,136,194,392,92,10,138,172,618
309,Rory White\whitero01,SF,27,LAC,68,35,1545,265,552,.480,0,3,.000,265,549,.483,.480,94,144,.653,90,104,194,79,47,19,73,159,624
310,Jerome Whitehead\whiteje01,C,30,GSW,73,1,937,147,327,.450,0,1,.000,147,326,.451,.450,79,113,.699,110,152,262,24,16,12,50,175,373
311,Mitchell Wiggins\wiggimi01,SG,27,HOU,32,19,788,153,350,.437,0,5,.000,153,345,.443,.437,49,65,.754,74,59,133,76,44,3,50,82,355
312,Dominique Wilkins*\wilkido01,SF,27,ATL,79,79,2969,828,1787,.463,31,106,.292,797,1681,.474,.472,607,742,.818,210,284,494,261,117,51,215,149,2294
313,Eddie Lee Wilkins\wilkied01,PF,24,NYK,24,10,454,56,127,.441,0,1,.000,56,126,.444,.441,27,58,.466,45,62,107,6,9,2,28,67,139
314,Gerald Wilkins\wilkige01,SG,23,NYK,80,73,2758,633,1302,.486,26,74,.351,607,1228,.494,.496,235,335,.701,120,174,294,354,88,18,214,165,1527
315,Buck Williams\willibu01,PF,26,NJN,82,82,2976,521,936,.557,0,1,.000,521,935,.557,.557,430,588,.731,322,701,1023,129,78,91,280,315,1472
316,Gus Williams\willigu01,SG,33,ATL,33,0,481,53,146,.363,5,18,.278,48,128,.375,.380,27,40,.675,8,32,40,139,17,5,54,53,138
317,Herb Williams\willihe01,PF,28,IND,74,67,2526,451,939,.480,0,9,.000,451,930,.485,.480,199,269,.740,143,400,543,174,59,93,145,255,1101
318,Hot Rod Williams\williho01,PF,24,CLE,80,80,2714,435,897,.485,0,1,.000,435,896,.485,.485,298,400,.745,222,407,629,154,58,167,139,197,1168
319,John Williams\willijo02,SF,20,WSB,78,6,1773,283,624,.454,8,36,.222,275,588,.468,.460,144,223,.646,130,236,366,191,129,30,122,173,718
320,Kevin Williams\willike01,SG,25,SEA,65,0,703,132,296,.446,0,7,.000,132,289,.457,.446,55,66,.833,47,36,83,66,45,8,63,154,319
321,Pete Williams\willipe01,PF,21,DEN,5,0,10,1,2,.500,0,0,,1,2,.500,.500,0,0,,0,1,1,1,0,0,1,1,2
322,Ray Williams\willira01,PG,32,NJN,32,14,800,131,290,.452,7,28,.250,124,262,.473,.464,49,60,.817,26,49,75,185,38,9,94,111,318
323,Kevin Willis\willike02,PF,24,ATL,81,81,2626,538,1003,.536,1,4,.250,537,999,.538,.537,227,320,.709,321,528,849,62,65,61,173,313,1304
324,Michael Wilson\wilsomi01,SG-PG,27,TOT,7,0,45,3,10,.300,0,0,,3,10,.300,.300,2,2,1.000,1,3,4,7,1,0,5,10,8
324,Michael Wilson\wilsomi01,SG,27,NJN,5,0,43,3,8,.375,0,0,,3,8,.375,.375,2,2,1.000,1,3,4,6,1,0,4,9,8
324,Michael Wilson\wilsomi01,PG,27,ATL,2,0,2,0,2,.000,0,0,,0,2,.000,.000,0,0,,0,0,0,1,0,0,1,1,0
325,Othell Wilson\wilsoot01,PG,25,SAC,53,2,789,82,185,.443,3,18,.167,79,167,.473,.451,43,54,.796,28,53,81,207,42,4,77,67,210
326,David Wingate\wingada01,SG,23,PHI,77,9,1612,259,602,.430,13,52,.250,246,550,.447,.441,149,201,.741,70,86,156,155,93,19,128,169,680
327,Randy Wittman\wittmra01,SG,27,ATL,71,65,2049,398,792,.503,4,12,.333,394,780,.505,.505,100,127,.787,30,94,124,211,39,16,88,107,900
328,Al Wood\woodal01,SG,28,DAL,54,0,657,121,310,.390,7,25,.280,114,285,.400,.402,109,139,.784,39,55,94,34,19,11,34,83,358
329,Leon Wood\woodle01,PG,24,NJN,76,7,1733,187,501,.373,60,200,.300,127,301,.422,.433,123,154,.799,23,97,120,370,48,3,108,126,557
330,Mike Woodson\woodsmi01,SG,28,LAC,74,66,2126,494,1130,.437,34,123,.276,460,1007,.457,.452,240,290,.828,68,94,162,196,100,16,168,201,1262
331,Orlando Woolridge\woolror01,SF,27,NJN,75,53,2638,556,1067,.521,1,8,.125,555,1059,.524,.522,438,564,.777,118,249,367,261,54,86,213,243,1551
332,James Worthy*\worthja01,SF,25,LAL,82,82,2819,651,1207,.539,0,13,.000,651,1194,.545,.539,292,389,.751,158,308,466,226,108,83,168,206,1594
333,Brad Wright\wrighbr01,PF,24,NYK,14,0,138,20,46,.435,0,1,.000,20,45,.444,.435,12,28,.429,25,28,53,1,3,6,13,20,52
334,Danny Young\youngda01,PG,24,SEA,73,26,1482,132,288,.458,29,79,.367,103,209,.493,.509,59,71,.831,23,90,113,353,74,3,85,72,352
335,Perry Young\youngpe01,SG,23,TOT,9,0,72,6,21,.286,0,0,,6,21,.286,.286,1,2,.500,3,5,8,7,5,1,4,14,13
335,Perry Young\youngpe01,SG,23,CHI,5,0,20,2,4,.500,0,0,,2,4,.500,.500,1,2,.500,0,1,1,0,1,0,1,3,5
335,Perry Young\youngpe01,SG,23,POR,4,0,52,4,17,.235,0,0,,4,17,.235,.235,0,0,,3,4,7,7,4,1,3,11,8