
Rk,Player,Pos,Age,Tm,G,GS,MP,FG,FGA,FG%,3P,3PA,3P%,2P,2PA,2P%,eFG%,FT,FTA,FT%,ORB,DRB,TRB,AST,STL,BLK,TOV,PF,PTS
1,Kareem Abdul-Jabbar*\abdulka01,C,41,LAL,74,74,1695,313,659,.475,0,3,.000,313,656,.477,.475,122,165,.739,103,231,334,74,38,85,95,196,748
2,Mark Acres\acresma01,C,26,BOS,62,0,632,55,114,.482,1,1,1.000,54,113,.478,.487,26,48,.542,59,87,146,19,19,6,23,94,137
3,Michael Adams\adamsmi01,PG,26,DEN,77,77,2787,468,1082,.433,166,466,.356,302,616,.490,.509,322,393,.819,71,212,283,490,166,11,180,149,1424
4,Mark Aguirre\aguirma01,SF,29,TOT,80,76,2597,586,1270,.461,51,174,.293,535,1096,.488,.481,288,393,.733,146,240,386,278,45,36,208,229,1511
4,Mark Aguirre\aguirma01,SF,29,DAL,44,44,1529,373,829,.450,29,99,.293,344,730,.471,.467,178,244,.730,90,145,235,189,29,29,140,128,953
4,Mark Aguirre\aguirma01,SF,29,DET,36,32,1068,213,441,.483,22,75,.293,191,366,.522,.508,110,149,.738,56,95,151,89,16,7,68,101,558
5,Danny Ainge\aingeda01,PG,29,TOT,73,54,2377,480,1051,.457,116,305,.380,364,746,.488,.512,205,240,.854,71,184,255,402,93,8,145,186,1281
5,Danny Ainge\aingeda01,PG,29,BOS,45,28,1349,271,589,.460,58,155,.374,213,434,.491,.509,114,128,.891,37,117,154,215,52,1,82,108,714
5,Danny Ainge\aingeda01,PG,29,SAC,28,26,1028,209,462,.452,58,150,.387,151,312,.484,.515,91,112,.813,34,67,101,187,41,7,63,78,567
6,Mark Alarie\alarima01,PF,25,WSB,74,5,1141,206,431,.478,13,38,.342,193,393,.491,.493,73,87,.839,103,152,255,63,25,22,62,160,498
7,Steve Alford\alforst01,PG,24,TOT,66,3,906,148,324,.457,20,55,.364,128,269,.476,.488,50,61,.820,10,62,72,92,45,3,45,57,366
7,Steve Alford\alforst01,PG,24,DAL,9,0,38,3,11,.273,0,2,.000,3,9,.333,.273,1,2,.500,0,3,3,9,1,0,1,3,7
7,Steve Alford\alforst01,PG,24,GSW,57,3,868,145,313,.463,20,53,.377,125,260,.481,.495,49,59,.831,10,59,69,83,44,3,44,54,359
8,Randy Allen\allenra01,SG,24,SAC,7,0,43,8,19,.421,0,1,.000,8,18,.444,.421,1,2,.500,3,4,7,0,1,1,2,7,17
9,Greg Anderson\andergr01,PF,24,SAS,82,56,2401,460,914,.503,0,3,.000,460,911,.505,.503,207,403,.514,255,421,676,61,102,103,180,221,1127
10,Michael Anderson\andermi01,PG,22,SAS,36,12,730,73,175,.417,1,7,.143,72,168,.429,.420,57,82,.695,44,45,89,153,44,3,84,64,204
11,Richard Anderson\anderri01,PF,28,POR,72,3,1082,145,348,.417,49,141,.348,96,207,.464,.487,32,38,.842,62,169,231,98,44,12,54,100,371
12,Ron Anderson\anderro01,SF,30,PHI,82,12,2618,566,1152,.491,2,11,.182,564,1141,.494,.492,196,229,.856,167,239,406,139,71,23,126,166,1330
13,Willie Anderson\anderwi01,SF,22,SAS,81,79,2738,640,1285,.498,4,21,.190,636,1264,.503,.500,224,289,.775,152,265,417,372,150,62,261,295,1508
14,John Bagley\baglejo01,PG,28,NJN,68,20,1642,200,481,.416,11,54,.204,189,427,.443,.427,89,123,.724,36,108,144,391,72,5,159,117,500
15,Thurl Bailey\baileth01,SF,27,UTA,82,3,2777,615,1272,.483,2,5,.400,613,1267,.484,.484,363,440,.825,115,332,447,138,48,91,208,185,1595
16,Greg Ballard\ballagr01,SF,34,SEA,2,0,15,1,8,.125,0,1,.000,1,7,.143,.125,4,4,1.000,2,5,7,0,0,0,0,3,6
17,Ken Bannister\bannike01,PF,28,LAC,9,2,130,22,36,.611,0,1,.000,22,35,.629,.611,30,53,.566,6,27,33,3,7,2,8,17,74
18,Charles Barkley*\barklch01,PF,25,PHI,79,79,3088,700,1208,.579,35,162,.216,665,1046,.636,.594,602,799,.753,403,583,986,325,126,67,254,262,2037
19,John Battle\battljo01,SG,26,ATL,82,0,1672,287,628,.457,11,34,.324,276,594,.465,.466,194,238,.815,30,110,140,197,42,9,104,125,779
20,Benoit Benjamin\benjabe01,C,24,LAC,79,62,2585,491,907,.541,0,2,.000,491,905,.543,.541,317,426,.744,164,532,696,157,57,221,237,221,1299
21,Ricky Berry\berryri01,SG,24,SAC,64,21,1406,255,567,.450,65,160,.406,190,407,.467,.507,131,166,.789,57,140,197,80,37,22,82,197,706
22,Walter Berry\berrywa01,PF,24,TOT,69,31,1355,254,501,.507,1,2,.500,253,499,.507,.508,100,143,.699,86,181,267,77,29,48,89,183,609
22,Walter Berry\berrywa01,PF,24,NJN,29,17,556,108,231,.468,0,0,,108,231,.468,.468,43,63,.683,32,83,115,20,10,13,40,69,259
22,Walter Berry\berrywa01,PF,24,HOU,40,14,799,146,270,.541,1,2,.500,145,268,.541,.543,57,80,.713,54,98,152,57,19,35,49,114,350
23,Larry Bird*\birdla01,SF,32,BOS,6,6,189,49,104,.471,0,0,,49,104,.471,.471,18,19,.947,1,36,37,29,6,5,11,18,116
24,Otis Birdsong\birdsot01,SG,33,BOS,13,0,108,18,36,.500,1,3,.333,17,33,.515,.514,0,2,.000,4,9,13,9,3,1,12,10,37
25,Uwe Blab\blabuw01,C,26,DAL,37,0,208,24,52,.462,0,0,,24,52,.462,.462,20,25,.800,11,33,44,12,3,13,14,36,68
26,Rolando Blackman\blackro01,SG,29,DAL,78,78,2946,594,1249,.476,30,85,.353,564,1164,.485,.488,316,370,.854,70,203,273,288,65,20,165,137,1534
27,Muggsy Bogues\boguemu01,PG,24,CHH,79,21,1755,178,418,.426,1,13,.077,177,405,.437,.427,66,88,.750,53,112,165,620,111,7,124,141,423
28,Manute Bol\bolma01,C,26,GSW,80,4,1769,127,344,.369,20,91,.220,107,253,.423,.398,40,66,.606,116,346,462,27,11,345,79,226,314
29,Anthony Bowie\bowiean01,SG,25,SAS,18,5,438,72,144,.500,1,5,.200,71,139,.511,.503,10,15,.667,25,31,56,29,18,4,22,43,155
30,Sam Bowie\bowiesa01,C,27,POR,20,0,412,69,153,.451,5,7,.714,64,146,.438,.467,28,49,.571,36,70,106,36,7,33,33,43,171
31,Dudley Bradley\bradldu01,SG,31,ATL,38,0,267,28,86,.326,8,31,.258,20,55,.364,.372,8,16,.500,7,25,32,24,16,2,14,41,72
32,Adrian Branch\brancad01,SF,25,POR,67,4,811,202,436,.463,7,31,.226,195,405,.481,.471,87,120,.725,63,69,132,60,45,3,64,99,498
33,Randy Breuer\breuera01,C,28,MIL,48,4,513,86,179,.480,0,0,,86,179,.480,.480,28,51,.549,51,84,135,22,9,37,29,59,200
34,Frank Brickowski\brickfr01,C,29,SAS,64,60,1822,337,654,.515,0,2,.000,337,652,.517,.515,201,281,.715,148,258,406,131,102,35,165,252,875
35,Scott Brooks\brooksc01,PG,23,PHI,82,6,1372,156,371,.420,55,153,.359,101,218,.463,.495,61,69,.884,19,75,94,306,69,3,65,116,428
36,Mike Brown\brownmi01,C,25,UTA,66,16,1051,104,248,.419,0,0,,104,248,.419,.419,92,130,.708,92,166,258,41,25,17,77,133,300
37,Tony Brown\brownto01,SF-SG,28,TOT,43,0,365,50,118,.424,4,16,.250,46,102,.451,.441,24,31,.774,22,22,44,26,15,4,17,42,128
37,Tony Brown\brownto01,SG,28,HOU,14,0,91,14,45,.311,2,9,.222,12,36,.333,.333,6,8,.750,7,8,15,5,3,0,7,14,36
37,Tony Brown\brownto01,SF,28,MIL,29,0,274,36,73,.493,2,7,.286,34,66,.515,.507,18,23,.783,15,14,29,21,12,4,10,28,92
38,Mark Bryant\bryanma01,PF,23,POR,56,32,803,120,247,.486,0,0,,120,247,.486,.486,40,69,.580,65,114,179,33,20,7,41,144,280
39,Greg Butler\butlegr01,C,22,NYK,33,0,140,20,48,.417,0,3,.000,20,45,.444,.417,16,20,.800,9,19,28,2,1,2,17,28,56
40,Michael Cage\cagemi01,PF,27,SEA,80,71,2536,314,630,.498,0,4,.000,314,626,.502,.498,197,265,.743,276,489,765,126,92,52,124,184,825
41,Tony Campbell\campbto01,SF,26,LAL,63,2,787,158,345,.458,2,21,.095,156,324,.481,.461,70,83,.843,53,77,130,47,37,6,62,108,388
42,Antoine Carr\carran01,PF,27,ATL,78,12,1488,226,471,.480,0,1,.000,226,470,.481,.480,130,152,.855,106,168,274,91,31,62,82,221,582
43,Joe Barry Carroll\carrojo01,C,30,NJN,64,62,1996,363,810,.448,0,0,,363,810,.448,.448,176,220,.800,118,355,473,105,71,81,143,193,902
44,Bill Cartwright\cartwbi01,C,31,CHI,78,76,2333,365,768,.475,0,0,,365,768,.475,.475,236,308,.766,152,369,521,90,21,41,190,234,966
45,Terry Catledge\catlete01,PF,25,WSB,79,77,2077,334,681,.490,1,5,.200,333,676,.493,.491,153,254,.602,230,342,572,75,46,25,120,250,822
46,Ron Cavenall\cavenro01,C,29,NJN,5,0,16,2,3,.667,0,0,,2,3,.667,.667,2,5,.400,0,2,2,0,0,2,2,2,6
47,Tom Chambers\chambto01,PF,29,PHO,81,81,3002,774,1643,.471,28,86,.326,746,1557,.479,.480,509,598,.851,143,541,684,231,87,55,231,271,2085
48,Mike Champion\champmi01,SF,24,SEA,2,0,4,0,3,.000,0,1,.000,0,2,.000,.000,0,0,,0,0,0,0,0,0,1,2,0
49,Rex Chapman\chapmre01,SG,21,CHH,75,44,2219,526,1271,.414,60,191,.314,466,1080,.431,.437,155,195,.795,74,113,187,176,70,25,113,167,1267
50,Maurice Cheeks*\cheekma01,PG,32,PHI,71,70,2298,336,696,.483,1,13,.077,335,683,.490,.483,151,195,.774,39,144,183,554,105,17,116,114,824
51,Derrick Chievous\chievde01,SF,21,HOU,81,1,1539,277,634,.437,5,24,.208,272,610,.446,.441,191,244,.783,114,142,256,77,48,11,136,161,750
52,Ben Coleman\colembe01,PF,27,PHI,58,11,703,117,241,.485,0,0,,117,241,.485,.485,61,77,.792,49,128,177,17,10,18,48,120,295
53,Steve Colter\coltest01,PG,26,WSB,80,5,1425,203,457,.444,3,25,.120,200,432,.463,.447,125,167,.749,62,120,182,225,69,14,64,158,534
54,Dallas Comegys\comegda01,PF,24,SAS,67,10,1119,166,341,.487,0,2,.000,166,339,.490,.487,106,161,.658,112,122,234,30,42,63,85,160,438
55,Lester Conner\connele01,PG,29,NJN,82,63,2532,309,676,.457,13,37,.351,296,639,.463,.467,212,269,.788,100,255,355,604,181,5,181,132,843
56,Darwin Cook\cookda01,SG,30,TOT,66,4,1143,218,478,.456,8,41,.195,210,437,.481,.464,63,78,.808,34,73,107,127,71,10,88,121,507
56,Darwin Cook\cookda01,SG,30,SAS,36,0,757,147,315,.467,6,31,.194,141,284,.496,.476,46,56,.821,21,38,59,84,43,4,62,77,346
56,Darwin Cook\cookda01,SG,30,DEN,30,4,386,71,163,.436,2,10,.200,69,153,.451,.442,17,22,.773,13,35,48,43,28,6,26,44,161
57,Michael Cooper\coopemi01,SG,32,LAL,80,13,1943,213,494,.431,80,210,.381,133,284,.468,.512,81,93,.871,33,158,191,314,72,32,94,186,587
58,Wayne Cooper\coopewa01,C,32,DEN,79,72,1864,220,444,.495,1,4,.250,219,440,.498,.497,79,106,.745,212,407,619,78,36,211,73,302,520
59,Tyrone Corbin\corbity01,SF,26,PHO,77,30,1655,245,454,.540,0,2,.000,245,452,.542,.540,141,179,.788,176,222,398,118,82,13,92,222,631
60,Dave Corzine\corzida01,C,32,CHI,81,7,1483,203,440,.461,2,8,.250,201,432,.465,.464,71,96,.740,92,223,315,103,29,45,93,134,479
61,Winston Crite\critewi01,SF,23,PHO,2,0,6,0,3,.000,0,0,,0,3,.000,.000,0,0,,1,0,1,0,0,0,1,1,0
62,Pat Cummings\cummipa01,PF,32,MIA,53,28,1096,197,394,.500,0,2,.000,197,392,.503,.500,72,97,.742,84,197,281,47,29,18,111,160,466
63,Terry Cummings\cummite01,SF,27,MIL,80,78,2824,730,1563,.467,7,15,.467,723,1548,.467,.469,362,460,.787,281,369,650,198,106,72,201,265,1829
64,Earl Cureton\curetea01,C,31,CHH,82,41,2047,233,465,.501,0,1,.000,233,464,.502,.501,66,123,.537,188,300,488,130,50,61,114,230,532
65,Dell Curry\curryde01,SG,24,CHH,48,0,813,256,521,.491,19,55,.345,237,466,.509,.510,40,46,.870,26,78,104,50,42,4,44,68,571
66,Quintin Dailey\dailequ01,SG,28,LAC,69,51,1722,448,964,.465,1,9,.111,447,955,.468,.465,217,286,.759,69,135,204,154,90,6,122,152,1114
67,Adrian Dantley*\dantlad01,SF,32,TOT,73,67,2422,470,954,.493,0,1,.000,470,953,.493,.493,460,568,.810,117,200,317,171,43,13,163,186,1400
67,Adrian Dantley*\dantlad01,SF,32,DET,42,42,1341,258,495,.521,0,0,,258,495,.521,.521,256,305,.839,53,111,164,93,23,6,81,99,772
67,Adrian Dantley*\dantlad01,SF,32,DAL,31,25,1081,212,459,.462,0,1,.000,212,458,.463,.462,204,263,.776,64,89,153,78,20,7,82,87,628
68,Brad Daugherty\daughbr01,C,23,CLE,78,78,2821,544,1012,.538,1,3,.333,543,1009,.538,.538,386,524,.737,167,551,718,285,63,40,230,175,1475
69,Brad Davis\davisbr01,PG,33,DAL,78,4,1395,183,379,.483,32,102,.314,151,277,.545,.525,99,123,.805,14,94,108,242,48,18,92,151,497
70,Charles Davis\davisch02,SF,30,CHI,49,3,545,81,190,.426,4,15,.267,77,175,.440,.437,19,26,.731,47,67,114,31,11,5,22,58,185
71,Mark Davis\davisma01,SF,25,TOT,33,0,258,49,102,.480,1,10,.100,48,92,.522,.485,28,34,.824,16,21,37,14,13,5,12,39,127
71,Mark Davis\davisma01,SF,25,PHO,2,0,7,1,5,.200,0,1,.000,1,4,.250,.200,2,2,1.000,1,0,1,0,0,0,0,1,4
71,Mark Davis\davisma01,SF,25,MIL,31,0,251,48,97,.495,1,9,.111,47,88,.534,.500,26,32,.813,15,21,36,14,13,5,12,38,123
72,Walter Davis\daviswa03,SG,34,DEN,81,0,1857,536,1076,.498,20,69,.290,516,1007,.512,.507,175,199,.879,41,110,151,190,72,5,132,187,1267
73,Darryl Dawkins\dawkida01,C,32,DET,14,0,48,9,19,.474,0,0,,9,19,.474,.474,9,18,.500,3,4,7,1,0,1,4,13,27
74,Johnny Dawkins\dawkijo01,PG,25,SAS,32,30,1083,177,400,.443,0,4,.000,177,396,.447,.443,100,112,.893,32,69,101,224,55,0,111,64,454
75,Vinny Del Negro\delnevi01,SG,22,SAC,80,2,1556,239,503,.475,6,20,.300,233,483,.482,.481,85,100,.850,48,123,171,206,65,14,77,160,569
76,Fennis Dembo\dembofe01,SF,23,DET,31,0,74,14,42,.333,0,4,.000,14,38,.368,.333,8,10,.800,8,15,23,5,1,0,7,15,36
77,James Donaldson\donalja01,C,31,DAL,53,53,1746,193,337,.573,0,0,,193,337,.573,.573,95,124,.766,158,412,570,38,24,81,83,111,481
78,Greg Dreiling\dreilgr01,C,26,IND,53,4,396,43,77,.558,0,0,,43,77,.558,.558,43,64,.672,39,53,92,18,5,11,39,100,129
79,Clyde Drexler*\drexlcl01,SG,26,POR,78,78,3064,829,1672,.496,27,104,.260,802,1568,.511,.504,438,548,.799,289,326,615,450,213,54,250,269,2123
80,Kevin Duckworth\duckwke01,C,24,POR,79,79,2662,554,1161,.477,0,2,.000,554,1159,.478,.477,324,428,.757,246,389,635,60,56,49,200,300,1432
81,Chris Dudley\dudlech02,C,23,CLE,61,2,544,73,168,.435,0,1,.000,73,167,.437,.435,39,107,.364,72,85,157,21,9,23,44,82,185
82,Joe Dumars*\dumarjo01,SG,25,DET,69,67,2408,456,903,.505,14,29,.483,442,874,.506,.513,260,306,.850,57,115,172,390,63,5,178,103,1186
83,Mike Dunleavy\dunlemi01,PG,34,MIL,2,0,5,1,2,.500,1,2,.500,0,0,,.750,0,0,,0,0,0,0,0,0,0,0,3
84,T.R. Dunn\dunntr01,SG,33,PHO,34,1,321,12,35,.343,0,0,,12,35,.343,.343,9,12,.750,30,30,60,25,12,1,6,35,33
85,Ledell Eackles\eacklle01,SG,22,WSB,80,6,1459,318,732,.434,9,40,.225,309,692,.447,.441,272,346,.786,100,80,180,123,41,5,128,156,917
86,Mark Eaton\eatonma01,C,32,UTA,82,82,2914,188,407,.462,0,0,,188,407,.462,.462,132,200,.660,227,616,843,83,40,315,142,290,508
87,James Edwards\edwarja01,C,33,DET,76,1,1254,211,422,.500,0,2,.000,211,420,.502,.500,133,194,.686,68,163,231,49,11,31,72,226,555
88,Kevin Edwards\edwarke01,SG,23,MIA,79,62,2349,470,1105,.425,10,37,.270,460,1068,.431,.430,144,193,.746,85,177,262,349,139,27,246,154,1094
89,Craig Ehlo\ehlocr01,SG,27,CLE,82,4,1867,249,524,.475,39,100,.390,210,424,.495,.512,71,117,.607,100,195,295,266,110,19,116,161,608
90,Dale Ellis\ellisda01,SG,28,SEA,82,82,3190,857,1710,.501,162,339,.478,695,1371,.507,.549,377,462,.816,156,186,342,164,108,22,218,197,2253
91,Wayne Englestad\englewa01,PF,22,DEN,11,0,50,11,29,.379,0,0,,11,29,.379,.379,6,10,.600,5,11,16,7,1,0,3,12,28
92,Alex English*\englial01,SF,35,DEN,82,82,2990,924,1881,.491,2,8,.250,922,1873,.492,.492,325,379,.858,148,178,326,383,66,12,198,174,2175
93,Patrick Ewing*\ewingpa01,C,26,NYK,80,80,2896,727,1282,.567,0,6,.000,727,1276,.570,.567,361,484,.746,213,527,740,188,117,281,266,311,1815
94,Jim Farmer\farmeji01,SG,24,UTA,37,0,412,57,142,.401,9,20,.450,48,122,.393,.433,29,41,.707,22,33,55,28,9,0,26,41,152
95,Dave Feitl\feitlda01,C,26,WSB,57,36,828,116,266,.436,0,1,.000,116,265,.438,.436,54,65,.831,69,133,202,36,17,18,65,136,286
96,Rolando Ferreira\ferrero01,C,24,POR,12,0,34,1,18,.056,0,0,,1,18,.056,.056,7,8,.875,4,9,13,1,0,1,6,7,9
97,Duane Ferrell\ferredu01,SF,23,ATL,41,0,231,35,83,.422,0,0,,35,83,.422,.422,30,44,.682,19,22,41,10,7,6,12,33,100
98,Vern Fleming\flemive01,PG,26,IND,76,69,2552,419,814,.515,3,23,.130,416,791,.526,.517,243,304,.799,85,225,310,494,77,12,192,212,1084
99,Sleepy Floyd\floydsl01,PG,28,HOU,82,82,2788,396,893,.443,109,292,.373,287,601,.478,.504,261,309,.845,48,258,306,709,124,11,253,196,1162
100,Tellis Frank\frankte01,PF,23,GSW,32,2,245,34,91,.374,0,1,.000,34,90,.378,.374,39,51,.765,26,35,61,15,14,6,29,59,107
101,Anthony Frederick\fredean01,SF,24,IND,46,0,313,63,125,.504,2,5,.400,61,120,.508,.512,24,34,.706,26,26,52,20,14,6,34,59,152
102,Corey Gaines\gaineco01,SG,23,NJN,32,0,337,27,64,.422,1,5,.200,26,59,.441,.430,12,16,.750,3,16,19,67,15,1,20,27,67
103,Kevin Gamble\gamblke01,SF,23,BOS,44,6,375,75,136,.551,2,11,.182,73,125,.584,.559,35,55,.636,11,31,42,34,14,3,19,40,187
104,Winston Garland\garlawi01,PG,24,GSW,79,79,2661,466,1074,.434,10,43,.233,456,1031,.442,.439,203,251,.809,101,227,328,505,175,14,187,216,1145
105,Tom Garrick\garrito01,SG,22,LAC,71,20,1499,176,359,.490,0,13,.000,176,346,.509,.490,102,127,.803,37,119,156,243,78,9,116,141,454
106,Kenny Gattison\gattike01,PF,24,PHO,2,0,9,0,1,.000,0,0,,0,1,.000,.000,1,2,.500,0,1,1,0,0,0,0,2,1
107,Ben Gillery\gillebe01,C,23,SAC,24,0,84,6,19,.316,0,0,,6,19,.316,.316,13,23,.565,7,16,23,2,2,4,5,29,25
108,Armen Gilliam\gilliar01,PF,24,PHO,74,60,2120,468,930,.503,0,0,,468,930,.503,.503,240,323,.743,165,376,541,52,54,27,140,176,1176
109,Mike Gminski\gminsmi01,C,29,PHI,82,82,2739,556,1166,.477,0,6,.000,556,1160,.479,.477,297,341,.871,213,556,769,138,46,106,129,142,1409
110,Grant Gondrezick\gondrgr01,SG,26,LAC,27,0,244,38,95,.400,3,11,.273,35,84,.417,.416,26,40,.650,15,21,36,34,13,1,17,36,105
111,Orlando Graham\grahaor01,PF,23,GSW,7,0,22,3,10,.300,0,0,,3,10,.300,.300,2,4,.500,8,3,11,0,0,0,2,6,8
112,Ron Grandison\grandro01,PF,24,BOS,72,0,528,59,142,.415,0,10,.000,59,132,.447,.415,59,80,.738,47,45,92,42,18,3,36,71,177
113,Gary Grant\grantga01,PG,23,LAC,71,48,1924,361,830,.435,5,22,.227,356,808,.441,.438,119,162,.735,80,158,238,506,144,9,258,170,846
114,Harvey Grant\grantha01,PF,23,WSB,71,1,1193,181,390,.464,0,1,.000,181,389,.465,.464,34,57,.596,75,88,163,79,35,29,28,147,396
115,Horace Grant\grantho01,PF,23,CHI,79,79,2809,405,781,.519,0,5,.000,405,776,.522,.519,140,199,.704,240,441,681,168,86,62,128,251,950
116,Stuart Gray\grayst01,C,25,IND,72,0,783,72,153,.471,0,1,.000,72,152,.474,.471,44,64,.688,84,161,245,29,11,21,48,128,188
117,Sylvester Gray\graysy01,SF,21,MIA,55,15,1220,167,398,.420,1,4,.250,166,394,.421,.421,105,156,.673,117,169,286,117,36,25,102,144,440
118,Jeff Grayer\grayeje01,SG,23,MIL,11,2,200,32,73,.438,0,2,.000,32,71,.451,.438,17,20,.850,14,21,35,22,10,1,19,15,81
119,A.C. Green\greenac01,PF,25,LAL,82,82,2510,401,758,.529,4,17,.235,397,741,.536,.532,282,359,.786,258,481,739,103,94,55,119,172,1088
120,Rickey Green\greenri01,PG,34,TOT,63,2,871,129,264,.489,3,11,.273,126,253,.498,.494,30,33,.909,11,58,69,187,40,2,61,35,291
120,Rickey Green\greenri01,PG,34,CHH,33,2,370,57,132,.432,1,5,.200,56,127,.441,.436,13,14,.929,4,19,23,82,18,0,28,16,128
120,Rickey Green\greenri01,PG,34,MIL,30,0,501,72,132,.545,2,6,.333,70,126,.556,.553,17,19,.895,7,39,46,105,22,2,33,19,163
121,Sidney Green\greensi02,PF,28,NYK,82,0,1277,194,422,.460,0,3,.000,194,419,.463,.460,129,170,.759,157,237,394,76,47,18,125,172,517
122,Dave Greenwood\greenda01,PF,31,TOT,67,18,1403,167,395,.423,0,0,,167,395,.423,.423,132,176,.750,140,262,402,96,47,52,91,201,466
122,Dave Greenwood\greenda01,PF,31,SAS,38,15,912,105,247,.425,0,0,,105,247,.425,.425,84,105,.800,92,146,238,55,30,24,55,123,294
122,Dave Greenwood\greenda01,PF,31,DEN,29,3,491,62,148,.419,0,0,,62,148,.419,.419,48,71,.676,48,116,164,41,17,28,36,78,172
123,Darrell Griffith\griffda01,SG,30,UTA,82,73,2382,466,1045,.446,61,196,.311,405,849,.477,.475,142,182,.780,77,253,330,130,86,22,141,175,1135
124,Petur Gudmundsson\gudmupe01,C,30,SAS,5,3,70,9,25,.360,0,0,,9,25,.360,.360,3,4,.750,5,11,16,5,1,1,8,15,21
125,Jack Haley\haleyja01,PF,25,CHI,51,1,289,37,78,.474,0,0,,37,78,.474,.474,36,46,.783,21,50,71,10,11,0,26,56,110
126,Bob Hansen\hansebo01,SG,28,UTA,46,9,964,140,300,.467,19,54,.352,121,246,.492,.498,42,75,.560,29,99,128,50,37,6,43,105,341
127,Bill Hanzlik\hanzlbi01,PF,31,DEN,41,0,701,66,151,.437,1,5,.200,65,146,.445,.440,68,87,.782,18,75,93,86,25,5,53,82,201
128,Derek Harper\harpede01,PG,27,DAL,81,81,2968,538,1127,.477,99,278,.356,439,849,.517,.521,229,284,.806,46,182,228,570,172,41,205,219,1404
129,Ron Harper\harpero01,SG,25,CLE,82,82,2851,587,1149,.511,29,116,.250,558,1033,.540,.523,323,430,.751,122,287,409,434,185,74,230,224,1526
130,Steve Harris\harrist01,SG,25,DET,3,0,7,1,4,.250,0,0,,1,4,.250,.250,2,2,1.000,0,2,2,0,1,0,0,1,4
131,Scott Hastings\hastisc01,C,28,MIA,75,6,1206,143,328,.436,9,28,.321,134,300,.447,.450,91,107,.850,72,159,231,59,32,42,68,203,386
132,Hersey Hawkins\hawkihe01,SG,22,PHI,79,79,2577,442,971,.455,71,166,.428,371,805,.461,.492,241,290,.831,51,174,225,239,120,37,158,184,1196
133,Gerald Henderson\hendege01,PG,33,PHI,65,0,986,144,348,.414,33,107,.308,111,241,.461,.461,104,127,.819,17,51,68,140,42,3,73,121,425
134,Rod Higgins\higgiro01,PF,29,GSW,81,1,1887,301,633,.476,66,168,.393,235,465,.505,.528,188,229,.821,111,265,376,160,39,42,76,172,856
135,Roy Hinson\hinsoro01,SF,27,NJN,82,39,2542,495,1027,.482,0,2,.000,495,1025,.483,.482,318,420,.757,152,370,522,71,34,121,165,298,1308
136,Craig Hodges\hodgecr01,SG,28,TOT,59,6,1204,203,430,.472,75,180,.417,128,250,.512,.559,48,57,.842,23,66,89,146,43,4,57,90,529
136,Craig Hodges\hodgecr01,SG,28,PHO,10,0,92,16,36,.444,4,12,.333,12,24,.500,.500,3,4,.750,2,3,5,8,2,0,5,8,39
136,Craig Hodges\hodgecr01,SG,28,CHI,49,6,1112,187,394,.475,71,168,.423,116,226,.513,.565,45,53,.849,21,63,84,138,41,4,52,82,490
137,Mike Holton\holtomi01,PG,27,CHH,67,60,1696,215,504,.427,3,14,.214,212,490,.433,.430,120,143,.839,30,75,105,424,66,12,119,165,553
138,Dave Hoppen\hoppeda01,C,24,CHH,77,36,1419,199,353,.564,1,2,.500,198,351,.564,.565,101,139,.727,123,261,384,57,25,21,77,239,500
139,Dennis Hopson\hopsode01,SG,23,NJN,62,36,1551,299,714,.419,4,27,.148,295,687,.429,.422,186,219,.849,91,111,202,103,70,30,102,150,788
140,Tito Horford\horfoti01,C,23,MIL,25,0,112,15,46,.326,0,0,,15,46,.326,.326,12,19,.632,9,13,22,3,1,7,15,14,42
141,Jeff Hornacek\hornaje01,SG,25,PHO,78,73,2487,440,889,.495,27,81,.333,413,808,.511,.510,147,178,.826,75,191,266,465,129,8,111,188,1054
142,Phil Hubbard\hubbaph01,SF,32,CLE,31,0,191,28,63,.444,0,0,,28,63,.444,.444,17,25,.680,14,26,40,11,6,0,9,20,73
143,Eddie Hughes\hugheed01,PG,28,DEN,26,1,224,28,64,.438,7,22,.318,21,42,.500,.492,7,12,.583,6,13,19,35,17,2,11,30,70
144,Jay Humphries\humphja01,PG,26,MIL,73,50,2220,345,714,.483,25,94,.266,320,620,.516,.501,129,158,.816,70,119,189,405,142,5,160,187,844
145,Marc Iavaroni\iavarma01,PF,32,UTA,77,50,796,72,163,.442,0,1,.000,72,162,.444,.442,36,44,.818,41,91,132,32,11,13,52,99,180
146,Mark Jackson\jacksma01,PG,23,NYK,72,72,2477,479,1025,.467,81,240,.338,398,785,.507,.507,180,258,.698,106,235,341,619,139,7,226,163,1219
147,Michael Jackson\jacksmi02,PG,24,SAC,14,0,70,9,24,.375,2,6,.333,7,18,.389,.417,1,2,.500,1,3,4,11,3,0,4,12,21
148,Avery Johnson\johnsav01,PG,23,SEA,43,0,291,29,83,.349,1,9,.111,28,74,.378,.355,9,16,.563,11,13,24,73,21,3,18,34,68
149,Buck Johnson\johnsbu01,SF,25,HOU,67,51,1850,270,515,.524,1,9,.111,269,506,.532,.525,101,134,.754,114,172,286,126,64,35,110,213,642
150,Dennis Johnson*\johnsde01,PG,34,BOS,72,72,2309,277,638,.434,7,50,.140,270,588,.459,.440,160,195,.821,31,159,190,472,94,21,175,211,721
151,Eddie Johnson\johnsed03,SF,29,PHO,70,7,2043,608,1224,.497,71,172,.413,537,1052,.510,.526,217,250,.868,91,215,306,162,47,7,122,198,1504
152,Frank Johnson\johnsfr01,PG,30,HOU,67,0,879,109,246,.443,1,6,.167,108,240,.450,.445,75,93,.806,22,57,79,181,42,0,102,91,294
153,Kevin Johnson\johnske02,PG,22,PHO,81,81,3179,570,1128,.505,2,22,.091,568,1106,.514,.506,508,576,.882,46,294,340,991,135,24,322,226,1650
154,Magic Johnson*\johnsma02,PG,29,LAL,77,77,2886,579,1137,.509,59,188,.314,520,949,.548,.535,513,563,.911,111,496,607,988,138,22,312,172,1730
155,Steve Johnson\johnsst03,C,31,POR,72,11,1477,296,565,.524,0,0,,296,565,.524,.524,129,245,.527,135,223,358,105,20,44,140,254,721
156,Vinnie Johnson\johnsvi01,SG,32,DET,82,21,2073,462,996,.464,13,44,.295,449,952,.472,.470,193,263,.734,109,146,255,242,74,17,105,155,1130
157,Anthony Jones\jonesan01,SG,26,TOT,33,0,196,29,79,.367,4,16,.250,25,63,.397,.392,14,16,.875,14,14,28,17,11,3,5,20,76
157,Anthony Jones\jonesan01,SG,26,CHI,8,0,65,5,15,.333,0,1,.000,5,14,.357,.333,2,2,1.000,4,4,8,4,2,1,1,7,12
157,Anthony Jones\jonesan01,SG,26,DAL,25,0,131,24,64,.375,4,15,.267,20,49,.408,.406,12,14,.857,10,10,20,13,9,2,4,13,64
158,Bill Jones\jonesbi01,PF,22,NJN,37,0,307,50,102,.490,0,1,.000,50,101,.495,.490,29,43,.674,20,27,47,20,17,6,18,38,129
159,Caldwell Jones\jonesca01,PF,38,POR,72,40,1279,77,183,.421,0,1,.000,77,182,.423,.421,48,61,.787,88,212,300,59,24,85,83,166,202
160,Charles Jones\jonesch01,C,31,WSB,53,45,1154,60,125,.480,0,1,.000,60,124,.484,.480,16,25,.640,77,180,257,42,39,76,39,187,136
161,Charles Jones\jonesch02,PF,27,WSB,43,0,516,38,82,.463,1,3,.333,37,79,.468,.470,33,53,.623,54,86,140,18,18,16,22,49,110
162,Shelton Jones\jonessh01,SF,22,TOT,51,34,682,93,209,.445,0,1,.000,93,208,.447,.445,58,80,.725,32,81,113,42,21,15,47,58,244
162,Shelton Jones\jonessh01,SF,22,SAS,7,0,92,9,25,.360,0,0,,9,25,.360,.360,8,13,.615,6,10,16,7,2,2,7,8,26
162,Shelton Jones\jonessh01,SF,22,GSW,2,0,13,3,5,.600,0,0,,3,5,.600,.600,0,0,,2,0,2,2,3,0,1,0,6
162,Shelton Jones\jonessh01,SF,22,PHI,42,34,577,81,179,.453,0,1,.000,81,178,.455,.453,50,67,.746,24,71,95,33,16,13,39,50,212
163,Michael Jordan*\jordami01,SG,25,CHI,81,81,3255,966,1795,.538,27,98,.276,939,1697,.553,.546,674,793,.850,149,503,652,650,234,65,290,247,2633
164,Tim Kempton\kemptti01,PF,25,CHH,79,0,1341,171,335,.510,0,1,.000,171,334,.512,.510,142,207,.686,91,213,304,102,41,14,121,215,484
165,Steve Kerr\kerrst01,PG,23,PHO,26,0,157,20,46,.435,8,17,.471,12,29,.414,.522,6,9,.667,3,14,17,24,7,0,6,12,54
166,Jerome Kersey\kerseje01,SF,26,POR,76,76,2716,533,1137,.469,6,21,.286,527,1116,.472,.471,258,372,.694,246,383,629,243,137,84,167,277,1330
167,Randolph Keys\keysra01,SF,22,CLE,42,0,331,74,172,.430,1,10,.100,73,162,.451,.433,20,29,.690,23,33,56,19,12,6,21,51,169
168,Albert King\kingal01,SF,29,SAS,46,11,791,141,327,.431,8,32,.250,133,295,.451,.443,37,48,.771,33,107,140,79,27,7,74,97,327
169,Bernard King*\kingbe01,SF,32,WSB,81,81,2559,654,1371,.477,5,30,.167,649,1341,.484,.479,361,441,.819,133,251,384,294,64,13,227,219,1674
170,Greg Kite\kitegr01,C,27,TOT,70,24,942,65,151,.430,0,0,,65,151,.430,.430,20,41,.488,81,162,243,36,27,54,58,161,150
170,Greg Kite\kitegr01,C,27,LAC,58,12,729,49,121,.405,0,0,,49,121,.405,.405,14,31,.452,66,124,190,29,23,46,46,118,112
170,Greg Kite\kitegr01,C,27,CHH,12,12,213,16,30,.533,0,0,,16,30,.533,.533,6,10,.600,15,38,53,7,4,8,12,43,38
171,Joe Kleine\kleinjo01,C,27,TOT,75,13,1411,175,432,.405,0,2,.000,175,430,.407,.405,134,152,.882,124,254,378,67,33,23,104,192,484
171,Joe Kleine\kleinjo01,C,27,SAC,47,11,913,116,303,.383,0,1,.000,116,302,.384,.383,81,88,.920,75,166,241,35,18,18,67,126,313
171,Joe Kleine\kleinjo01,C,27,BOS,28,2,498,59,129,.457,0,1,.000,59,128,.461,.457,53,64,.828,49,88,137,32,15,5,37,66,171
172,Bart Kofoed\kofoeba01,SG,24,UTA,19,0,176,12,33,.364,0,1,.000,12,32,.375,.364,6,11,.545,4,7,11,20,9,0,13,22,30
173,Jon Koncak\koncajo01,C,25,ATL,74,22,1531,141,269,.524,0,3,.000,141,266,.530,.524,63,114,.553,147,306,453,56,54,98,60,238,345
174,Larry Krystkowiak\krystla01,PF,24,MIL,80,77,2472,362,766,.473,4,12,.333,358,754,.475,.475,289,351,.823,198,412,610,107,93,9,147,219,1017
175,Bill Laimbeer\laimbbi01,C,31,DET,81,81,2640,449,900,.499,30,86,.349,419,814,.515,.516,178,212,.840,138,638,776,177,51,100,129,259,1106
176,Jeff Lamp\lampje01,SF,29,LAL,37,0,176,27,69,.391,2,4,.500,25,65,.385,.406,4,5,.800,6,28,34,15,8,2,16,27,60
177,Jerome Lane\laneje01,PF,22,DEN,54,1,550,109,256,.426,0,7,.000,109,249,.438,.426,43,112,.384,87,113,200,60,20,4,50,105,261
178,Andrew Lang\langan01,C,22,PHO,62,25,526,60,117,.513,0,0,,60,117,.513,.513,39,60,.650,54,93,147,9,17,48,28,112,159
179,Allen Leavell\leaveal01,SG,31,HOU,55,3,627,65,188,.346,5,41,.122,60,147,.408,.359,44,60,.733,13,40,53,127,25,5,62,61,179
180,Eric Leckner\leckner01,C,22,UTA,75,0,779,120,220,.545,0,0,,120,220,.545,.545,79,113,.699,48,151,199,16,8,22,69,174,319
181,Keith Lee\leeke01,PF,26,NJN,57,4,840,109,258,.422,0,2,.000,109,256,.426,.422,53,71,.746,73,186,259,42,20,33,53,138,271
182,Jim Les\lesji01,PG,25,UTA,82,0,781,40,133,.301,1,14,.071,39,119,.328,.305,57,73,.781,23,64,87,215,27,5,88,88,138
183,Fat Lever\leverfa01,SG,28,DEN,71,71,2745,558,1221,.457,23,66,.348,535,1155,.463,.466,270,344,.785,187,475,662,559,195,20,157,178,1409
184,Cliff Levingston\levincl01,PF,28,ATL,80,52,2184,300,568,.528,1,5,.200,299,563,.531,.529,133,191,.696,194,304,498,75,97,70,105,270,734
185,Ralph Lewis\lewisra01,SF,25,CHH,42,0,336,58,121,.479,1,3,.333,57,118,.483,.483,19,39,.487,35,26,61,15,11,3,24,28,136
186,Reggie Lewis\lewisre01,SF,23,BOS,81,57,2657,604,1242,.486,3,22,.136,601,1220,.493,.488,284,361,.787,116,261,377,218,124,72,142,258,1495
187,Alton Lister\listeal01,C,30,SEA,82,82,1806,271,543,.499,0,0,,271,543,.499,.499,115,178,.646,207,338,545,54,28,180,117,310,657
188,Rob Lock\lockro01,PF,22,LAC,20,0,110,9,32,.281,0,0,,9,32,.281,.281,12,15,.800,14,18,32,4,3,4,13,15,30
189,Brad Lohaus\lohaubr01,PF,24,TOT,77,25,1214,210,486,.432,1,11,.091,209,475,.440,.433,81,103,.786,84,172,256,66,30,56,77,161,502
189,Brad Lohaus\lohaubr01,PF,24,BOS,48,15,738,117,270,.433,0,4,.000,117,266,.440,.433,35,46,.761,47,95,142,49,21,26,49,101,269
189,Brad Lohaus\lohaubr01,PF,24,SAC,29,10,476,93,216,.431,1,7,.143,92,209,.440,.433,46,57,.807,37,77,114,17,9,30,28,60,233
190,Grant Long\longgr01,PF,22,MIA,82,73,2435,336,692,.486,0,5,.000,336,687,.489,.486,304,406,.749,240,306,546,149,122,48,201,337,976
191,John Long\longjo01,SG,32,TOT,68,1,919,147,359,.409,8,20,.400,139,339,.410,.421,70,76,.921,18,59,77,80,29,3,57,84,372
191,John Long\longjo01,SG,32,IND,44,1,767,128,319,.401,8,20,.400,120,299,.401,.414,59,63,.937,16,50,66,65,29,1,48,68,323
191,John Long\longjo01,SG,32,DET,24,0,152,19,40,.475,0,0,,19,40,.475,.475,11,13,.846,2,9,11,15,0,2,9,16,49
192,Sidney Lowe\lowesi01,SG,29,CHH,14,0,250,8,25,.320,0,2,.000,8,23,.348,.320,7,11,.636,6,28,34,93,14,0,9,28,23
193,John Lucas\lucasjo01,PG,35,SEA,74,8,842,119,299,.398,18,68,.265,101,231,.437,.428,54,77,.701,22,57,79,260,60,1,66,53,310
194,Rick Mahorn\mahorri01,PF,30,DET,72,61,1795,203,393,.517,0,2,.000,203,391,.519,.517,116,155,.748,141,355,496,59,40,66,97,206,522
195,Dan Majerle\majerda01,SG,23,PHO,54,5,1354,181,432,.419,27,82,.329,154,350,.440,.450,78,127,.614,62,147,209,130,63,14,48,139,467
196,Jeff Malone\malonje01,SG,27,WSB,76,75,2418,677,1410,.480,1,19,.053,676,1391,.486,.480,296,340,.871,55,124,179,219,39,14,165,155,1651
197,Karl Malone*\malonka01,PF,25,UTA,80,80,3126,809,1559,.519,5,16,.313,804,1543,.521,.521,703,918,.766,259,594,853,219,144,70,285,286,2326
198,Moses Malone*\malonmo01,C,33,ATL,81,80,2878,538,1096,.491,0,12,.000,538,1084,.496,.491,561,711,.789,386,570,956,112,79,100,245,154,1637
199,Danny Manning\mannida01,PF,22,LAC,26,18,950,177,358,.494,1,5,.200,176,353,.499,.496,79,103,.767,70,101,171,81,44,25,93,89,434
200,Pace Mannion\mannipa01,SF,28,TOT,10,0,32,4,8,.500,0,2,.000,4,6,.667,.500,0,0,,0,5,5,2,3,0,3,5,8
200,Pace Mannion\mannipa01,SF,28,DET,5,0,14,2,2,1.000,0,0,,2,2,1.000,1.000,0,0,,0,3,3,0,1,0,0,3,4
200,Pace Mannion\mannipa01,SF,28,ATL,5,0,18,2,6,.333,0,2,.000,2,4,.500,.333,0,0,,0,2,2,2,2,0,3,2,4
201,Vernon Maxwell\maxweve01,SG,23,SAS,79,36,2065,357,827,.432,32,129,.248,325,698,.466,.451,181,243,.745,49,153,202,301,86,8,178,136,927
202,Tim McCormick\mccorti01,C,26,HOU,81,0,1257,169,351,.481,0,4,.000,169,347,.487,.481,87,129,.674,87,174,261,54,18,24,68,193,425
203,Rodney McCray\mccraro01,SF,27,SAC,68,65,2435,340,729,.466,5,22,.227,335,707,.474,.470,169,234,.722,143,371,514,293,57,36,168,121,854
204,Xavier McDaniel\mcdanxa01,SF,25,SEA,82,10,2385,677,1385,.489,11,36,.306,666,1349,.494,.493,312,426,.732,177,256,433,134,84,40,210,231,1677
205,Ben McDonald\mcdonbe01,PF,26,GSW,11,0,103,13,19,.684,0,0,,13,19,.684,.684,9,15,.600,4,8,12,5,4,0,3,11,35
206,Mike McGee\mcgeemi01,SG,29,NJN,80,49,2027,434,917,.473,93,255,.365,341,662,.515,.524,77,144,.535,73,116,189,116,80,12,124,184,1038
207,Kevin McHale*\mchalke01,PF,31,BOS,78,74,2876,661,1211,.546,0,4,.000,661,1207,.548,.546,436,533,.818,223,414,637,172,26,97,196,223,1758
208,Derrick McKey\mckeyde01,SF,22,SEA,82,82,2804,487,970,.502,30,89,.337,457,881,.519,.518,301,375,.803,167,297,464,219,105,70,188,264,1305
209,Nate McMillan\mcmilna01,PG,24,SEA,75,74,2341,199,485,.410,15,70,.214,184,415,.443,.426,119,189,.630,143,245,388,696,156,42,211,236,532
210,Mark McNamara\mcnamma01,C,29,LAL,39,0,318,32,64,.500,0,0,,32,64,.500,.500,49,78,.628,38,62,100,10,4,3,24,51,113
211,Reggie Miller*\millere01,SG,23,IND,74,70,2536,398,831,.479,98,244,.402,300,587,.511,.538,287,340,.844,73,219,292,227,93,29,143,170,1181
212,Todd Mitchell\mitchto01,SF,22,TOT,24,0,353,43,97,.443,0,0,,43,97,.443,.443,37,64,.578,18,32,50,21,16,2,33,51,123
212,Todd Mitchell\mitchto01,SF,22,MIA,22,0,320,41,88,.466,0,0,,41,88,.466,.466,36,60,.600,17,30,47,20,15,2,29,49,118
212,Todd Mitchell\mitchto01,SF,22,SAS,2,0,33,2,9,.222,0,0,,2,9,.222,.222,1,4,.250,1,2,3,1,1,0,4,2,5
213,Paul Mokeski\mokespa01,C,32,MIL,74,0,690,59,164,.360,7,26,.269,52,138,.377,.381,40,51,.784,63,124,187,36,29,21,35,153,165
214,Sidney Moncrief\moncrsi01,PG,31,MIL,62,50,1594,261,532,.491,25,73,.342,236,459,.514,.514,205,237,.865,46,126,172,188,65,13,94,114,752
215,Chris Morris\morrich01,SF,23,NJN,76,48,2096,414,905,.457,64,175,.366,350,730,.479,.493,182,254,.717,188,209,397,119,102,60,190,250,1074
216,Richard Morton\mortori01,PG,22,IND,2,0,11,3,4,.750,0,0,,3,4,.750,.750,0,0,,0,0,0,1,0,0,1,2,6
217,Chris Mullin*\mullich01,SF,25,GSW,82,82,3093,830,1630,.509,23,100,.230,807,1530,.527,.516,493,553,.892,152,331,483,415,176,39,296,178,2176
218,Pete Myers\myerspe01,SG,25,TOT,33,0,270,31,73,.425,0,2,.000,31,71,.437,.425,33,48,.688,15,18,33,48,20,2,23,44,95
218,Pete Myers\myerspe01,SG,25,PHI,4,0,40,6,12,.500,0,0,,6,12,.500,.500,2,4,.500,3,7,10,2,3,0,4,3,14
218,Pete Myers\myerspe01,SG,25,NYK,29,0,230,25,61,.410,0,2,.000,25,59,.424,.410,31,44,.705,12,11,23,46,17,2,19,41,81
219,Larry Nance\nancela01,PF,29,CLE,73,72,2526,496,920,.539,0,4,.000,496,916,.541,.539,267,334,.799,156,425,581,159,57,206,117,186,1259
220,Calvin Natt\nattca01,SF,32,TOT,24,0,353,47,116,.405,0,1,.000,47,115,.409,.405,57,79,.722,28,50,78,18,8,3,30,32,151
220,Calvin Natt\nattca01,SF,32,DEN,14,0,168,22,50,.440,0,1,.000,22,49,.449,.440,22,31,.710,12,34,46,7,6,1,11,13,66
220,Calvin Natt\nattca01,SF,32,SAS,10,0,185,25,66,.379,0,0,,25,66,.379,.379,35,48,.729,16,16,32,11,2,2,19,19,85
221,Craig Neal\nealcr01,PG,24,TOT,53,0,500,45,123,.366,10,34,.294,35,89,.393,.407,14,23,.609,7,22,29,118,24,4,54,70,114
221,Craig Neal\nealcr01,PG,24,POR,21,0,159,11,35,.314,2,9,.222,9,26,.346,.343,1,2,.500,3,8,11,32,9,0,14,24,25
221,Craig Neal\nealcr01,PG,24,MIA,32,0,341,34,88,.386,8,25,.320,26,63,.413,.432,13,21,.619,4,14,18,86,15,4,40,46,89
222,Ed Nealy\nealyed01,PF,28,TOT,43,0,258,13,36,.361,0,2,.000,13,34,.382,.361,4,9,.444,22,56,78,14,7,1,7,45,30
222,Ed Nealy\nealyed01,PF,28,CHI,13,0,94,5,7,.714,0,0,,5,7,.714,.714,1,2,.500,4,19,23,6,3,1,1,23,11
222,Ed Nealy\nealyed01,PF,28,PHO,30,0,164,8,29,.276,0,2,.000,8,27,.296,.276,3,7,.429,18,37,55,8,4,0,6,22,19
223,Chuck Nevitt\nevitch01,C,29,HOU,43,0,228,27,62,.435,0,0,,27,62,.435,.435,11,16,.688,17,47,64,3,5,29,22,51,65
224,Johnny Newman\newmajo01,SF,25,NYK,81,80,2336,455,957,.475,97,287,.338,358,670,.534,.526,286,351,.815,93,113,206,162,111,23,153,259,1293
225,Norm Nixon\nixonno01,PG,33,LAC,53,30,1318,153,370,.414,8,29,.276,145,341,.425,.424,48,65,.738,13,65,78,339,46,0,118,69,362
226,Ken Norman\normake01,SF,24,LAC,80,79,3020,638,1271,.502,4,21,.190,634,1250,.507,.504,170,270,.630,245,422,667,277,106,66,206,223,1450
227,Charles Oakley\oaklech01,PF,25,NYK,82,82,2604,426,835,.510,12,48,.250,414,787,.526,.517,197,255,.773,343,518,861,187,104,14,248,270,1061
228,Hakeem Olajuwon*\olajuha01,C,26,HOU,82,82,3024,790,1556,.508,0,10,.000,790,1546,.511,.508,454,652,.696,338,767,1105,149,213,282,275,329,2034
229,Jose Ortiz\ortizjo01,PF,25,UTA,51,15,327,55,125,.440,0,1,.000,55,124,.444,.440,31,52,.596,30,28,58,11,8,7,36,40,141
230,Robert Parish*\parisro01,C,35,BOS,80,80,2840,596,1045,.570,0,0,,596,1045,.570,.570,294,409,.719,342,654,996,175,79,116,200,209,1486
231,Jim Paxson\paxsoji02,PG,31,BOS,57,7,1138,202,445,.454,4,24,.167,198,421,.470,.458,84,103,.816,18,56,74,107,38,8,57,96,492
232,John Paxson\paxsojo01,PG,28,CHI,78,20,1738,246,513,.480,44,133,.331,202,380,.532,.522,31,36,.861,13,81,94,308,53,6,71,162,567
233,Will Perdue\perduwi01,C,23,CHI,30,0,190,29,72,.403,0,0,,29,72,.403,.403,8,14,.571,18,27,45,11,4,6,15,38,66
234,Sam Perkins\perkisa01,PF,27,DAL,78,77,2860,445,959,.464,7,38,.184,438,921,.476,.468,274,329,.833,235,453,688,127,76,92,141,224,1171
235,Tim Perry\perryti01,C,23,PHO,62,15,614,108,201,.537,1,4,.250,107,197,.543,.540,40,65,.615,61,71,132,18,19,32,37,47,257
236,Chuck Person\persoch01,SF,24,IND,80,79,3012,711,1453,.489,63,205,.307,648,1248,.519,.511,243,307,.792,144,372,516,289,83,18,308,280,1728
237,Jim Petersen\peterji01,C,26,SAC,66,40,1633,278,606,.459,0,8,.000,278,598,.465,.459,115,154,.747,121,292,413,81,47,68,147,236,671
238,Ricky Pierce\piercri01,SG,29,MIL,75,4,2078,527,1018,.518,8,36,.222,519,982,.529,.522,255,297,.859,82,115,197,156,77,19,112,193,1317
239,Ed Pinckney\pincked01,PF,25,TOT,80,33,2012,319,622,.513,0,6,.000,319,616,.518,.513,280,350,.800,166,283,449,118,83,66,119,202,918
239,Ed Pinckney\pincked01,PF,25,SAC,51,24,1334,224,446,.502,0,6,.000,224,440,.509,.502,177,221,.801,106,195,301,74,54,43,81,125,625
239,Ed Pinckney\pincked01,PF,25,BOS,29,9,678,95,176,.540,0,0,,95,176,.540,.540,103,129,.798,60,88,148,44,29,23,38,77,293
240,Scottie Pippen*\pippesc01,SF,23,CHI,73,56,2413,413,867,.476,21,77,.273,392,790,.496,.488,201,301,.668,138,307,445,256,139,61,199,261,1048
241,Olden Polynice\polynol01,C,24,SEA,80,0,835,91,180,.506,0,2,.000,91,178,.511,.506,51,86,.593,98,108,206,21,37,30,46,164,233
242,Dave Popson\popsoda01,PF,24,TOT,17,0,106,16,40,.400,0,0,,16,40,.400,.400,2,4,.500,12,15,27,8,1,3,10,17,34
242,Dave Popson\popsoda01,PF,24,LAC,10,0,68,11,25,.440,0,0,,11,25,.440,.440,1,2,.500,5,11,16,6,1,2,6,9,23
242,Dave Popson\popsoda01,PF,24,MIA,7,0,38,5,15,.333,0,0,,5,15,.333,.333,1,2,.500,7,4,11,2,0,1,4,8,11
243,Terry Porter\portete01,PG,25,POR,81,81,3102,540,1146,.471,79,219,.361,461,927,.497,.506,272,324,.840,85,282,367,770,146,8,248,187,1431
244,Paul Pressey\presspa01,SG,30,MIL,67,62,2170,307,648,.474,12,55,.218,295,593,.497,.483,187,241,.776,73,189,262,439,119,44,184,221,813
245,Dominic Pressley\pressdo01,PG,24,TOT,13,0,124,9,31,.290,0,2,.000,9,29,.310,.290,5,9,.556,3,12,15,26,4,0,11,11,23
245,Dominic Pressley\pressdo01,PG,24,WSB,10,0,107,8,25,.320,0,0,,8,25,.320,.320,5,9,.556,3,11,14,22,4,0,11,9,21
245,Dominic Pressley\pressdo01,PG,24,CHI,3,0,17,1,6,.167,0,2,.000,1,4,.250,.167,0,0,,0,1,1,4,0,0,0,2,2
246,Harold Pressley\pressha01,PF,25,SAC,80,36,2257,383,873,.439,119,295,.403,264,578,.457,.507,96,123,.780,216,269,485,174,93,76,124,215,981
247,Mark Price\pricema01,PG,24,CLE,75,74,2728,529,1006,.526,93,211,.441,436,795,.548,.572,263,292,.901,48,178,226,631,115,7,212,98,1414
248,Kurt Rambis\rambiku01,PF,30,CHH,75,75,2233,325,627,.518,0,3,.000,325,624,.521,.518,182,248,.734,269,434,703,159,100,57,148,208,832
249,Blair Rasmussen\rasmubl01,C,26,DEN,77,22,1308,257,577,.445,0,0,,257,577,.445,.445,69,81,.852,105,182,287,49,29,41,49,194,583
250,Robert Reid\reidro01,SF,33,CHH,82,54,2152,519,1214,.428,17,52,.327,502,1162,.432,.435,152,196,.776,82,220,302,153,53,20,106,235,1207
251,Jerry Reynolds\reynoje01,SG,26,SEA,56,0,737,149,357,.417,3,15,.200,146,342,.427,.422,127,167,.760,49,51,100,62,53,26,57,58,428
252,Mitch Richmond*\richmmi01,SG,23,GSW,79,79,2717,649,1386,.468,33,90,.367,616,1296,.475,.480,410,506,.810,158,310,468,334,82,13,269,223,1741
253,Ramon Rivas\rivasra01,C,22,BOS,28,0,91,12,31,.387,0,1,.000,12,30,.400,.387,16,25,.640,9,15,24,3,4,1,9,21,40
254,David Rivers\riverda01,PG,24,LAL,47,0,440,49,122,.402,1,6,.167,48,116,.414,.406,35,42,.833,13,30,43,106,23,9,61,50,134
255,Doc Rivers\riverdo01,PG,27,ATL,76,76,2462,371,816,.455,43,124,.347,328,692,.474,.481,247,287,.861,89,197,286,525,181,40,158,263,1032
256,Fred Roberts\roberfr01,PF,28,MIL,71,3,1251,155,319,.486,3,14,.214,152,305,.498,.491,104,129,.806,68,141,209,66,36,23,80,126,417
257,Alvin Robertson\roberal01,SG,26,SAS,65,65,2287,465,962,.483,9,45,.200,456,917,.497,.488,183,253,.723,157,227,384,393,197,36,231,259,1122
258,Cliff Robinson\robincl01,SF,28,PHI,14,13,416,90,187,.481,0,1,.000,90,186,.484,.481,32,44,.727,19,56,75,32,17,2,34,37,212
259,Dennis Rodman*\rodmade01,SF,27,DET,82,8,2208,316,531,.595,6,26,.231,310,505,.614,.601,97,155,.626,327,445,772,99,55,76,126,292,735
260,Tree Rollins\rollitr01,C,33,CLE,60,2,583,62,138,.449,0,1,.000,62,137,.453,.449,12,19,.632,38,101,139,19,11,38,22,89,136
261,Rob Rose\rosero01,SG,24,LAC,2,0,3,0,1,.000,0,0,,0,1,.000,.000,0,0,,1,1,2,0,0,0,0,0,0
262,Scott Roth\rothsc01,SF,25,TOT,63,3,536,59,167,.353,3,16,.188,56,151,.371,.362,60,87,.690,20,44,64,55,24,5,40,69,181
262,Scott Roth\rothsc01,SF,25,UTA,16,0,72,7,24,.292,1,6,.167,6,18,.333,.313,8,11,.727,0,8,8,7,5,1,7,14,23
262,Scott Roth\rothsc01,SF,25,SAS,47,3,464,52,143,.364,2,10,.200,50,133,.376,.371,52,76,.684,20,36,56,48,19,4,33,55,158
263,Jim Rowinski\rowinji01,PF-C,28,TOT,9,0,15,1,4,.250,0,0,,1,4,.250,.250,5,6,.833,1,4,5,0,0,0,0,0,7
263,Jim Rowinski\rowinji01,PF,28,DET,6,0,8,0,2,.000,0,0,,0,2,.000,.000,4,4,1.000,0,2,2,0,0,0,0,0,4
263,Jim Rowinski\rowinji01,C,28,PHI,3,0,7,1,2,.500,0,0,,1,2,.500,.500,1,2,.500,1,2,3,0,0,0,0,0,3
264,Brian Rowsom\rowsobr01,PF,23,CHH,34,0,517,80,162,.494,1,1,1.000,79,161,.491,.497,65,81,.802,56,81,137,24,10,12,18,69,226
265,John Salley\sallejo01,PF,24,DET,67,21,1458,166,333,.498,0,2,.000,166,331,.502,.498,135,195,.692,134,201,335,75,40,72,100,197,467
266,Ralph Sampson*\sampsra01,C,28,GSW,61,36,1086,164,365,.449,3,8,.375,161,357,.451,.453,62,95,.653,105,202,307,77,31,65,90,170,393
267,Mike Sanders\sandemi01,SF,28,CLE,82,82,2102,332,733,.453,3,10,.300,329,723,.455,.455,97,135,.719,98,209,307,133,89,32,104,230,764
268,Danny Schayes\schayda01,C,29,DEN,76,64,1918,317,607,.522,3,9,.333,314,598,.525,.525,332,402,.826,142,358,500,105,42,81,160,320,969
269,Russ Schoene\schoeru01,PF,28,SEA,69,1,774,135,349,.387,42,110,.382,93,239,.389,.447,46,57,.807,58,107,165,36,37,24,48,136,358
270,Detlef Schrempf\schrede01,PF,26,TOT,69,13,1850,274,578,.474,7,35,.200,267,543,.492,.480,273,350,.780,126,269,395,179,53,19,133,220,828
270,Detlef Schrempf\schrede01,PF,26,DAL,37,1,845,112,263,.426,2,16,.125,110,247,.445,.430,127,161,.789,56,110,166,86,24,9,56,118,353
270,Detlef Schrempf\schrede01,PF,26,IND,32,12,1005,162,315,.514,5,19,.263,157,296,.530,.522,146,189,.772,70,159,229,93,29,10,77,102,475
271,Byron Scott\scottby01,SG,27,LAL,74,73,2605,588,1198,.491,77,193,.399,511,1005,.508,.523,195,226,.863,72,230,302,231,114,27,157,181,1448
272,Rony Seikaly\seikaro01,C,23,MIA,78,62,1962,333,744,.448,1,4,.250,332,740,.449,.448,181,354,.511,204,345,549,55,46,96,200,258,848
273,Brad Sellers\sellebr01,PF,26,CHI,80,25,1732,231,476,.485,3,6,.500,228,470,.485,.488,86,101,.851,85,142,227,99,35,69,72,176,551
274,Charles Shackleford\shackch01,C,22,NJN,60,0,484,83,168,.494,0,1,.000,83,167,.497,.494,21,42,.500,50,103,153,21,15,18,27,71,187
275,John Shasky\shaskjo01,C,24,MIA,65,4,944,121,248,.488,0,2,.000,121,246,.492,.488,115,167,.689,96,136,232,22,14,13,46,94,357
276,Brian Shaw\shawbr01,SG,22,BOS,82,54,2301,297,686,.433,0,13,.000,297,673,.441,.433,109,132,.826,119,257,376,472,78,27,188,211,703
277,Purvis Short\shortpu01,SF,31,HOU,65,16,1157,198,480,.413,9,33,.273,189,447,.423,.422,77,89,.865,65,114,179,107,44,13,70,116,482
278,Jerry Sichting\sichtje01,PG,32,POR,25,1,390,46,104,.442,3,12,.250,43,92,.467,.457,7,8,.875,9,20,29,59,15,0,25,17,102
279,Jack Sikma\sikmaja01,C,33,MIL,80,80,2587,360,835,.431,82,216,.380,278,619,.449,.480,266,294,.905,141,482,623,289,85,61,145,300,1068
280,Scott Skiles\skilesc01,PG,24,IND,80,13,1571,198,442,.448,20,75,.267,178,367,.485,.471,130,144,.903,21,128,149,390,64,2,177,151,546
281,Keith Smart\smartke01,PG,24,SAS,2,0,12,0,2,.000,0,1,.000,0,1,.000,.000,2,2,1.000,0,1,1,2,0,0,2,0,2
282,Charles Smith\smithch01,PF,23,LAC,71,56,2161,435,878,.495,0,3,.000,435,875,.497,.495,285,393,.725,173,292,465,103,68,89,146,273,1155
283,Derek Smith\smithde02,SG,27,TOT,65,38,1295,216,496,.435,7,31,.226,209,465,.449,.443,129,188,.686,61,106,167,128,43,23,88,164,568
283,Derek Smith\smithde02,SG,27,SAC,29,20,600,111,276,.402,3,15,.200,108,261,.414,.408,64,95,.674,30,51,81,60,19,8,44,64,289
283,Derek Smith\smithde02,SG,27,PHI,36,18,695,105,220,.477,4,16,.250,101,204,.495,.486,65,93,.699,31,55,86,68,24,15,44,100,279
284,Kenny Smith\smithke01,PG,23,SAC,81,81,3145,547,1183,.462,46,128,.359,501,1055,.475,.482,263,357,.737,49,177,226,621,102,7,249,173,1403
285,Larry Smith\smithla01,PF,31,GSW,80,78,1897,219,397,.552,0,0,,219,397,.552,.552,18,58,.310,272,380,652,118,61,54,110,248,456
286,Otis Smith\smithot01,SG,25,GSW,80,5,1597,311,715,.435,7,37,.189,304,678,.448,.440,174,218,.798,128,202,330,140,88,40,129,165,803
287,Rik Smits\smitsri01,C,22,IND,82,71,2041,386,746,.517,0,1,.000,386,745,.518,.517,184,255,.722,185,315,500,70,37,151,130,310,956
288,Mike Smrek\smrekmi01,PF,26,SAS,43,18,623,72,153,.471,0,0,,72,153,.471,.471,49,76,.645,42,87,129,12,13,58,48,102,193
289,Rory Sparrow\sparrro01,PG,30,MIA,80,79,2613,444,982,.452,18,74,.243,426,908,.469,.461,94,107,.879,55,161,216,429,103,17,204,168,1000
290,John Starks\starkjo01,SG,23,GSW,36,0,316,51,125,.408,10,26,.385,41,99,.414,.448,34,52,.654,15,26,41,27,23,3,39,36,146
291,Everette Stephens\stephev01,PG,22,IND,35,0,209,23,72,.319,2,10,.200,21,62,.339,.333,17,22,.773,11,12,23,37,9,4,29,22,65
292,Brook Steppe\steppbr01,PG,29,POR,27,2,244,33,78,.423,5,9,.556,28,69,.406,.455,32,37,.865,13,19,32,16,11,1,13,32,103
293,John Stockton*\stockjo01,PG,26,UTA,82,82,3171,497,923,.538,16,66,.242,481,857,.561,.547,390,452,.863,83,165,248,1118,263,14,308,241,1400
294,Rod Strickland\stricro02,PG,22,NYK,81,10,1358,265,567,.467,19,59,.322,246,508,.484,.484,172,231,.745,51,109,160,319,98,3,148,142,721
295,John Stroeder\stroejo01,PF,30,TOT,5,0,22,2,5,.400,0,0,,2,5,.400,.400,0,0,,5,9,14,3,0,2,3,3,4
295,John Stroeder\stroejo01,PF,30,SAS,1,0,2,0,0,,0,0,,0,0,,,0,0,,0,0,0,0,0,0,1,2,0
295,John Stroeder\stroejo01,PF,30,GSW,4,0,20,2,5,.400,0,0,,2,5,.400,.400,0,0,,5,9,14,3,0,2,2,1,4
296,Barry Sumpter\sumptba01,PF,23,LAC,1,0,1,0,1,.000,0,0,,0,1,.000,.000,0,0,,0,0,0,0,0,0,0,0,0
297,Jon Sundvold\sundvjo01,SG,27,MIA,68,8,1338,307,675,.455,48,92,.522,259,583,.444,.490,47,57,.825,18,69,87,137,27,1,87,78,709
298,Roy Tarpley\tarplro01,PF,24,DAL,19,6,591,131,242,.541,0,1,.000,131,241,.544,.541,66,96,.688,77,141,218,17,28,30,45,70,328
299,Anthony Taylor\tayloan01,PG,23,MIA,21,7,368,60,151,.397,0,2,.000,60,149,.403,.397,24,32,.750,11,23,34,43,22,5,20,37,144
300,Terry Teagle\teaglte01,SF,28,GSW,66,41,1569,409,859,.476,2,12,.167,407,847,.481,.477,182,225,.809,110,153,263,96,79,17,116,173,1002
301,Reggie Theus\theusre01,SG,31,ATL,82,82,2517,497,1067,.466,17,58,.293,480,1009,.476,.474,285,335,.851,86,156,242,387,108,16,194,236,1296
302,Isiah Thomas*\thomais01,PG,27,DET,80,76,2924,569,1227,.464,33,121,.273,536,1106,.485,.477,287,351,.818,49,224,273,663,133,20,298,209,1458
303,Bernard Thompson\thompbe01,PF,26,HOU,23,0,222,20,59,.339,0,2,.000,20,57,.351,.339,22,26,.846,9,19,28,13,13,1,19,33,62
304,Billy Thompson\thompbi01,SF,25,MIA,79,58,2273,349,716,.487,0,4,.000,349,712,.490,.487,156,224,.696,241,331,572,176,56,105,189,260,854
305,LaSalle Thompson\thompla01,C,27,TOT,76,71,2329,416,850,.489,0,1,.000,416,849,.490,.489,227,281,.808,224,494,718,81,79,94,179,285,1059
305,LaSalle Thompson\thompla01,C,27,SAC,43,42,1276,247,536,.461,0,1,.000,247,535,.462,.461,152,188,.809,120,272,392,44,46,55,117,153,646
305,LaSalle Thompson\thompla01,C,27,IND,33,29,1053,169,314,.538,0,0,,169,314,.538,.538,75,93,.806,104,222,326,37,33,39,62,132,413
306,Mychal Thompson\thompmy01,C,34,LAL,80,8,1994,291,521,.559,0,1,.000,291,520,.560,.559,156,230,.678,157,310,467,48,58,59,97,224,738
307,Bob Thornton\thornbo01,PF,26,PHI,54,0,449,47,111,.423,1,3,.333,46,108,.426,.428,32,60,.533,36,56,92,15,8,7,23,87,127
308,Otis Thorpe\thorpot01,PF,26,HOU,82,82,3135,521,961,.542,0,2,.000,521,959,.543,.542,328,450,.729,272,515,787,202,82,37,225,259,1370
309,Sedale Threatt\threase01,PG,27,SEA,63,0,1220,235,476,.494,11,30,.367,224,446,.502,.505,63,77,.818,31,86,117,238,83,4,77,155,544
310,Wayman Tisdale\tisdawa01,PF,24,TOT,79,35,2434,532,1036,.514,0,4,.000,532,1032,.516,.514,317,410,.773,187,422,609,128,55,52,172,290,1381
310,Wayman Tisdale\tisdawa01,PF,24,IND,48,5,1326,285,564,.505,0,4,.000,285,560,.509,.505,198,250,.792,99,211,310,75,35,32,107,181,768
310,Wayman Tisdale\tisdawa01,PF,24,SAC,31,30,1108,247,472,.523,0,0,,247,472,.523,.523,119,160,.744,88,211,299,53,20,20,65,109,613
311,Ray Tolbert\tolbera01,PF,30,ATL,50,0,341,40,94,.426,0,0,,40,94,.426,.426,23,37,.622,31,57,88,16,13,13,35,55,103
312,Tom Tolbert\tolbeto01,SF,23,CHH,14,0,117,17,37,.459,0,3,.000,17,34,.500,.459,6,12,.500,7,14,21,7,2,4,2,20,40
313,Sedric Toney\toneyse01,PG,26,IND,2,0,9,1,5,.200,0,3,.000,1,2,.500,.200,0,1,.000,1,1,2,0,0,0,2,1,2
314,Kelly Tripucka\tripuke01,SF,29,CHH,71,65,2302,568,1215,.467,30,84,.357,538,1131,.476,.480,440,508,.866,79,188,267,224,88,16,236,196,1606
315,Trent Tucker\tucketr01,SG,29,NYK,81,24,1824,263,579,.454,118,296,.399,145,283,.512,.556,43,55,.782,55,121,176,132,88,6,59,163,687
316,Andre Turner\turnean01,PG,24,MIL,4,0,13,3,6,.500,0,0,,3,6,.500,.500,0,0,,0,3,3,0,2,0,4,2,6
317,Elston Turner\turneel01,SF,29,DEN,78,12,1746,151,353,.428,2,7,.286,149,346,.431,.431,33,56,.589,109,178,287,144,90,8,60,209,337
318,Terry Tyler\tylerte01,SF,32,DAL,70,11,1057,169,360,.469,1,9,.111,168,351,.479,.471,47,62,.758,74,135,209,40,24,39,51,90,386
319,Kelvin Upshaw\upshake01,SG,26,TOT,32,0,617,99,212,.467,3,15,.200,96,197,.487,.474,18,26,.692,10,39,49,117,26,3,55,80,219
319,Kelvin Upshaw\upshake01,SG,26,MIA,9,0,144,26,63,.413,1,5,.200,25,58,.431,.421,4,6,.667,4,9,13,20,7,0,13,18,57
319,Kelvin Upshaw\upshake01,SG,26,BOS,23,0,473,73,149,.490,2,10,.200,71,139,.511,.497,14,20,.700,6,30,36,97,19,3,42,62,162
320,Darnell Valentine\valenda01,SG,29,CLE,77,4,1086,136,319,.426,3,14,.214,133,305,.436,.431,91,112,.813,22,81,103,174,57,7,83,88,366
321,Kiki Vandeweghe\vandeki01,PF,30,TOT,45,1,934,200,426,.469,19,48,.396,181,378,.479,.492,80,89,.899,26,45,71,69,19,11,41,78,499
321,Kiki Vandeweghe\vandeki01,PF,30,POR,18,1,432,103,217,.475,16,38,.421,87,179,.486,.512,29,33,.879,11,24,35,34,7,4,18,40,251
321,Kiki Vandeweghe\vandeki01,PF,30,NYK,27,0,502,97,209,.464,3,10,.300,94,199,.472,.471,51,56,.911,15,21,36,35,12,7,23,38,248
322,Jay Vincent\vinceja01,SF,29,TOT,29,4,646,104,257,.405,1,3,.333,103,254,.406,.407,40,60,.667,38,72,110,27,6,4,42,63,249
322,Jay Vincent\vinceja01,SF,29,DEN,5,1,95,13,38,.342,1,2,.500,12,36,.333,.355,5,9,.556,2,16,18,5,1,1,5,11,32
322,Jay Vincent\vinceja01,SF,29,SAS,24,3,551,91,219,.416,0,1,.000,91,218,.417,.416,35,51,.686,36,56,92,22,5,3,37,52,217
323,Sam Vincent\vincesa01,PG,25,CHI,70,56,1703,274,566,.484,2,17,.118,272,549,.495,.486,106,129,.822,34,156,190,335,53,10,142,124,656
324,Darrell Walker\walkeda01,PG,27,WSB,79,78,2565,286,681,.420,0,9,.000,286,672,.426,.420,142,184,.772,135,372,507,496,155,23,184,215,714
325,Kenny Walker\walkeke01,SF,24,NYK,79,2,1163,174,356,.489,5,20,.250,169,336,.503,.496,66,85,.776,101,129,230,36,41,45,44,190,419
326,Pearl Washington\washipe01,PG,25,MIA,54,8,1065,164,387,.424,1,14,.071,163,373,.437,.425,82,104,.788,49,74,123,226,73,4,122,101,411
327,Spud Webb\webbsp01,PG,25,ATL,81,6,1219,133,290,.459,1,22,.045,132,268,.493,.460,52,60,.867,21,102,123,284,70,6,83,104,319
328,Chris Welp\welpch01,C,25,PHI,72,0,843,99,222,.446,0,1,.000,99,221,.448,.446,48,73,.658,59,134,193,29,23,41,42,176,246
329,Bill Wennington\wennibi01,C,25,DAL,65,9,1074,119,275,.433,1,9,.111,118,266,.444,.435,61,82,.744,82,204,286,46,16,35,54,211,300
330,Mark West\westma01,C,28,PHO,82,32,2019,243,372,.653,0,0,,243,372,.653,.653,108,202,.535,167,384,551,39,35,187,103,273,594
331,Ennis Whatley\whatlen01,PG,26,LAC,8,0,90,12,33,.364,0,0,,12,33,.364,.364,10,11,.909,2,14,16,22,7,1,11,15,34
332,Clinton Wheeler\wheelcl01,PG,29,TOT,28,0,354,45,87,.517,0,1,.000,45,86,.523,.517,15,20,.750,17,14,31,54,27,0,24,26,105
332,Clinton Wheeler\wheelcl01,PG,29,MIA,8,0,143,24,42,.571,0,0,,24,42,.571,.571,8,10,.800,5,7,12,21,8,0,6,9,56
332,Clinton Wheeler\wheelcl01,PG,29,POR,20,0,211,21,45,.467,0,1,.000,21,44,.477,.467,7,10,.700,12,7,19,33,19,0,18,17,49
333,Eric White\whiteer01,SF,23,TOT,38,0,436,62,120,.517,0,0,,62,120,.517,.517,34,42,.810,34,36,70,17,10,1,26,40,158
333,Eric White\whiteer01,SF,23,UTA,1,0,2,0,1,.000,0,0,,0,1,.000,.000,0,0,,0,0,0,0,0,0,0,1,0
333,Eric White\whiteer01,SF,23,LAC,37,0,434,62,119,.521,0,0,,62,119,.521,.521,34,42,.810,34,36,70,17,10,1,26,39,158
334,Jerome Whitehead\whiteje01,C,32,TOT,57,4,622,72,182,.396,0,0,,72,182,.396,.396,31,47,.660,49,85,134,19,23,4,24,115,175
334,Jerome Whitehead\whiteje01,C,32,GSW,5,0,42,3,6,.500,0,0,,3,6,.500,.500,1,2,.500,0,5,5,2,1,0,2,8,7
334,Jerome Whitehead\whiteje01,C,32,SAS,52,4,580,69,176,.392,0,0,,69,176,.392,.392,30,45,.667,49,80,129,17,22,4,22,107,168
335,Morlon Wiley\wileymo01,PG,22,DAL,51,1,408,46,114,.404,6,24,.250,40,90,.444,.430,13,16,.813,13,34,47,76,25,6,34,61,111
336,Dominique Wilkins*\wilkido01,SF,29,ATL,80,80,2997,814,1756,.464,29,105,.276,785,1651,.475,.472,442,524,.844,256,297,553,211,117,52,181,138,2099
337,Eddie Lee Wilkins\wilkied01,C,26,NYK,71,2,584,114,245,.465,0,1,.000,114,244,.467,.465,61,111,.550,72,76,148,7,10,16,56,110,289
338,Gerald Wilkins\wilkige01,SG,25,NYK,81,58,2414,462,1025,.451,51,172,.297,411,853,.482,.476,186,246,.756,95,149,244,274,115,22,169,166,1161
339,Buck Williams\willibu01,PF,28,NJN,74,72,2446,373,702,.531,0,3,.000,373,699,.534,.531,213,320,.666,249,447,696,78,61,36,142,223,959
340,Herb Williams\willihe01,C,30,TOT,76,66,2470,322,739,.436,0,5,.000,322,734,.439,.436,133,194,.686,135,458,593,124,46,134,149,236,777
340,Herb Williams\willihe01,C,30,IND,46,46,1567,244,542,.450,0,3,.000,244,539,.453,.450,90,126,.714,87,309,396,88,31,80,108,156,578
340,Herb Williams\willihe01,C,30,DAL,30,20,903,78,197,.396,0,2,.000,78,195,.400,.396,43,68,.632,48,149,197,36,15,54,41,80,199
341,Hot Rod Williams\williho01,PF,26,CLE,82,10,2125,356,700,.509,1,4,.250,355,696,.510,.509,235,314,.748,173,304,477,108,77,134,102,188,948
342,John Williams\willijo02,SF,22,WSB,82,1,2413,438,940,.466,19,71,.268,419,869,.482,.476,225,290,.776,158,415,573,356,142,70,157,213,1120
343,Kevin Williams\willike01,SG,27,TOT,50,0,547,81,200,.405,1,6,.167,80,194,.412,.408,46,59,.780,28,42,70,53,30,11,52,91,209
343,Kevin Williams\willike01,SG,27,NJN,41,0,433,67,168,.399,1,6,.167,66,162,.407,.402,40,51,.784,19,31,50,36,25,8,42,74,175
343,Kevin Williams\willike01,SG,27,LAC,9,0,114,14,32,.438,0,0,,14,32,.438,.438,6,8,.750,9,11,20,17,5,3,10,17,34
344,Micheal Williams\willimi02,PG,22,DET,49,0,358,47,129,.364,2,9,.222,45,120,.375,.372,31,47,.660,9,18,27,70,13,3,42,44,127
345,Reggie Williams\willire01,SF,24,LAC,63,17,1303,260,594,.438,30,104,.288,230,490,.469,.463,92,122,.754,70,109,179,103,81,29,114,181,642
346,David Wingate\wingada01,SG,25,PHI,33,6,372,54,115,.470,2,6,.333,52,109,.477,.478,27,34,.794,12,25,37,73,9,2,35,43,137
347,Randy Wittman\wittmra01,SF,29,TOT,64,13,1120,130,286,.455,3,6,.500,127,280,.454,.460,28,41,.683,26,54,80,111,23,2,32,43,291
347,Randy Wittman\wittmra01,SF,29,SAC,31,2,416,50,117,.427,2,4,.500,48,113,.425,.436,16,22,.727,6,20,26,32,10,0,12,12,118
347,Randy Wittman\wittmra01,SF,29,IND,33,11,704,80,169,.473,1,2,.500,79,167,.473,.476,12,19,.632,20,34,54,79,13,2,20,31,173
348,Joe Wolf\wolfjo01,C,24,LAC,66,15,1450,170,402,.423,2,14,.143,168,388,.433,.425,44,64,.688,83,188,271,113,32,16,94,152,386
349,David Wood\woodda01,PF,24,CHI,2,0,2,0,0,,0,0,,0,0,,,0,0,,0,0,0,0,0,0,0,0,0
350,Mike Woodson\woodsmi01,SG,30,HOU,81,79,2259,410,936,.438,31,89,.348,379,847,.447,.455,195,237,.823,51,143,194,206,89,18,136,195,1046
351,Orlando Woolridge\woolror01,SF,29,LAL,74,0,1491,231,494,.468,0,1,.000,231,493,.469,.468,253,343,.738,81,189,270,58,30,65,103,130,715
352,James Worthy*\worthja01,SF,27,LAL,81,81,2960,702,1282,.548,2,23,.087,700,1259,.556,.548,251,321,.782,169,320,489,288,108,56,182,175,1657
353,Danny Young\youngda01,PG,26,POR,48,2,952,115,250,.460,17,50,.340,98,200,.490,.494,50,64,.781,17,57,74,123,55,3,45,50,297