
Rk,Player,Pos,Age,Tm,G,GS,MP,FG,FGA,FG%,3P,3PA,3P%,2P,2PA,2P%,eFG%,FT,FTA,FT%,ORB,DRB,TRB,AST,STL,BLK,TOV,PF,PTS
1,Mahmoud Abdul-Rauf\abdulma02,PG,31,VAN,41,0,486,120,246,.488,4,14,.286,116,232,.500,.496,22,29,.759,5,20,25,76,9,1,26,50,266
2,Tariq Abdul-Wahad\abdulta01,SG,26,DEN,29,12,420,43,111,.387,4,10,.400,39,101,.386,.405,21,36,.583,14,45,59,22,14,13,34,54,111
3,Shareef Abdur-Rahim\abdursh01,SF,24,VAN,81,81,3241,604,1280,.472,12,64,.188,592,1216,.487,.477,443,531,.834,175,560,735,250,90,77,231,238,1663
4,Cory Alexander\alexaco01,PG,27,ORL,26,0,227,18,56,.321,4,16,.250,14,40,.350,.357,12,18,.667,0,25,25,36,16,0,25,29,52
5,Courtney Alexander\alexaco02,PG,23,TOT,65,24,1382,239,573,.417,17,46,.370,222,527,.421,.432,123,150,.820,42,101,143,62,45,5,75,139,618
5,Courtney Alexander\alexaco02,PG,23,DAL,38,6,472,62,178,.348,3,10,.300,59,168,.351,.357,33,45,.733,20,43,63,21,16,3,21,76,160
5,Courtney Alexander\alexaco02,PG,23,WAS,27,18,910,177,395,.448,14,36,.389,163,359,.454,.466,90,105,.857,22,58,80,41,29,2,54,63,458
6,Ray Allen*\allenra02,SG,25,MIL,82,82,3129,628,1309,.480,202,467,.433,426,842,.506,.557,348,392,.888,101,327,428,374,124,20,204,192,1806
7,Rafer Alston\alstora01,PG,24,MIL,37,2,288,30,84,.357,8,30,.267,22,54,.407,.405,9,13,.692,4,27,31,68,13,0,20,27,77
8,John Amaechi\amaecjo01,C,30,ORL,82,36,1710,237,592,.400,0,7,.000,237,585,.405,.400,176,279,.631,77,191,268,74,28,29,124,175,650
9,Derek Anderson\anderde01,SG,26,SAS,82,82,2859,413,993,.416,101,253,.399,312,740,.422,.467,342,402,.851,75,288,363,301,120,14,165,188,1269
10,Kenny Anderson\anderke01,PG,30,BOS,33,28,849,88,227,.388,11,33,.333,77,194,.397,.412,59,71,.831,16,57,73,134,44,2,52,62,246
11,Nick Anderson\anderni01,SG,33,SAC,21,0,169,14,57,.246,10,39,.256,4,18,.222,.333,0,0,,3,22,25,13,10,4,7,13,38
12,Shandon Anderson\andersh01,SG,27,HOU,82,82,2396,263,590,.446,46,170,.271,217,420,.517,.485,138,188,.734,72,261,333,189,82,40,131,202,710
13,Greg Anthony\anthogr01,PG,33,POR,58,0,856,97,253,.383,65,159,.409,32,94,.340,.512,23,35,.657,21,40,61,82,40,3,43,63,282
14,Darrell Armstrong\armstda01,PG,32,ORL,75,75,2767,413,1002,.412,143,403,.355,270,599,.451,.484,220,249,.884,94,249,343,524,135,13,200,155,1189
15,Chucky Atkins\atkinch01,PG,26,DET,81,75,2363,380,952,.399,121,339,.357,259,613,.423,.463,90,130,.692,28,145,173,330,67,5,149,184,971
16,Stacey Augmon\augmost01,SG,32,POR,66,23,1182,127,266,.477,0,4,.000,127,262,.485,.477,57,87,.655,60,99,159,98,48,21,48,105,311
17,Isaac Austin\austiis01,C,31,VAN,52,16,845,96,270,.356,6,24,.250,90,246,.366,.367,28,40,.700,50,172,222,58,20,23,54,94,226
18,William Avery\averywi01,PG,21,MIN,55,0,463,55,144,.382,16,59,.271,39,85,.459,.438,28,36,.778,5,24,29,75,13,4,45,48,154
19,Dalibor Bagaric\bagarda01,C,20,CHI,35,0,259,17,65,.262,0,1,.000,17,64,.266,.262,13,28,.464,22,34,56,10,9,16,21,44,47
20,Vin Baker\bakervi01,PF,29,SEA,76,27,2129,347,822,.422,1,16,.063,346,806,.429,.423,232,321,.723,179,251,430,90,38,73,158,264,927
21,Erick Barkley\barkler01,PG,22,POR,8,0,38,8,22,.364,3,8,.375,5,14,.357,.432,0,0,,0,3,3,6,2,0,5,2,19
22,Dana Barros\barroda01,PG,33,DET,60,0,1079,183,412,.444,44,105,.419,139,307,.453,.498,68,80,.850,6,88,94,110,30,2,60,63,478
23,Brent Barry\barrybr01,SG,29,SEA,67,20,1778,198,401,.494,109,229,.476,89,172,.517,.630,84,103,.816,33,178,211,225,80,14,86,126,589
24,Jon Barry\barryjo01,SG,31,SAC,62,2,1010,103,255,.404,46,132,.348,57,123,.463,.494,64,73,.877,16,78,94,130,28,6,53,66,316
25,Tony Battie\battito01,C,24,BOS,40,25,845,108,201,.537,0,3,.000,108,198,.545,.537,44,69,.638,73,160,233,16,27,60,37,126,260
26,Raja Bell\bellra01,SG,24,PHI,5,0,30,2,7,.286,1,3,.333,1,4,.250,.357,0,0,,0,1,1,0,1,0,2,1,5
27,Jonathan Bender\bendejo01,SF,20,IND,59,7,574,66,186,.355,11,41,.268,55,145,.379,.384,50,68,.735,14,60,74,32,7,28,42,73,193
28,Corey Benjamin\benjaco01,PG,22,CHI,65,5,857,115,302,.381,21,81,.259,94,221,.425,.416,56,83,.675,38,62,100,69,28,16,63,128,307
29,David Benoit\benoida01,SF,32,UTA,49,2,446,71,147,.483,5,13,.385,66,134,.493,.500,31,39,.795,20,61,81,22,6,6,28,75,178
30,Travis Best\besttr01,PG,28,IND,77,21,2457,347,788,.440,37,97,.381,310,691,.449,.464,187,226,.827,38,184,222,473,110,11,127,246,918
31,Mike Bibby\bibbymi01,PG,22,VAN,82,82,3190,525,1157,.454,108,285,.379,417,872,.478,.500,143,188,.761,47,257,304,685,107,12,248,148,1301
32,Chauncey Billups\billuch01,SG,24,MIN,77,33,1790,248,587,.422,73,194,.376,175,393,.445,.485,144,171,.842,32,126,158,260,51,11,111,178,713
33,Mookie Blaylock\blaylmo01,PG,33,GSW,69,59,2352,317,801,.396,73,225,.324,244,576,.424,.441,53,76,.697,71,201,272,462,163,20,128,134,760
34,Corie Blount\blounco01,PF,32,TOT,68,6,1305,130,294,.442,2,8,.250,128,286,.448,.446,51,83,.614,181,219,400,59,42,22,73,165,313
34,Corie Blount\blounco01,PF,32,PHO,30,6,387,23,47,.489,0,0,,23,47,.489,.489,8,15,.533,35,50,85,8,13,5,18,75,54
34,Corie Blount\blounco01,PF,32,GSW,38,0,918,107,247,.433,2,8,.250,105,239,.439,.437,43,68,.632,146,169,315,51,29,17,55,90,259
35,Mark Blount\blounma01,C,25,BOS,64,50,1098,101,200,.505,0,0,,101,200,.505,.505,46,66,.697,97,134,231,32,39,76,62,183,248
36,Muggsy Bogues\boguemu01,PG,36,TOR,3,0,34,0,2,.000,0,1,.000,0,1,.000,.000,0,0,,0,3,3,5,2,0,4,3,0
37,Etdrick Bohannon\bohanet01,PF,27,CLE,6,0,19,2,4,.500,0,0,,2,4,.500,.500,4,4,1.000,3,4,7,0,0,2,1,4,8
38,Calvin Booth\boothca01,C,24,TOT,55,29,933,120,252,.476,0,0,,120,252,.476,.476,53,78,.679,77,169,246,42,29,111,53,146,293
38,Calvin Booth\boothca01,C,24,WAS,40,22,640,74,168,.440,0,0,,74,168,.440,.440,33,45,.733,53,121,174,23,17,81,36,91,181
38,Calvin Booth\boothca01,C,24,DAL,15,7,293,46,84,.548,0,0,,46,84,.548,.548,20,33,.606,24,48,72,19,12,30,17,55,112
39,Cal Bowdler\bowdlca01,SF,23,ATL,44,0,375,53,114,.465,1,5,.200,52,109,.477,.469,33,40,.825,30,47,77,4,10,21,11,45,140
40,Bruce Bowen\bowenbr01,SF,29,MIA,82,72,2685,211,581,.363,103,307,.336,108,274,.394,.452,98,161,.609,45,200,245,132,83,53,74,269,623
41,Ryan Bowen\bowenry01,SF,25,DEN,57,0,696,80,144,.556,4,11,.364,76,133,.571,.569,27,44,.614,62,51,113,30,37,12,24,95,191
42,Ira Bowman\bowmair01,PG,27,ATL,3,0,19,0,2,.000,0,0,,0,2,.000,.000,0,0,,1,1,2,7,0,0,1,0,0
43,Earl Boykins\boykiea01,PG,24,LAC,10,0,149,25,63,.397,1,8,.125,24,55,.436,.405,14,17,.824,4,7,11,32,5,0,9,9,65
44,Shawn Bradley\bradlsh01,C,28,DAL,82,35,2001,219,447,.490,1,6,.167,218,441,.494,.491,140,178,.787,160,448,608,38,36,228,88,256,579
45,Elton Brand\brandel01,PF,21,CHI,74,74,2906,578,1215,.476,0,2,.000,578,1213,.477,.476,334,472,.708,285,461,746,240,71,118,219,243,1490
46,Terrell Brandon\brandte01,PG,30,MIN,78,78,2821,511,1134,.451,33,91,.363,478,1043,.458,.465,195,224,.871,60,238,298,583,161,21,155,138,1250
47,Chucky Brown\brownch01,SF,32,TOT,26,2,339,40,95,.421,0,3,.000,40,92,.435,.421,22,34,.647,8,46,54,11,9,7,8,37,102
47,Chucky Brown\brownch01,SF,32,GSW,6,0,74,9,20,.450,0,2,.000,9,18,.500,.450,6,10,.600,3,15,18,5,3,1,2,10,24
47,Chucky Brown\brownch01,SF,32,CLE,20,2,265,31,75,.413,0,1,.000,31,74,.419,.413,16,24,.667,5,31,36,6,6,6,6,27,78
48,Dee Brown\brownde01,PG,32,ORL,7,0,155,16,44,.364,12,32,.375,4,12,.333,.500,4,5,.800,0,11,11,12,4,0,7,10,48
49,P.J. Brown\brownpj01,C,31,CHH,80,79,2811,249,561,.444,0,4,.000,249,557,.447,.444,178,209,.852,257,485,742,127,78,92,108,260,676
50,Randy Brown\brownra02,PG,32,BOS,54,35,1238,100,237,.422,0,3,.000,100,234,.427,.422,23,40,.575,23,76,99,154,62,10,56,132,223
51,Rick Brunson\brunsri01,PG,28,TOT,22,0,208,18,54,.333,2,14,.143,16,40,.400,.352,8,15,.533,5,16,21,31,8,1,17,21,46
51,Rick Brunson\brunsri01,PG,28,BOS,7,0,142,10,35,.286,2,11,.182,8,24,.333,.314,4,9,.444,2,7,9,24,7,1,9,16,26
51,Rick Brunson\brunsri01,PG,28,NYK,15,0,66,8,19,.421,0,3,.000,8,16,.500,.421,4,6,.667,3,9,12,7,1,0,8,5,20
52,Kobe Bryant\bryanko01,SG,22,LAL,68,68,2783,701,1510,.464,61,200,.305,640,1310,.489,.484,475,557,.853,104,295,399,338,114,43,220,222,1938
53,Mark Bryant\bryanma01,PF,35,DAL,18,1,101,8,20,.400,0,0,,8,20,.400,.400,3,5,.600,4,17,21,3,1,2,5,29,19
54,Greg Buckner\buckngr01,SG,24,DAL,37,9,820,84,192,.438,2,7,.286,82,185,.443,.443,59,81,.728,60,97,157,49,33,9,27,118,229
55,Jud Buechler\buechju01,SF,32,DET,57,3,737,76,164,.463,32,77,.416,44,87,.506,.561,9,12,.750,20,74,94,39,21,10,25,83,193
56,Rodney Buford\buforro01,SF,23,PHI,47,0,573,104,241,.432,16,38,.421,88,203,.433,.465,24,29,.828,16,58,74,17,17,6,29,68,248
57,Matt Bullard\bullama01,PF,33,HOU,61,5,1000,129,305,.423,86,213,.404,43,92,.467,.564,10,14,.714,22,108,130,42,10,9,12,76,354
58,Scott Burrell\burresc01,SF,30,CHH,4,0,41,7,15,.467,2,6,.333,5,9,.556,.533,1,4,.250,1,2,3,1,3,0,0,8,17
59,Jason Caffey\caffeja01,PF,27,MIL,70,33,1460,179,367,.488,0,0,,179,367,.488,.488,142,211,.673,135,218,353,53,38,25,77,184,500
60,Marcus Camby\cambyma01,C,26,NYK,63,63,2127,304,580,.524,1,8,.125,303,572,.530,.525,150,225,.667,196,527,723,52,66,136,63,205,759
61,Elden Campbell\campbel01,PF,32,CHH,78,78,2337,367,834,.440,0,6,.000,367,828,.443,.440,288,406,.709,157,451,608,104,60,140,144,280,1022
62,Brian Cardinal\cardibr01,PF,23,DET,15,0,126,10,31,.323,0,5,.000,10,26,.385,.323,11,18,.611,8,15,23,3,7,2,9,27,31
63,Chris Carr\carrch01,SG,26,BOS,35,0,309,53,112,.473,17,37,.459,36,75,.480,.549,46,60,.767,11,33,44,11,4,3,19,45,169
64,Anthony Carter\cartean01,PG,25,MIA,72,6,1630,195,480,.406,6,40,.150,189,440,.430,.413,65,103,.631,46,134,180,268,73,10,119,154,461
65,Vince Carter\cartevi01,SF,24,TOR,75,75,2979,762,1656,.460,162,397,.408,600,1259,.477,.509,384,502,.765,176,240,416,291,114,82,167,205,2070
66,Sam Cassell\cassesa01,PG,31,MIL,76,75,2709,537,1132,.474,30,98,.306,507,1034,.490,.488,277,323,.858,46,244,290,580,88,8,220,214,1381
67,Kelvin Cato\catoke01,C,26,HOU,35,13,624,64,111,.577,0,0,,64,111,.577,.577,37,57,.649,47,94,141,11,13,31,25,89,165
68,Duane Causwell\causwdu01,C,32,MIA,31,14,384,32,85,.376,0,0,,32,85,.376,.376,12,25,.480,23,60,83,5,8,18,23,67,76
69,Cedric Ceballos\cebalce01,SF,31,TOT,40,0,559,101,229,.441,22,73,.301,79,156,.506,.489,37,43,.860,34,72,106,20,16,7,32,61,261
69,Cedric Ceballos\cebalce01,SF,31,DET,13,0,166,28,71,.394,11,40,.275,17,31,.548,.472,8,10,.800,7,19,26,7,6,3,9,19,75
69,Cedric Ceballos\cebalce01,SF,31,MIA,27,0,393,73,158,.462,11,33,.333,62,125,.496,.497,29,33,.879,27,53,80,13,10,4,23,42,186
70,Calbert Cheaney\cheanca01,SG,29,DEN,9,5,153,10,30,.333,0,0,,10,30,.333,.333,1,2,.500,5,15,20,9,4,2,5,14,21
71,Chris Childs\childch01,PG,33,TOT,77,5,1859,135,335,.403,32,106,.302,103,229,.450,.451,60,71,.845,24,178,202,355,59,15,156,242,362
71,Chris Childs\childch01,PG,33,NYK,51,5,1309,93,222,.419,20,64,.313,73,158,.462,.464,39,46,.848,14,124,138,236,37,7,98,160,245
71,Chris Childs\childch01,PG,33,TOR,26,0,550,42,113,.372,12,42,.286,30,71,.423,.425,21,25,.840,10,54,64,119,22,8,58,82,117
72,Doug Christie\chrisdo01,SG,30,SAC,81,81,2939,311,788,.395,94,250,.376,217,538,.403,.454,280,312,.897,95,260,355,289,183,45,154,224,996
73,Keon Clark\clarkke01,PF,25,TOT,81,3,1720,249,519,.480,0,1,.000,249,518,.481,.480,142,240,.592,136,298,434,72,32,154,90,244,640
73,Keon Clark\clarkke01,PF,25,DEN,35,3,752,82,199,.412,0,0,,82,199,.412,.412,63,105,.600,58,128,186,34,16,44,48,101,227
73,Keon Clark\clarkke01,PF,25,TOR,46,0,968,167,320,.522,0,1,.000,167,319,.524,.522,79,135,.585,78,170,248,38,16,110,42,143,413
74,Mateen Cleaves\cleavma01,PG,23,DET,78,8,1268,160,400,.400,5,17,.294,155,383,.405,.406,97,137,.708,26,106,132,207,49,1,139,153,422
75,John Coker\cokerjo01,C,29,GSW,6,0,32,1,8,.125,0,0,,1,8,.125,.125,0,0,,3,2,5,2,1,0,2,4,2
76,Derrick Coleman\colemde01,PF,33,CHH,34,3,683,97,255,.380,20,51,.392,77,204,.377,.420,63,92,.685,46,138,184,39,10,21,42,53,277
77,Bimbo Coles\colesbi01,PG,32,CLE,47,0,804,91,239,.381,2,16,.125,89,223,.399,.385,48,56,.857,9,39,48,138,27,6,59,87,232
78,Jason Collier\collija02,C,23,HOU,23,0,222,27,71,.380,0,1,.000,27,70,.386,.380,17,24,.708,12,25,37,6,2,3,11,27,71
79,Sean Colson\colsose01,PG,25,TOT,13,0,44,6,24,.250,1,5,.200,5,19,.263,.271,2,4,.500,2,4,6,10,1,0,2,6,15
79,Sean Colson\colsose01,PG,25,ATL,3,0,14,0,5,.000,0,1,.000,0,4,.000,.000,0,0,,0,3,3,3,0,0,2,0,0
79,Sean Colson\colsose01,PG,25,HOU,10,0,30,6,19,.316,1,4,.250,5,15,.333,.342,2,4,.500,2,1,3,7,1,0,0,6,15
80,Tyrone Corbin\corbity01,SF,38,TOR,15,1,117,9,38,.237,0,5,.000,9,33,.273,.237,2,4,.500,3,10,13,4,2,0,3,18,20
81,Chris Crawford\crawfch01,PF,25,ATL,47,22,901,122,270,.452,6,22,.273,116,248,.468,.463,68,83,.819,28,82,110,37,21,16,62,117,318
82,Jamal Crawford\crawfja01,PG,20,CHI,61,8,1050,107,304,.352,41,117,.350,66,187,.353,.419,27,34,.794,9,80,89,141,43,14,85,68,282
83,Austin Croshere\croshau01,PF,25,IND,81,23,1874,276,701,.394,70,207,.338,206,494,.417,.444,200,231,.866,123,264,387,92,36,50,136,180,822
84,John Crotty\crottjo01,PG,31,UTA,31,0,264,22,65,.338,4,7,.571,18,58,.310,.369,17,19,.895,13,15,28,34,6,0,19,32,65
85,Vonteego Cummings\cummivo01,PG,24,GSW,66,11,1495,178,517,.344,48,143,.336,130,374,.348,.391,79,116,.681,47,90,137,227,67,14,91,160,483
86,Bill Curley\curlebi01,PF,28,TOT,20,2,192,25,47,.532,1,2,.500,24,45,.533,.543,12,19,.632,21,16,37,3,7,9,16,45,63
86,Bill Curley\curlebi01,PF,28,DAL,5,0,15,1,4,.250,0,1,.000,1,3,.333,.250,1,4,.250,0,0,0,0,1,1,2,4,3
86,Bill Curley\curlebi01,PF,28,GSW,15,2,177,24,43,.558,1,1,1.000,23,42,.548,.570,11,15,.733,21,16,37,3,6,8,14,41,60
87,Dell Curry\curryde01,SG,36,TOR,71,1,956,162,382,.424,62,145,.428,100,237,.422,.505,43,51,.843,16,69,85,75,27,8,39,66,429
88,Michael Curry\currymi01,SG,32,DET,68,58,1485,145,319,.455,4,9,.444,141,310,.455,.461,62,73,.849,21,100,121,132,27,3,61,173,356
89,Erick Dampier\dampier01,C,25,GSW,43,26,1038,126,314,.401,0,2,.000,126,312,.404,.401,67,126,.532,97,153,250,59,17,58,82,123,319
90,Antonio Daniels\daniean01,PG,25,SAS,79,23,2060,275,588,.468,74,183,.404,201,405,.496,.531,121,156,.776,26,137,163,304,61,14,109,120,745
91,Kornel David\davidko01,SF,29,TOT,27,0,209,25,51,.490,0,0,,25,51,.490,.490,12,13,.923,15,37,52,7,6,4,11,28,62
91,Kornel David\davidko01,SF,29,TOR,17,0,140,15,29,.517,0,0,,15,29,.517,.517,12,13,.923,9,24,33,4,2,3,7,20,42
91,Kornel David\davidko01,SF,29,DET,10,0,69,10,22,.455,0,0,,10,22,.455,.455,0,0,,6,13,19,3,4,1,4,8,20
92,Antonio Davis\davisan01,C,32,TOR,78,77,2729,375,866,.433,0,1,.000,375,865,.434,.433,319,423,.754,274,513,787,106,22,151,135,230,1069
93,Baron Davis\davisba01,PG,21,CHH,82,82,3192,409,957,.427,85,274,.310,324,683,.474,.472,228,337,.677,129,279,408,598,170,36,226,267,1131
94,Dale Davis\davisda01,C,31,POR,81,43,2162,242,487,.497,0,4,.000,242,483,.501,.497,96,152,.632,233,373,606,103,44,76,67,199,580
95,Emanual Davis\davisem01,SG,32,SEA,62,39,1290,133,318,.418,50,127,.394,83,191,.435,.497,45,55,.818,28,126,154,137,64,12,77,101,361
96,Hubert Davis\davishu01,PG,30,TOT,66,18,1692,196,433,.453,78,171,.456,118,262,.450,.543,54,62,.871,28,111,139,110,35,1,81,121,524
96,Hubert Davis\davishu01,PG,30,DAL,51,7,1261,139,314,.443,58,133,.436,81,181,.448,.535,35,41,.854,18,91,109,61,29,1,56,92,371
96,Hubert Davis\davishu01,PG,30,WAS,15,11,431,57,119,.479,20,38,.526,37,81,.457,.563,19,21,.905,10,20,30,49,6,0,25,29,153
97,Ricky Davis\davisri01,SG,21,MIA,7,0,70,12,29,.414,1,1,1.000,11,28,.393,.431,7,8,.875,1,6,7,11,5,2,5,7,32
98,Terry Davis\daviste01,PF,33,DEN,19,1,228,12,25,.480,0,0,,12,25,.480,.480,9,22,.409,24,29,53,7,1,1,5,34,33
99,Todd Day\dayto01,SG,31,MIN,31,0,345,44,118,.373,26,69,.377,18,49,.367,.483,18,23,.783,10,27,37,28,10,7,24,52,132
100,Andrew DeClercq\declean01,C,27,ORL,67,51,903,107,193,.554,0,0,,107,193,.554,.554,47,82,.573,91,145,236,32,41,33,51,198,261
101,Vinny Del Negro\delnevi01,PG,34,TOT,65,1,922,106,234,.453,1,13,.077,105,221,.475,.455,41,44,.932,12,70,82,126,26,3,34,78,254
101,Vinny Del Negro\delnevi01,PG,34,GSW,29,1,396,30,90,.333,1,9,.111,29,81,.358,.339,16,16,1.000,4,27,31,62,6,0,15,36,77
101,Vinny Del Negro\delnevi01,PG,34,PHO,36,0,526,76,144,.528,0,4,.000,76,140,.543,.528,25,28,.893,8,43,51,64,20,3,19,42,177
102,Tony Delk\delkto01,SG,27,PHO,82,11,2288,383,923,.415,54,168,.321,329,755,.436,.444,185,235,.787,76,185,261,160,75,17,101,171,1005
103,Derrick Dial\dialde01,SG,25,SAS,33,0,207,36,83,.434,2,10,.200,34,73,.466,.446,12,21,.571,12,26,38,21,4,6,12,22,86
104,Michael Dickerson\dickemi01,SG,25,VAN,70,69,2618,425,1020,.417,86,230,.374,339,790,.429,.459,206,270,.763,70,159,229,233,62,27,162,207,1142
105,Vlade Divac\divacvl01,C,32,SAC,81,81,2420,364,755,.482,4,14,.286,360,741,.486,.485,242,350,.691,207,466,673,231,87,93,192,242,974
106,Michael Doleac\doleami01,C,23,ORL,77,21,1398,220,527,.417,0,3,.000,220,524,.420,.417,50,59,.847,70,203,273,65,37,41,59,239,490
107,Keyon Dooling\doolike01,PG,20,LAC,76,1,1237,148,362,.409,28,80,.350,120,282,.426,.448,125,179,.698,8,81,89,177,41,11,94,107,449
108,Sherman Douglas\douglsh01,PG,34,NJN,59,7,1094,122,303,.403,8,40,.200,114,263,.433,.416,86,115,.748,21,53,74,144,36,4,79,93,338
109,Bryce Drew\drewbr01,PG,26,CHI,48,41,1305,124,327,.379,40,105,.381,84,222,.378,.440,14,19,.737,12,57,69,185,32,3,68,99,302
110,Chris Dudley\dudlech02,C,35,PHO,53,33,613,29,73,.397,0,0,,29,73,.397,.397,14,36,.389,64,119,183,18,14,29,26,111,72
111,Tim Duncan\duncati01,PF,24,SAS,82,82,3174,702,1406,.499,7,27,.259,695,1379,.504,.502,409,662,.618,259,738,997,245,70,192,242,247,1820
112,Tyus Edney\edneyty01,PG,27,IND,24,0,263,35,91,.385,1,6,.167,34,85,.400,.390,35,39,.897,5,19,24,54,17,0,25,17,106
113,Kevin Edwards\edwarke01,SG,35,VAN,46,5,634,56,170,.329,5,19,.263,51,151,.338,.344,43,53,.811,23,59,82,52,29,8,37,46,160
114,Howard Eisley\eisleho01,SG,28,DAL,82,40,2426,265,675,.393,107,269,.398,158,406,.389,.472,104,126,.825,23,174,197,295,99,12,102,218,741
115,Obinna Ekezie\ekeziob01,PF,25,TOT,33,0,281,32,81,.395,0,0,,32,81,.395,.395,37,53,.698,31,47,78,9,5,5,14,48,101
115,Obinna Ekezie\ekeziob01,PF,25,WAS,29,0,273,32,77,.416,0,0,,32,77,.416,.416,37,53,.698,31,45,76,9,5,5,14,46,101
115,Obinna Ekezie\ekeziob01,PF,25,DAL,4,0,8,0,4,.000,0,0,,0,4,.000,.000,0,0,,0,2,2,0,0,0,0,2,0
116,Khalid El-Amin\elamikh01,PG,21,CHI,50,14,936,115,311,.370,28,84,.333,87,227,.383,.415,56,72,.778,21,60,81,145,48,2,54,99,314
117,Mario Elie\eliema01,SG,37,PHO,68,67,1506,104,246,.423,36,100,.360,68,146,.466,.496,55,69,.797,38,117,155,131,58,12,60,112,299
118,Sean Elliott\elliose01,SF,32,SAS,52,34,1229,147,339,.434,55,129,.426,92,210,.438,.515,60,84,.714,17,153,170,81,23,25,51,80,409
119,LaPhonso Ellis\ellisla01,PF,30,MIN,82,5,1948,298,642,.464,7,22,.318,291,620,.469,.470,169,214,.790,199,295,494,93,67,74,108,290,772
120,Pervis Ellison\ellispe01,C,33,SEA,9,0,40,2,7,.286,0,0,,2,7,.286,.286,2,2,1.000,2,10,12,3,0,2,3,13,6
121,Evan Eschmeyer\eschmev01,C,25,NJN,74,51,1331,92,200,.460,0,0,,92,200,.460,.460,67,102,.657,135,231,366,40,41,58,53,220,251
122,Patrick Ewing*\ewingpa01,C,38,SEA,79,79,2107,294,684,.430,0,2,.000,294,682,.431,.430,172,251,.685,124,461,585,92,53,91,151,229,760
123,Jamie Feick\feickja01,C,26,NJN,6,0,149,8,23,.348,0,0,,8,23,.348,.348,6,12,.500,12,44,56,5,8,3,7,15,22
124,Danny Ferry\ferryda01,SF,34,SAS,80,29,1688,178,375,.475,70,156,.449,108,219,.493,.568,22,30,.733,55,168,223,71,28,21,50,169,448
125,Michael Finley\finlemi01,SF,27,DAL,82,82,3443,711,1552,.458,91,263,.346,620,1289,.481,.487,252,325,.775,109,316,425,360,118,32,190,174,1765
126,Derek Fisher\fishede01,PG,26,LAL,20,20,709,77,187,.412,25,63,.397,52,124,.419,.479,50,62,.806,5,54,59,87,39,2,29,50,229
127,Marcus Fizer\fizerma01,PF,22,CHI,72,13,1580,278,646,.430,10,39,.256,268,607,.442,.438,117,161,.727,76,237,313,76,30,19,124,175,683
128,Danny Fortson\fortsda01,PF,24,GSW,6,6,203,29,50,.580,0,0,,29,50,.580,.580,42,54,.778,29,69,98,5,2,0,10,22,100
129,Greg Foster\fostegr01,C,32,LAL,62,8,451,56,133,.421,3,9,.333,53,124,.427,.432,10,14,.714,29,83,112,32,9,12,25,76,125
130,Jeff Foster\fosteje01,C,24,IND,71,9,1152,100,213,.469,2,7,.286,98,206,.476,.474,47,91,.516,144,245,389,33,39,28,52,152,249
131,Rick Fox\foxri01,SF,31,LAL,82,77,2291,287,646,.444,118,300,.393,169,346,.488,.536,95,122,.779,80,245,325,262,70,29,136,225,787
132,Adonal Foyle\foylead01,C,25,GSW,58,37,1457,156,375,.416,0,0,,156,375,.416,.416,30,68,.441,156,249,405,48,31,156,79,136,342
133,Steve Francis\francst01,PG,23,HOU,80,79,3194,550,1219,.451,133,336,.396,417,883,.472,.506,358,438,.817,190,363,553,517,141,31,265,274,1591
134,Todd Fuller\fulleto02,C,26,MIA,10,0,77,10,35,.286,0,0,,10,35,.286,.286,8,8,1.000,7,11,18,1,3,2,3,10,28
135,Lawrence Funderburke\fundela01,PF,30,SAC,59,2,698,120,242,.496,0,0,,120,242,.496,.496,48,77,.623,74,122,196,17,9,13,32,44,288
136,Ruben Garces\garceru01,PF,27,TOT,13,0,73,7,22,.318,0,0,,7,22,.318,.318,2,8,.250,16,13,29,5,3,2,5,14,16
136,Ruben Garces\garceru01,PF,27,PHO,10,0,62,7,15,.467,0,0,,7,15,.467,.467,2,8,.250,12,10,22,4,2,1,5,14,16
136,Ruben Garces\garceru01,PF,27,GSW,3,0,11,0,7,.000,0,0,,0,7,.000,.000,0,0,,4,3,7,1,1,1,0,0,0
137,Chris Garner\garnech01,PG,25,GSW,8,0,149,7,37,.189,0,7,.000,7,30,.233,.189,5,6,.833,2,10,12,18,7,1,9,18,19
138,Kevin Garnett\garneke01,PF,24,MIN,81,81,3202,704,1475,.477,19,66,.288,685,1409,.486,.484,357,467,.764,219,702,921,401,111,145,230,204,1784
139,Dean Garrett\garrede01,C,34,MIN,70,21,831,75,156,.481,0,0,,75,156,.481,.481,27,39,.692,65,152,217,24,26,49,25,93,177
140,Pat Garrity\garripa01,SF,24,ORL,76,1,1579,223,576,.387,97,224,.433,126,352,.358,.471,85,98,.867,51,159,210,51,40,15,68,241,628
141,Chris Gatling\gatlich01,PF,33,CLE,74,6,1670,329,733,.449,28,92,.304,301,641,.470,.468,156,228,.684,99,292,391,61,52,27,119,185,842
142,Matt Geiger\geigema01,C,31,PHI,35,4,542,88,224,.393,0,2,.000,88,222,.396,.393,37,54,.685,50,89,139,14,12,8,25,73,213
143,Devean George\georgde01,SF,23,LAL,59,1,593,64,207,.309,15,68,.221,49,139,.353,.345,39,55,.709,35,75,110,19,15,15,34,87,182
144,Eddie Gill\gilled01,PG,22,NJN,8,0,152,16,41,.390,3,9,.333,13,32,.406,.427,4,5,.800,0,9,9,24,4,1,10,9,39
145,Kendall Gill\gillke01,SG,32,NJN,31,26,892,107,323,.331,4,14,.286,103,309,.333,.337,65,90,.722,32,99,131,87,47,7,48,64,283
146,Dion Glover\glovedi01,SG,22,ATL,57,7,929,141,336,.420,9,46,.196,132,290,.455,.433,47,69,.681,39,92,131,69,49,10,54,92,338
147,Anthony Goldwire\goldwan01,PG,29,DEN,20,0,201,30,80,.375,9,34,.265,21,46,.457,.431,13,17,.765,1,11,12,34,9,0,15,13,82
148,Steve Goodrich\goodrst01,PF,24,CHI,12,0,133,7,18,.389,1,3,.333,6,15,.400,.417,4,7,.571,7,14,21,6,2,1,8,14,19
149,Brian Grant\grantbr01,C,28,MIA,82,79,2771,484,1010,.479,0,1,.000,484,1009,.480,.479,282,354,.797,217,501,718,101,60,71,170,293,1250
150,Gary Grant\grantga01,PG,35,POR,4,0,17,5,7,.714,0,0,,5,7,.714,.714,0,0,,0,0,0,1,0,0,0,1,10
151,Horace Grant\grantho01,PF,35,LAL,77,77,2390,263,569,.462,0,3,.000,263,566,.465,.462,131,169,.775,220,325,545,121,51,61,48,181,657
152,A.C. Green\greenac01,PF,37,MIA,82,1,1411,144,324,.444,0,6,.000,144,318,.453,.444,79,111,.712,107,206,313,39,30,8,45,119,367
153,Adrian Griffin\griffad01,SF,26,BOS,44,0,377,33,97,.340,9,26,.346,24,71,.338,.387,18,24,.750,27,60,87,27,18,5,18,45,93
154,Tom Gugliotta\guglito01,PF,31,PHO,57,2,1159,149,380,.392,3,12,.250,146,368,.397,.396,61,77,.792,76,179,255,55,47,21,51,110,362
155,A.J. Guyton\guytoaj01,PG,22,CHI,33,8,630,78,192,.406,27,69,.391,51,123,.415,.477,15,18,.833,10,26,36,64,9,5,24,35,198
156,Darvin Ham\hamda01,SF,27,MIL,29,13,540,39,80,.488,2,3,.667,37,77,.481,.500,29,49,.592,56,65,121,25,17,21,33,85,109
157,Richard Hamilton\hamilri01,SF,22,WAS,78,42,2519,547,1249,.438,40,146,.274,507,1103,.460,.454,277,319,.868,75,163,238,224,75,10,201,203,1411
158,Zendon Hamilton\hamilze01,C,25,LAC,3,0,19,2,9,.222,0,0,,2,9,.222,.222,5,8,.625,3,5,8,0,0,0,2,4,9
159,Tom Hammonds\hammoto01,PF,33,MIN,7,0,30,3,10,.300,0,0,,3,10,.300,.300,1,2,.500,2,2,4,1,0,0,3,8,7
160,Anfernee Hardaway\hardaan01,SG,29,PHO,4,4,112,15,36,.417,2,8,.250,13,28,.464,.444,7,11,.636,5,13,18,15,6,1,3,6,39
161,Tim Hardaway\hardati01,PG,34,MIA,77,77,2613,408,1042,.392,189,517,.366,219,525,.417,.482,145,181,.801,26,178,204,483,90,6,189,155,1150
162,Ron Harper\harpero01,PG,37,LAL,47,46,1139,127,271,.469,19,72,.264,108,199,.543,.504,34,48,.708,46,120,166,113,39,25,62,70,307
163,Matt Harpring\harprma01,SG,24,CLE,56,55,1615,238,524,.454,13,52,.250,225,472,.477,.467,134,165,.812,90,152,242,102,42,17,90,161,623
164,Al Harrington\harrial01,PF,20,IND,78,38,1892,241,543,.444,1,7,.143,240,536,.448,.445,103,157,.656,119,262,381,130,63,18,148,223,586
165,Othella Harrington\harriot01,C,27,TOT,74,45,1815,247,507,.487,0,3,.000,247,504,.490,.487,171,224,.763,139,249,388,56,34,45,145,237,665
165,Othella Harrington\harriot01,C,27,VAN,44,40,1267,180,386,.466,0,3,.000,180,383,.470,.466,120,154,.779,102,187,289,36,19,26,104,136,480
165,Othella Harrington\harriot01,C,27,NYK,30,5,548,67,121,.554,0,0,,67,121,.554,.554,51,70,.729,37,62,99,20,15,19,41,101,185
166,Lucious Harris\harrilu01,SG,30,NJN,73,50,2071,265,624,.425,46,132,.348,219,492,.445,.462,107,139,.770,71,217,288,135,74,16,64,127,683
167,Jason Hart\hartja01,PG,22,MIL,1,0,10,1,1,1.000,0,0,,1,1,1.000,1.000,0,0,,0,0,0,1,0,0,2,0,2
168,Antonio Harvey\harvean01,PF,30,POR,12,0,72,13,28,.464,0,0,,13,28,.464,.464,5,6,.833,5,9,14,4,1,6,3,10,31
169,Donnell Harvey\harvedo01,PF,20,DAL,18,0,65,8,14,.571,0,0,,8,14,.571,.571,6,16,.375,6,14,20,2,3,1,7,15,22
170,Hersey Hawkins\hawkihe01,SG,34,CHH,59,0,681,56,137,.409,17,46,.370,39,91,.429,.471,54,63,.857,17,63,80,72,33,9,19,45,183
171,Michael Hawkins\hawkimi01,PG,28,CLE,10,0,76,3,9,.333,2,4,.500,1,5,.200,.444,0,0,,2,3,5,13,2,0,6,13,8
172,Alan Henderson\hendeal01,PF,28,ATL,73,42,1810,298,671,.444,0,1,.000,298,670,.445,.444,173,271,.638,180,226,406,50,51,29,126,164,769
173,Cedric Henderson\hendece02,SF,25,CLE,55,10,961,102,262,.389,1,8,.125,101,254,.398,.391,30,46,.652,19,71,90,79,29,23,63,101,235
174,Chris Herren\herrech01,PG,25,BOS,25,7,408,29,96,.302,16,55,.291,13,41,.317,.385,9,12,.750,4,17,21,56,14,0,20,43,83
175,Grant Hill*\hillgr01,SF,28,ORL,4,4,133,19,43,.442,1,1,1.000,18,42,.429,.453,16,26,.615,8,17,25,25,5,2,11,9,55
176,Tyrone Hill\hillty01,PF,32,PHI,76,75,2363,278,587,.474,0,1,.000,278,586,.474,.474,172,273,.630,239,448,687,48,37,27,127,242,728
177,Fred Hoiberg\hoibefr01,SG,28,CHI,74,37,2247,217,495,.438,103,250,.412,114,245,.465,.542,136,157,.866,21,287,308,263,98,12,74,155,673
178,Robert Horry\horryro01,PF,30,LAL,79,1,1587,147,380,.387,54,156,.346,93,224,.415,.458,59,83,.711,93,203,296,128,54,54,79,210,407
179,Eddie House\houseed01,PG,22,MIA,50,0,550,104,247,.421,19,55,.345,85,192,.443,.460,24,35,.686,5,37,42,52,13,0,35,58,251
180,Allan Houston\houstal01,SG,29,NYK,78,78,2858,542,1208,.449,96,252,.381,446,956,.467,.488,279,307,.909,20,263,283,173,52,10,161,190,1459
181,Juwan Howard\howarju01,PF,27,TOT,81,81,2974,583,1218,.479,0,3,.000,583,1215,.480,.479,296,383,.773,171,401,572,224,75,37,242,292,1462
181,Juwan Howard\howarju01,PF,27,WAS,54,54,1981,392,827,.474,0,0,,392,827,.474,.474,197,256,.770,121,258,379,154,46,21,169,186,981
181,Juwan Howard\howarju01,PF,27,DAL,27,27,993,191,391,.488,0,3,.000,191,388,.492,.488,99,127,.780,50,143,193,70,29,16,73,106,481
182,Troy Hudson\hudsotr01,PG,24,ORL,75,7,1008,125,372,.336,22,109,.202,103,263,.392,.366,85,104,.817,38,67,105,162,37,3,92,82,357
183,Larry Hughes\hughela01,SG,22,GSW,50,45,1846,308,805,.383,14,75,.187,294,730,.403,.391,193,252,.766,76,200,276,223,96,29,152,147,823
184,Lindsey Hunter\hunteli01,PG,30,MIL,82,5,2002,298,783,.381,152,407,.373,146,376,.388,.478,77,96,.802,32,137,169,222,102,12,68,172,825
185,Zydrunas Ilgauskas\ilgauzy01,C,25,CLE,24,24,616,114,234,.487,0,2,.000,114,232,.491,.487,53,78,.679,65,95,160,18,15,37,60,78,281
186,Allen Iverson*\iversal01,SG,25,PHI,71,71,2979,762,1813,.420,98,306,.320,664,1507,.441,.447,585,719,.814,50,223,273,325,178,20,237,147,2207
187,Bobby Jackson\jacksbo01,PG,27,SAC,79,7,1648,231,526,.439,39,104,.375,192,422,.455,.476,65,88,.739,74,172,246,161,87,7,103,139,566
188,Jaren Jackson\jacksja01,SG,33,SAS,16,0,114,16,40,.400,7,18,.389,9,22,.409,.488,0,2,.000,1,11,12,7,5,0,3,13,39
189,Jim Jackson\jacksji01,SF,30,TOT,56,40,1690,239,632,.378,26,80,.325,213,552,.386,.399,139,169,.822,53,171,224,163,53,10,130,139,643
189,Jim Jackson\jacksji01,SF,30,ATL,17,14,550,77,217,.355,16,38,.421,61,179,.341,.392,73,85,.859,17,62,79,50,19,4,48,42,243
189,Jim Jackson\jacksji01,SF,30,CLE,39,26,1140,162,415,.390,10,42,.238,152,373,.408,.402,66,84,.786,36,109,145,113,34,6,82,97,400
190,Marc Jackson\jacksma02,C,26,GSW,48,35,1410,237,508,.467,5,23,.217,232,485,.478,.471,154,192,.802,119,242,361,59,34,27,93,138,633
191,Mark Jackson\jacksma01,PG,35,TOT,83,82,2588,244,583,.419,70,207,.338,174,376,.463,.479,73,93,.785,63,242,305,661,84,7,175,139,631
191,Mark Jackson\jacksma01,PG,35,TOR,54,54,1802,170,403,.422,57,165,.345,113,238,.475,.493,64,76,.842,42,143,185,498,63,7,117,83,461
191,Mark Jackson\jacksma01,PG,35,NYK,29,28,786,74,180,.411,13,42,.310,61,138,.442,.447,9,17,.529,21,99,120,163,21,0,58,56,170
192,Stephen Jackson\jacksst02,SF,22,NJN,77,40,1660,243,572,.425,52,155,.335,191,417,.458,.470,97,135,.719,41,167,208,140,86,14,130,166,635
193,Sam Jacobson\jacobsa01,PG,25,MIN,14,0,59,9,18,.500,0,0,,9,18,.500,.500,2,3,.667,3,3,6,4,3,0,0,19,20
194,Tim James\jamesti01,SF,24,CHH,30,0,197,16,52,.308,1,3,.333,15,49,.306,.317,12,14,.857,15,20,35,8,2,5,8,27,45
195,Antawn Jamison\jamisan01,SF,24,GSW,82,82,3394,800,1812,.442,62,205,.302,738,1607,.459,.459,382,534,.715,280,435,715,164,114,28,199,225,2044
196,Anthony Johnson\johnsan02,PG,26,TOT,53,0,511,53,152,.349,1,5,.200,52,147,.354,.352,23,33,.697,10,34,44,78,23,6,34,62,130
196,Anthony Johnson\johnsan02,PG,26,ATL,25,0,279,26,71,.366,0,3,.000,26,68,.382,.366,12,17,.706,3,20,23,34,17,5,20,41,64
196,Anthony Johnson\johnsan02,PG,26,CLE,28,0,232,27,81,.333,1,2,.500,26,79,.329,.340,11,16,.688,7,14,21,44,6,1,14,21,66
197,Avery Johnson\johnsav01,PG,35,SAS,55,20,1290,134,300,.447,1,6,.167,133,294,.452,.448,41,60,.683,21,64,85,237,33,4,60,90,310
198,DerMarr Johnson\johnsde03,SF,20,ATL,78,21,1313,146,390,.374,41,127,.323,105,263,.399,.427,64,87,.736,56,122,178,64,43,30,93,134,397
199,Ervin Johnson\johnser02,C,33,MIL,82,19,1981,108,198,.545,0,0,,108,198,.545,.545,50,93,.538,205,408,613,40,44,97,47,257,266
200,Larry Johnson\johnsla02,PF,31,NYK,65,65,2105,246,598,.411,51,163,.313,195,435,.448,.454,102,128,.797,90,273,363,127,39,29,97,209,645
201,Damon Jones\jonesda01,PG,24,VAN,71,10,1415,170,416,.409,84,231,.364,86,185,.465,.510,37,52,.712,16,108,124,224,36,1,76,58,461
202,Eddie Jones\jonesed02,SG,29,MIA,63,58,2282,388,871,.445,90,238,.378,298,633,.471,.497,228,270,.844,75,217,292,171,110,58,135,183,1094
203,Jumaine Jones\jonesju01,SF,21,PHI,65,0,866,122,275,.444,20,60,.333,102,215,.474,.480,40,53,.755,63,126,189,32,30,15,39,68,304
204,Popeye Jones\jonespo01,PF,30,WAS,45,1,638,60,153,.392,1,6,.167,59,147,.401,.395,41,55,.745,83,137,220,31,19,8,21,95,162
205,Garth Joseph\josepga01,C,27,TOT,4,0,16,1,5,.200,0,0,,1,5,.200,.200,0,2,.000,2,0,2,1,0,1,2,1,2
205,Garth Joseph\josepga01,C,27,TOR,2,0,8,1,2,.500,0,0,,1,2,.500,.500,0,0,,2,0,2,1,0,0,1,1,2
205,Garth Joseph\josepga01,C,27,DEN,2,0,8,0,3,.000,0,0,,0,3,.000,.000,0,2,.000,0,0,0,0,0,1,1,0,0
206,Adam Keefe\keefead01,PF,30,GSW,67,13,836,64,159,.403,1,3,.333,63,156,.404,.406,39,63,.619,90,119,209,36,28,20,40,102,168
207,Shawn Kemp\kempsh01,PF,31,POR,68,3,1083,168,413,.407,4,11,.364,164,402,.408,.412,101,131,.771,63,196,259,65,45,23,99,184,441
208,Steve Kerr\kerrst01,PG,35,SAS,55,1,650,67,159,.421,33,77,.429,34,82,.415,.525,14,15,.933,6,29,35,57,16,1,21,30,181
209,Jerome Kersey\kerseje01,SF,38,MIL,22,2,243,32,69,.464,0,1,.000,32,68,.471,.464,8,16,.500,8,37,45,15,14,8,6,36,72
210,Lari Ketner\ketnela01,PF,23,IND,3,0,7,0,0,,0,0,,0,0,,,0,0,,0,0,0,1,0,0,2,0,0
211,Jason Kidd*\kiddja01,PG,27,PHO,77,76,3065,451,1097,.411,69,232,.297,382,865,.442,.443,328,403,.814,91,403,494,753,166,23,286,171,1299
212,Gerard King\kingge02,SF,28,WAS,45,3,706,90,176,.511,0,0,,90,176,.511,.511,36,45,.800,39,90,129,31,14,11,47,94,216
213,Brevin Knight\knighbr01,PG,25,TOT,53,43,1457,139,371,.375,1,10,.100,138,361,.382,.376,54,66,.818,23,145,168,311,101,4,91,155,333
213,Brevin Knight\knighbr01,PG,25,CLE,6,0,93,2,15,.133,0,0,,2,15,.133,.133,5,6,.833,1,6,7,25,6,1,7,17,9
213,Brevin Knight\knighbr01,PG,25,ATL,47,43,1364,137,356,.385,1,10,.100,136,346,.393,.386,49,60,.817,22,139,161,286,95,3,84,138,324
214,Travis Knight\knightr01,C,26,NYK,45,0,256,10,53,.189,0,1,.000,10,52,.192,.189,9,18,.500,19,34,53,5,5,11,10,47,29
215,Toni Kukoc\kukocto01,SF,32,TOT,65,19,1597,275,582,.473,70,157,.446,205,425,.482,.533,101,160,.631,66,193,259,199,48,11,111,98,721
215,Toni Kukoc\kukocto01,SF,32,PHI,48,5,979,151,330,.458,32,78,.410,119,252,.472,.506,52,88,.591,47,115,162,93,35,6,60,62,386
215,Toni Kukoc\kukocto01,SF,32,ATL,17,14,618,124,252,.492,38,79,.481,86,173,.497,.567,49,72,.681,19,78,97,106,13,5,51,36,335
216,Christian Laettner\laettch01,C-PF,31,TOT,78,48,1663,277,551,.503,4,13,.308,273,538,.507,.506,170,204,.833,118,247,365,124,71,46,137,242,728
216,Christian Laettner\laettch01,C,31,DAL,53,35,930,165,323,.511,1,3,.333,164,320,.513,.512,67,82,.817,75,137,212,67,40,27,70,159,398
216,Christian Laettner\laettch01,PF,31,WAS,25,13,733,112,228,.491,3,10,.300,109,218,.500,.498,103,122,.844,43,110,153,57,31,19,67,83,330
217,Raef LaFrentz\lafrera01,C,24,DEN,78,74,2457,387,812,.477,51,139,.367,336,673,.499,.508,183,262,.698,173,434,607,107,37,206,97,290,1008
218,Trajan Langdon\langdtr01,SG,24,CLE,65,5,1116,135,313,.431,51,124,.411,84,189,.444,.513,68,76,.895,12,77,89,81,38,9,52,114,389
219,Dan Langhi\langhda01,SF,23,HOU,33,0,241,37,99,.374,0,1,.000,37,98,.378,.374,16,29,.552,13,28,41,4,7,1,8,16,90
220,Voshon Lenard\lenarvo01,SG,27,DEN,80,58,2331,336,846,.397,147,382,.385,189,464,.407,.484,153,192,.797,47,184,231,190,65,18,102,170,972
221,Quincy Lewis\lewisqu01,SF,23,UTA,35,2,402,50,123,.407,9,25,.360,41,98,.418,.443,15,21,.714,14,33,47,18,10,10,17,78,124
222,Rashard Lewis\lewisra02,PF,21,SEA,78,78,2720,426,887,.480,123,285,.432,303,602,.503,.550,176,213,.826,143,398,541,125,91,45,129,191,1151
223,Randy Livingston\livinra01,PG,25,GSW,2,0,7,0,2,.000,0,1,.000,0,1,.000,.000,0,0,,0,1,1,1,0,0,0,0,0
224,Art Long\longar01,SF,28,SAC,9,0,20,0,4,.000,0,0,,0,4,.000,.000,0,2,.000,2,6,8,1,0,3,2,5,0
225,Grant Long\longgr01,PF,34,VAN,66,27,1507,140,319,.439,4,15,.267,136,304,.447,.445,112,157,.713,76,198,274,83,72,15,62,160,396
226,Luc Longley\longllu01,C,32,NYK,25,2,301,18,54,.333,0,0,,18,54,.333,.333,13,17,.765,26,40,66,7,3,9,22,51,49
227,Felipe Lopez\lopezfe01,SG-PG,26,TOT,70,48,1565,211,478,.441,19,52,.365,192,426,.451,.461,109,156,.699,55,179,234,107,62,30,83,156,550
227,Felipe Lopez\lopezfe01,SG,26,WAS,47,38,1108,142,326,.436,6,29,.207,136,297,.458,.445,90,123,.732,30,130,160,73,41,18,56,110,380
227,Felipe Lopez\lopezfe01,PG,26,MIN,23,10,457,69,152,.454,13,23,.565,56,129,.434,.497,19,33,.576,25,49,74,34,21,12,27,46,170
228,Tyronn Lue\luety01,PG,23,LAL,38,1,468,50,117,.427,11,34,.324,39,83,.470,.474,19,24,.792,5,27,32,45,19,0,27,54,130
229,George Lynch\lynchge01,SF,30,PHI,82,80,2649,274,616,.445,15,57,.263,259,559,.463,.457,123,171,.719,200,390,590,139,99,30,109,222,686
230,Todd MacCulloch\maccuto01,C,25,PHI,63,3,597,109,185,.589,0,0,,109,185,.589,.589,42,66,.636,69,99,168,10,7,19,27,96,260
231,Don MacLean\macledo01,SF,31,MIA,8,1,76,10,20,.500,2,2,1.000,8,18,.444,.550,9,12,.750,7,11,18,4,5,1,10,9,31
232,Mark Madsen\madsema01,PF,25,LAL,70,3,641,55,113,.487,1,1,1.000,54,112,.482,.491,26,37,.703,74,78,152,24,8,8,27,111,137
233,Corey Maggette\maggeco01,SF,21,LAC,69,9,1359,225,487,.462,17,56,.304,208,431,.483,.479,223,288,.774,88,203,291,82,35,9,106,140,690
234,Jamaal Magloire\magloja01,C,22,CHH,74,0,1095,122,271,.450,0,2,.000,122,269,.454,.450,95,145,.655,103,192,295,27,18,78,61,139,339
235,Dan Majerle\majerda01,SG,35,MIA,53,19,1306,87,259,.336,57,181,.315,30,78,.385,.446,36,44,.818,20,146,166,88,53,15,35,98,267
236,Karl Malone*\malonka01,PF,37,UTA,81,81,2895,670,1345,.498,2,5,.400,668,1340,.499,.499,536,676,.793,114,555,669,361,93,62,244,216,1878
237,Matt Maloney\malonma01,PG,29,ATL,55,27,1403,146,348,.420,51,142,.359,95,206,.461,.493,26,34,.765,14,103,117,154,56,5,70,94,369
238,Danny Manning\mannida01,PF,34,UTA,82,0,1305,247,500,.494,7,28,.250,240,472,.508,.501,102,140,.729,66,148,214,92,47,29,96,219,603
239,Stephon Marbury\marbust01,PG,23,NJN,67,67,2557,563,1277,.441,110,335,.328,453,942,.481,.484,362,458,.790,53,152,205,506,79,5,197,150,1598
240,Shawn Marion\mariosh01,SF,22,PHO,79,79,2857,557,1160,.480,21,82,.256,536,1078,.497,.489,234,289,.810,220,628,848,160,132,108,129,211,1369
241,Donyell Marshall\marshdo01,SF,27,UTA,81,49,2326,427,849,.503,41,128,.320,386,721,.535,.527,205,273,.751,172,394,566,133,85,78,128,196,1100
242,Darrick Martin\martida01,PG,29,SAC,31,0,176,29,76,.382,14,27,.519,15,49,.306,.474,31,35,.886,2,14,16,14,7,0,10,27,103
243,Kenyon Martin\martike01,PF,23,NJN,68,68,2272,346,777,.445,1,11,.091,345,766,.450,.446,121,192,.630,137,365,502,131,78,113,138,281,814
244,Jamal Mashburn\mashbja01,SF,28,CHH,76,76,2989,573,1388,.413,103,289,.356,470,1099,.428,.450,279,364,.766,92,484,576,411,85,13,211,185,1528
245,Anthony Mason\masonan01,PF,34,MIA,80,80,3254,460,954,.482,0,0,,460,954,.482,.482,370,474,.781,169,601,770,248,80,25,179,231,1290
246,Desmond Mason\masonde01,SF,23,SEA,78,14,1522,189,439,.431,18,67,.269,171,372,.460,.451,67,91,.736,72,177,249,63,39,20,53,146,463
247,Tony Massenburg\masseto01,PF,33,VAN,52,20,823,92,199,.462,0,0,,92,199,.462,.462,49,70,.700,75,135,210,9,10,28,48,122,233
248,Vernon Maxwell\maxweve01,PG,35,TOT,43,6,660,73,223,.327,34,111,.306,39,112,.348,.404,21,32,.656,4,62,66,49,21,3,35,64,201
248,Vernon Maxwell\maxweve01,PG,35,PHI,24,6,375,42,125,.336,21,64,.328,21,61,.344,.420,15,22,.682,3,34,37,29,12,0,18,33,120
248,Vernon Maxwell\maxweve01,PG,35,DAL,19,0,285,31,98,.316,13,47,.277,18,51,.353,.383,6,10,.600,1,28,29,20,9,3,17,31,81
249,Walter McCarty\mccarwa01,PF,26,BOS,60,3,478,45,126,.357,19,56,.339,26,70,.371,.433,22,28,.786,24,57,81,39,14,7,20,82,131
250,Dan McClintock\mcclida01,C,23,DEN,6,1,58,9,18,.500,0,0,,9,18,.500,.500,0,5,.000,10,7,17,1,0,2,3,11,18
251,George McCloud\mccloge01,SF,33,DEN,76,8,2007,250,655,.382,77,234,.329,173,421,.411,.440,152,181,.840,55,169,224,279,53,27,117,165,729
252,Jelani McCoy\mccoyje01,C,23,SEA,70,44,1143,138,264,.523,0,0,,138,264,.523,.523,41,93,.441,92,159,251,57,18,49,75,141,317
253,Antonio McDyess\mcdyean01,PF,26,DEN,70,70,2555,577,1165,.495,0,0,,577,1165,.495,.495,304,434,.700,240,605,845,146,43,102,162,220,1458
254,Tracy McGrady*\mcgratr01,SG,21,ORL,77,77,3087,788,1724,.457,59,166,.355,729,1558,.468,.474,430,587,.733,192,388,580,352,116,118,198,160,2065
255,Jim McIlvaine\mcilvji01,C,28,NJN,18,3,193,10,28,.357,0,0,,10,28,.357,.357,8,12,.667,8,27,35,4,7,15,9,35,28
256,Jeff McInnis\mcinnje01,PG,26,LAC,81,81,2831,432,933,.463,52,144,.361,380,789,.482,.491,130,161,.807,41,179,220,447,75,7,113,199,1046
257,Derrick McKey\mckeyde01,SF,34,IND,66,20,987,60,136,.441,4,20,.200,56,116,.483,.456,21,27,.778,49,127,176,74,48,13,47,136,145
258,Aaron McKie\mckieaa01,SG,28,PHI,76,33,2394,338,714,.473,53,170,.312,285,544,.524,.511,149,194,.768,33,278,311,377,106,8,203,178,878
259,Roshown McLeod\mcleoro01,SF,25,TOT,35,25,922,145,332,.437,2,22,.091,143,310,.461,.440,45,51,.882,38,82,120,58,23,8,58,90,337
259,Roshown McLeod\mcleoro01,SF,25,ATL,34,25,907,144,330,.436,2,21,.095,142,309,.460,.439,45,51,.882,37,81,118,58,23,8,57,88,335
259,Roshown McLeod\mcleoro01,SF,25,PHI,1,0,15,1,2,.500,0,1,.000,1,1,1.000,.500,0,0,,1,1,2,0,0,0,1,2,2
260,Paul McPherson\mcphepa01,PG,22,TOT,55,0,595,109,216,.505,2,12,.167,107,204,.525,.509,42,58,.724,40,39,79,38,25,4,47,80,262
260,Paul McPherson\mcphepa01,PG,22,PHO,33,0,308,47,96,.490,0,6,.000,47,90,.522,.490,18,24,.750,20,28,48,16,12,3,23,48,112
260,Paul McPherson\mcphepa01,PG,22,GSW,22,0,287,62,120,.517,2,6,.333,60,114,.526,.525,24,34,.706,20,11,31,22,13,1,24,32,150
261,Stanislav Medvedenko\medvest01,PF,21,LAL,7,0,39,12,25,.480,1,1,1.000,11,24,.458,.500,7,12,.583,1,8,9,2,1,1,3,9,32
262,Ron Mercer\mercero01,SG,24,CHI,61,61,2535,500,1121,.446,14,46,.304,486,1075,.452,.452,188,228,.825,72,164,236,201,78,27,129,148,1202
263,Chris Mihm\mihmch01,C,21,CLE,59,43,1166,173,391,.442,0,1,.000,173,390,.444,.442,100,126,.794,106,174,280,16,20,53,80,156,446
264,Darius Miles\milesda01,SF,19,LAC,81,21,2133,318,630,.505,1,19,.053,317,611,.519,.506,124,238,.521,127,350,477,99,51,125,147,191,761
265,Andre Miller\millean02,PG,24,CLE,82,82,2848,452,999,.452,17,64,.266,435,935,.465,.461,375,450,.833,94,266,360,657,119,28,265,229,1296
266,Anthony Miller\millean01,PF,29,TOT,4,0,11,1,2,.500,0,0,,1,2,.500,.500,0,0,,0,2,2,0,0,0,1,1,2
266,Anthony Miller\millean01,PF,29,ATL,2,0,6,1,2,.500,0,0,,1,2,.500,.500,0,0,,0,2,2,0,0,0,1,0,2
266,Anthony Miller\millean01,PF,29,HOU,1,0,3,0,0,,0,0,,0,0,,,0,0,,0,0,0,0,0,0,0,1,0
266,Anthony Miller\millean01,PF,29,PHI,1,0,2,0,0,,0,0,,0,0,,,0,0,,0,0,0,0,0,0,0,0,0
267,Brad Miller\millebr01,C,24,CHI,57,45,1434,168,386,.435,1,5,.200,167,381,.438,.437,168,226,.743,144,275,419,107,33,38,73,176,505
268,Mike Miller\millemi01,SF,20,ORL,82,62,2390,368,845,.436,148,364,.407,220,481,.457,.523,91,128,.711,66,261,327,140,51,19,97,200,975
269,Reggie Miller*\millere01,SG,35,IND,81,81,3181,517,1176,.440,170,464,.366,347,712,.487,.512,323,348,.928,38,247,285,260,81,15,133,162,1527
270,Chris Mills\millsch01,SF,31,GSW,15,8,493,71,191,.372,7,25,.280,64,166,.386,.390,31,36,.861,24,69,93,18,9,5,20,43,180
271,Terry Mills\millste01,PF,33,IND,14,0,113,11,34,.324,3,17,.176,8,17,.471,.368,0,0,,4,17,21,5,3,1,10,20,25
272,Sam Mitchell\mitchsa01,SF,37,MIN,82,4,983,118,289,.408,9,43,.209,109,246,.443,.424,40,55,.727,28,95,123,57,26,10,36,117,285
273,Cuttino Mobley\moblecu01,SG,25,HOU,79,49,3002,527,1214,.434,90,252,.357,437,962,.454,.471,394,474,.831,83,314,397,195,84,26,165,169,1538
274,Nazr Mohammed\mohamna01,C,23,TOT,58,22,912,176,369,.477,0,1,.000,176,368,.478,.477,89,126,.706,115,192,307,19,29,35,64,113,441
274,Nazr Mohammed\mohamna01,C,23,PHI,30,3,196,41,88,.466,0,0,,41,88,.466,.466,14,28,.500,18,37,55,2,6,7,9,40,96
274,Nazr Mohammed\mohamna01,C,23,ATL,28,19,716,135,281,.480,0,1,.000,135,280,.482,.480,75,98,.765,97,155,252,17,23,28,55,73,345
275,Jerome Moiso\moisoje01,C,22,BOS,24,0,135,12,30,.400,0,1,.000,12,29,.414,.400,11,26,.423,12,30,42,3,3,4,18,29,35
276,Eric Montross\montrer01,C,29,TOT,54,21,649,56,138,.406,0,0,,56,138,.406,.406,8,31,.258,52,121,173,19,11,26,41,115,120
276,Eric Montross\montrer01,C,29,DET,42,20,568,50,121,.413,0,0,,50,121,.413,.413,7,26,.269,43,101,144,15,8,23,37,100,107
276,Eric Montross\montrer01,C,29,TOR,12,1,81,6,17,.353,0,0,,6,17,.353,.353,1,5,.200,9,20,29,4,3,3,4,15,13
277,Mikki Moore\mooremi01,C,25,DET,81,2,1154,132,268,.493,0,1,.000,132,267,.494,.493,95,130,.731,121,195,316,33,24,61,74,202,359
278,Hanno Mottola\mottoha01,SF,24,ATL,73,3,989,123,277,.444,0,3,.000,123,274,.449,.444,73,90,.811,49,125,174,25,11,9,67,163,319
279,Alonzo Mourning*\mournal01,C,30,MIA,13,3,306,73,141,.518,0,1,.000,73,140,.521,.518,31,55,.564,35,66,101,12,4,31,28,24,177
280,Chris Mullin*\mullich01,SF,37,GSW,20,8,374,36,106,.340,19,52,.365,17,54,.315,.429,24,28,.857,10,31,41,19,16,10,19,28,115
281,Lamond Murray\murrala01,SF,27,CLE,78,46,2225,391,925,.423,61,165,.370,330,760,.434,.456,155,211,.735,104,236,340,124,83,27,141,173,998
282,Tracy Murray\murratr01,SF,29,TOT,51,1,588,94,248,.379,36,103,.350,58,145,.400,.452,33,42,.786,22,59,81,23,12,7,26,53,257
282,Tracy Murray\murratr01,SF,29,DEN,13,0,135,17,55,.309,7,23,.304,10,32,.313,.373,9,10,.900,4,18,22,9,4,1,6,8,50
282,Tracy Murray\murratr01,SF,29,TOR,38,1,453,77,193,.399,29,80,.363,48,113,.425,.474,24,32,.750,18,41,59,14,8,6,20,45,207
283,Dikembe Mutombo*\mutomdi01,C,34,TOT,75,75,2591,269,556,.484,0,0,,269,556,.484,.484,211,291,.725,307,708,1015,76,29,203,144,204,749
283,Dikembe Mutombo*\mutomdi01,C,34,ATL,49,49,1716,169,354,.477,0,0,,169,354,.477,.477,107,154,.695,188,505,693,54,20,137,92,139,445
283,Dikembe Mutombo*\mutomdi01,C,34,PHI,26,26,875,100,202,.495,0,0,,100,202,.495,.495,104,137,.759,119,203,322,22,9,66,52,65,304
284,Mamadou N'Diaye\ndiayma02,C,25,TOR,3,0,10,1,4,.250,0,0,,1,4,.250,.250,2,2,1.000,1,1,2,0,0,0,0,3,4
285,Lee Nailon\nailole01,SF,25,CHH,42,0,469,66,136,.485,0,1,.000,66,135,.489,.485,32,43,.744,29,63,92,24,9,5,27,60,164
286,Eduardo Najera\najered01,PF,24,DAL,40,4,431,58,111,.523,1,3,.333,57,108,.528,.527,14,33,.424,41,54,95,27,13,8,17,48,131
287,Steve Nash*\nashst01,PG,26,DAL,70,70,2387,386,792,.487,89,219,.406,297,573,.518,.544,231,258,.895,46,177,223,509,72,5,205,158,1092
288,Tyrone Nesby\nesbyty01,SF-SG,25,TOT,62,34,1556,189,530,.357,49,180,.272,140,350,.400,.403,85,106,.802,51,122,173,76,51,20,65,155,512
288,Tyrone Nesby\nesbyty01,SG,25,LAC,14,12,333,40,123,.325,10,46,.217,30,77,.390,.366,18,23,.783,16,26,42,11,10,4,10,28,108
288,Tyrone Nesby\nesbyty01,SF,25,WAS,48,22,1223,149,407,.366,39,134,.291,110,273,.403,.414,67,83,.807,35,96,131,65,41,16,55,127,404
289,Rasho Nesterovic\nestera01,C,24,MIN,73,39,1233,147,319,.461,0,1,.000,147,318,.462,.461,34,65,.523,99,187,286,45,25,63,55,189,328
290,Ira Newble\newblir01,SF,26,SAS,27,6,184,21,55,.382,4,9,.444,17,46,.370,.418,8,16,.500,13,22,35,6,2,4,7,18,54
291,Johnny Newman\newmajo01,SG,37,NJN,82,17,2049,291,695,.419,59,176,.335,232,519,.447,.461,254,297,.855,34,142,176,115,63,10,106,229,895
292,Moochie Norris\norrimo01,PG,27,HOU,82,6,1654,184,413,.446,25,89,.281,159,324,.491,.476,151,194,.778,44,154,198,283,69,2,107,84,544
293,Dirk Nowitzki\nowitdi01,PF,22,DAL,82,82,3125,591,1247,.474,151,390,.387,440,857,.513,.534,451,538,.838,119,635,754,173,79,101,156,245,1784
294,Jermaine O'Neal\onealje01,C,22,IND,81,80,2641,404,868,.465,0,5,.000,404,863,.468,.465,233,388,.601,249,545,794,98,49,228,161,280,1041
295,Shaquille O'Neal*\onealsh01,C,28,LAL,74,74,2924,813,1422,.572,0,2,.000,813,1420,.573,.572,499,972,.513,291,649,940,277,47,204,218,256,2125
296,Charles Oakley\oaklech01,PF,37,TOR,78,77,2767,305,786,.388,11,49,.224,294,737,.399,.395,127,152,.836,142,599,741,264,76,48,139,258,748
297,Lamar Odom\odomla01,PF,21,LAC,76,74,2836,481,1046,.460,80,253,.316,401,793,.506,.498,262,386,.679,110,482,592,392,74,122,264,236,1304
298,Hakeem Olajuwon*\olajuha01,C,38,HOU,58,55,1545,283,568,.498,0,1,.000,283,567,.499,.498,123,198,.621,124,307,431,72,70,88,81,141,689
299,Kevin Ollie\ollieke01,PG,28,TOT,70,4,925,76,192,.396,1,3,.333,75,189,.397,.398,63,89,.708,16,79,95,146,30,1,49,84,216
299,Kevin Ollie\ollieke01,PG,28,NJN,19,0,161,5,27,.185,0,0,,5,27,.185,.185,12,19,.632,3,20,23,25,5,0,9,14,22
299,Kevin Ollie\ollieke01,PG,28,PHI,51,4,764,71,165,.430,1,3,.333,70,162,.432,.433,51,70,.729,13,59,72,121,25,1,40,70,194
300,Michael Olowokandi\olowomi01,C,25,LAC,82,82,2127,308,708,.435,0,0,,308,708,.435,.435,85,156,.545,168,357,525,46,30,108,169,250,701
301,Greg Ostertag\ostergr01,C,27,UTA,81,3,1491,139,281,.495,1,2,.500,138,279,.495,.496,84,151,.556,164,251,415,22,22,142,63,215,363
302,Bo Outlaw\outlabo01,PF,29,ORL,80,69,2534,226,368,.614,1,2,.500,225,366,.615,.615,129,225,.573,211,408,619,225,105,137,141,241,582
303,Doug Overton\overtdo01,PG,31,TOT,21,10,475,52,139,.374,11,36,.306,41,103,.398,.414,10,16,.625,4,35,39,72,8,0,31,37,125
303,Doug Overton\overtdo01,PG,31,BOS,7,1,144,15,44,.341,1,4,.250,14,40,.350,.352,7,11,.636,3,12,15,19,4,0,13,15,38
303,Doug Overton\overtdo01,PG,31,CHH,2,0,15,2,2,1.000,0,0,,2,2,1.000,1.000,0,0,,0,0,0,0,1,0,3,2,4
303,Doug Overton\overtdo01,PG,31,NJN,12,9,316,35,93,.376,10,32,.313,25,61,.410,.430,3,5,.600,1,23,24,53,3,0,15,20,83
304,Billy Owens\owensbi01,PF,31,DET,45,14,793,88,230,.383,3,20,.150,85,210,.405,.389,19,40,.475,84,121,205,55,32,12,39,93,198
305,Olumide Oyedeji\oyedeol01,C,19,SEA,30,1,221,18,37,.486,0,0,,18,37,.486,.486,9,12,.750,24,43,67,2,7,10,11,40,45
306,Robert Pack\packro01,PG,31,DEN,74,11,1260,181,426,.425,12,31,.387,169,395,.428,.439,105,137,.766,30,107,137,293,65,1,135,114,479
307,Scott Padgett\padgesc01,PF,24,UTA,27,0,127,18,43,.419,5,9,.556,13,34,.382,.477,15,20,.750,19,20,39,5,6,3,10,21,56
308,Milt Palacio\palacmi01,PG,22,BOS,58,6,1141,126,267,.472,12,36,.333,114,231,.494,.494,78,92,.848,25,77,102,151,48,0,80,83,342
309,Andy Panko\pankoan01,SF,23,ATL,1,0,1,0,0,,0,0,,0,0,,,0,0,,0,0,0,0,0,0,0,0,0
310,Cherokee Parks\parksch02,C,28,TOT,65,31,1054,134,274,.489,0,6,.000,134,268,.500,.489,31,44,.705,71,158,229,46,25,36,41,122,299
310,Cherokee Parks\parksch02,C,28,WAS,13,0,178,18,38,.474,0,0,,18,38,.474,.474,12,17,.706,13,27,40,7,6,11,10,20,48
310,Cherokee Parks\parksch02,C,28,LAC,52,31,876,116,236,.492,0,6,.000,116,230,.504,.492,19,27,.704,58,131,189,39,19,25,31,102,251
311,Ruben Patterson\patteru01,SF,25,SEA,76,22,2059,370,749,.494,2,36,.056,368,713,.516,.495,246,361,.681,183,199,382,161,103,45,155,176,988
312,Gary Payton*\paytoga01,PG,32,SEA,79,79,3244,725,1591,.456,102,272,.375,623,1319,.472,.488,271,354,.766,73,288,361,642,127,26,209,184,1823
313,Anthony Peeler\peelean01,SG,31,MIN,75,41,2126,308,732,.421,100,256,.391,208,476,.437,.489,75,87,.862,44,148,192,192,91,18,105,166,791
314,Mike Penberthy\penbemi01,PG,26,LAL,53,0,851,92,222,.414,55,139,.396,37,83,.446,.538,28,31,.903,10,53,63,71,22,2,34,57,267
315,Will Perdue\perduwi01,C,35,POR,13,0,58,6,9,.667,0,0,,6,9,.667,.667,2,4,.500,6,12,18,2,3,2,0,8,14
316,Sam Perkins\perkisa01,PF,39,IND,64,41,999,86,226,.381,38,110,.345,48,116,.414,.465,32,38,.842,32,136,168,41,33,18,19,61,242
317,Elliot Perry\perryel01,PG,31,TOT,49,6,499,65,140,.464,1,5,.200,64,135,.474,.468,16,22,.727,9,37,46,79,22,1,38,29,147
317,Elliot Perry\perryel01,PG,31,ORL,6,0,39,5,11,.455,0,1,.000,5,10,.500,.455,0,0,,1,3,4,5,3,0,6,1,10
317,Elliot Perry\perryel01,PG,31,PHO,43,6,460,60,129,.465,1,4,.250,59,125,.472,.469,16,22,.727,8,34,42,74,19,1,32,28,137
318,Wesley Person\persowe01,SG,29,CLE,44,22,958,128,292,.438,34,84,.405,94,208,.452,.497,24,30,.800,11,119,130,64,27,11,40,62,314
319,Morris Peterson\petermo01,SG,23,TOR,80,49,1809,290,673,.431,63,165,.382,227,508,.447,.478,104,145,.717,112,147,259,105,63,20,78,164,747
320,Eric Piatkowski\piatker01,SG,30,LAC,81,40,2144,291,672,.433,120,297,.404,171,375,.456,.522,158,181,.873,54,187,241,96,46,19,76,123,860
321,Paul Pierce\piercpa01,SF,23,BOS,82,82,3120,687,1513,.454,147,384,.383,540,1129,.478,.503,550,738,.745,94,428,522,253,138,69,262,251,2071
322,Scottie Pippen*\pippesc01,SF,35,POR,64,60,2133,269,596,.451,64,186,.344,205,410,.500,.505,119,161,.739,70,263,333,294,94,35,154,158,721
323,Scot Pollard\pollasc01,C,25,SAC,77,8,1658,185,395,.468,0,2,.000,185,393,.471,.468,128,171,.749,173,292,465,47,48,97,66,206,498
324,Olden Polynice\polynol01,C,36,UTA,81,79,1619,206,415,.496,0,1,.000,206,414,.498,.496,17,65,.262,157,221,378,31,27,77,78,241,429
325,Mark Pope\popema01,PF,28,MIL,63,45,942,62,142,.437,5,24,.208,57,118,.483,.454,22,35,.629,56,91,147,38,16,26,17,140,151
326,Chris Porter\portech01,SF,22,GSW,51,35,1147,173,445,.389,0,5,.000,173,440,.393,.389,94,141,.667,89,100,189,61,45,6,59,111,440
327,Terry Porter\portete01,PG,37,SAS,80,42,1678,197,440,.448,87,205,.424,110,235,.468,.547,92,116,.793,24,177,201,251,52,11,104,88,573
328,James Posey\poseyja01,SF,24,DEN,82,82,2255,243,590,.412,65,217,.300,178,373,.477,.467,115,141,.816,125,306,431,163,93,40,102,226,666
329,Lavor Postell\postela01,SG,22,NYK,26,0,169,17,54,.315,3,11,.273,14,43,.326,.343,22,27,.815,8,17,25,5,4,2,17,12,59
330,Vitaly Potapenko\potapvi01,C,25,BOS,82,7,1901,248,521,.476,0,0,,248,521,.476,.476,115,158,.728,206,289,495,64,52,23,105,228,611
331,Brent Price\pricebr01,PG,32,VAN,6,0,30,3,11,.273,1,4,.250,2,7,.286,.318,6,7,.857,1,3,4,5,2,0,4,8,13
332,Laron Profit\profila01,PG,23,WAS,35,12,605,56,142,.394,7,26,.269,49,116,.422,.419,33,45,.733,18,46,64,89,36,11,46,43,152
333,Joel Przybilla\przybjo01,C,21,MIL,33,13,270,12,35,.343,0,0,,12,35,.343,.343,3,11,.273,29,42,71,2,3,30,13,56,27
334,Theo Ratliff\ratlith01,C,27,PHI,50,50,1800,228,457,.499,0,0,,228,457,.499,.499,165,217,.760,125,288,413,58,30,187,126,165,621
335,Eldridge Recasner\recasel01,PG,33,CHH,43,0,403,38,114,.333,13,39,.333,25,75,.333,.390,14,18,.778,13,37,50,39,6,1,27,30,103
336,Michael Redd\reddmi01,SG,21,MIL,6,0,35,5,19,.263,0,3,.000,5,16,.313,.263,3,6,.500,3,1,4,1,1,0,1,2,13
337,Bryant Reeves\reevebr01,C,27,VAN,75,48,1832,254,552,.460,1,4,.250,253,548,.462,.461,113,142,.796,132,320,452,80,43,54,90,243,622
338,Don Reid\reiddo01,PF,27,ORL,65,7,764,82,145,.566,0,0,,82,145,.566,.566,46,75,.613,84,158,242,21,23,54,48,190,210
339,J.R. Reid\reidjr01,PF,32,CLE,6,0,39,2,5,.400,0,0,,2,5,.400,.400,6,8,.750,5,3,8,1,2,1,1,4,10
340,Glen Rice\ricegl01,SF,33,NYK,75,25,2212,331,752,.440,82,211,.389,249,541,.460,.495,155,182,.852,61,246,307,89,41,13,96,179,899
341,Quentin Richardson\richaqu01,SG,20,LAC,76,28,1358,232,525,.442,50,151,.331,182,374,.487,.490,99,158,.627,105,152,257,62,42,7,64,98,613
342,Mitch Richmond*\richmmi01,SG,35,WAS,37,30,1216,205,504,.407,45,133,.338,160,371,.431,.451,143,160,.894,15,94,109,111,43,7,84,86,598
343,Isaiah Rider\rideris01,SG,29,LAL,67,6,1206,201,472,.426,34,92,.370,167,380,.439,.462,71,83,.855,44,112,156,111,27,7,98,105,507
344,Terrance Roberson\roberte01,SF,24,CHH,3,0,13,0,2,.000,0,1,.000,0,1,.000,.000,0,0,,0,1,1,1,0,0,2,3,0
345,Clifford Robinson\robincl02,PF,34,PHO,82,82,2751,501,1186,.422,90,249,.361,411,937,.439,.460,253,357,.709,105,229,334,237,87,82,186,258,1345
346,David Robinson*\robinda01,C,35,SAS,80,80,2371,400,823,.486,0,1,.000,400,822,.487,.486,351,470,.747,208,483,691,116,80,197,122,212,1151
347,Eddie Robinson\robined01,SF,24,CHH,67,6,1201,216,407,.531,2,4,.500,214,403,.531,.533,64,88,.727,60,138,198,59,50,32,43,66,498
348,Glenn Robinson\robingl01,SF,28,MIL,76,74,2813,684,1460,.468,55,184,.299,629,1276,.493,.487,251,306,.820,124,402,526,252,86,62,219,191,1674
349,Jamal Robinson\robinja03,SF,27,MIA,6,0,72,3,22,.136,0,2,.000,3,20,.150,.136,0,0,,3,8,11,2,6,0,3,7,6
350,James Robinson\robinja02,PG,30,ORL,6,0,50,4,11,.364,2,5,.400,2,6,.333,.455,0,0,,0,8,8,0,4,1,4,5,10
351,Larry Robinson\robinla01,PG-SG,33,TOT,34,1,632,67,184,.364,44,116,.379,23,68,.338,.484,21,24,.875,23,64,87,36,28,2,25,46,199
351,Larry Robinson\robinla01,SG,33,CLE,1,0,1,0,0,,0,0,,0,0,,,0,0,,0,0,0,0,0,0,1,0,0
351,Larry Robinson\robinla01,PG,33,ATL,33,1,631,67,184,.364,44,116,.379,23,68,.338,.484,21,24,.875,23,64,87,36,28,2,24,46,199
352,Carlos Rogers\rogerca01,C,29,HOU,39,0,544,75,110,.682,0,1,.000,75,109,.688,.682,29,52,.558,48,91,139,9,10,18,17,33,179
353,Rodney Rogers\rogerro01,SF,29,PHO,82,3,2183,377,876,.430,56,189,.296,321,687,.467,.462,188,247,.761,94,265,359,180,97,47,157,269,998
354,Sean Rooks\rooksse01,C,31,LAC,82,0,1553,169,395,.428,1,2,.500,168,393,.427,.429,107,143,.748,91,212,303,77,34,64,73,197,446
355,Jalen Rose\roseja01,SF,28,IND,72,72,2943,567,1242,.457,59,174,.339,508,1068,.476,.480,285,344,.828,37,322,359,435,65,43,211,230,1478
356,Malik Rose\rosema01,PF,26,SAS,57,9,1219,160,368,.435,3,17,.176,157,351,.447,.439,114,160,.713,95,213,308,48,59,40,74,148,437
357,Michael Ruffin\ruffimi01,PF,24,CHI,45,16,879,40,90,.444,0,0,,40,90,.444,.444,39,77,.506,101,161,262,39,30,38,46,131,119
358,Bryon Russell\russebr01,SF,30,UTA,78,46,2473,308,700,.440,95,230,.413,213,470,.453,.508,222,285,.779,94,236,330,160,96,20,113,229,933
359,Arvydas Sabonis*\sabonar01,C,36,POR,61,42,1299,247,516,.479,1,15,.067,246,501,.491,.480,121,156,.776,51,280,331,91,40,62,85,137,616
360,Soumaila Samake\samakso01,C,22,NJN,34,0,226,18,48,.375,0,0,,18,48,.375,.375,10,24,.417,22,31,53,1,2,14,4,23,46
361,Pepe Sanchez\sanchpe01,PG,23,TOT,29,0,150,9,28,.321,0,1,.000,9,27,.333,.321,2,2,1.000,3,12,15,41,11,1,6,21,20
361,Pepe Sanchez\sanchpe01,PG,23,ATL,5,0,34,0,7,.000,0,0,,0,7,.000,.000,0,0,,1,0,1,5,2,0,3,3,0
361,Pepe Sanchez\sanchpe01,PG,23,PHI,24,0,116,9,21,.429,0,1,.000,9,20,.450,.429,2,2,1.000,2,12,14,36,9,1,3,18,20
362,Daniel Santiago\santida01,C,24,PHO,54,2,581,64,134,.478,0,0,,64,134,.478,.478,42,61,.689,35,67,102,11,17,21,47,101,170
363,Detlef Schrempf\schrede01,SF,38,POR,26,0,397,39,95,.411,3,8,.375,36,87,.414,.426,23,27,.852,17,61,78,44,7,3,28,43,104
364,Shawnelle Scott\scottsh01,C,28,SAS,27,1,144,17,41,.415,0,0,,17,41,.415,.415,9,22,.409,23,27,50,4,5,6,11,23,43
365,Brian Shaw\shawbr01,SG,34,LAL,80,28,1833,164,411,.399,42,135,.311,122,276,.442,.450,51,64,.797,48,256,304,258,49,27,97,159,421
366,Brian Skinner\skinnbr01,PF,24,LAC,39,23,584,64,161,.398,0,0,,64,161,.398,.398,32,59,.542,55,113,168,18,14,11,32,61,160
367,Reggie Slater\slatere01,PF,30,MIN,55,16,686,90,175,.514,0,0,,90,175,.514,.514,74,110,.673,78,108,186,26,18,9,43,126,254
368,Jabari Smith\smithja01,C,23,SAC,9,0,66,11,22,.500,0,0,,11,22,.500,.500,4,6,.667,1,7,8,6,4,0,3,7,26
369,Joe Smith\smithjo02,PF,25,DET,69,59,1941,308,765,.403,0,5,.000,308,760,.405,.403,231,287,.805,160,331,491,79,47,50,88,258,847
370,Michael Smith\smithmi02,PF,28,WAS,79,29,1610,106,218,.486,0,1,.000,106,217,.488,.486,89,154,.578,172,390,562,101,57,37,62,156,301
371,Mike Smith\smithmi03,SF,24,WAS,17,0,180,19,59,.322,3,18,.167,16,41,.390,.347,10,16,.625,10,12,22,10,5,3,7,8,51
372,Steve Smith\smithst01,SG,31,POR,81,36,2542,359,788,.456,78,230,.339,281,558,.504,.505,309,347,.890,87,185,272,213,48,24,137,203,1105
373,Tony Smith\smithto02,SG,32,ATL,6,0,78,8,23,.348,0,2,.000,8,21,.381,.348,1,2,.500,2,1,3,10,7,0,9,12,17
374,Eric Snow\snower01,PG,27,PHI,50,50,1740,182,435,.418,5,19,.263,177,416,.425,.424,122,154,.792,27,139,166,369,77,7,124,123,491
375,Felton Spencer\spencfe01,C,33,NYK,18,0,113,12,20,.600,0,0,,12,20,.600,.600,15,25,.600,16,19,35,2,2,2,11,24,39
376,Latrell Sprewell\sprewla01,SF,30,NYK,77,77,3017,524,1219,.430,41,135,.304,483,1084,.446,.447,275,351,.783,49,298,347,269,106,28,218,159,1364
377,Jerry Stackhouse\stackje01,SG,26,DET,80,80,3215,774,1927,.402,166,473,.351,608,1454,.418,.445,666,810,.822,99,216,315,410,97,54,326,160,2380
378,John Starks\starkjo01,SG,35,UTA,75,64,2122,273,686,.398,64,182,.352,209,504,.415,.445,89,111,.802,29,125,154,178,73,10,94,217,699
379,Vladimir Stepania\stepavl01,C,24,NJN,29,0,280,28,88,.318,1,4,.250,27,84,.321,.324,25,34,.735,35,74,109,16,10,11,19,47,82
380,DeShawn Stevenson\stevede01,SG,19,UTA,40,2,293,31,91,.341,1,12,.083,30,79,.380,.346,26,38,.684,9,19,28,18,10,2,28,29,89
381,Michael Stewart\stewami01,C,25,TOR,26,0,123,11,34,.324,0,0,,11,34,.324,.324,11,18,.611,16,13,29,2,4,3,5,19,33
382,Bryant Stith\stithbr01,SG,30,BOS,78,74,2504,245,611,.401,91,242,.376,154,369,.417,.475,175,207,.845,65,219,284,168,93,14,90,182,756
383,John Stockton*\stockjo01,PG,38,UTA,82,82,2397,328,651,.504,61,132,.462,267,519,.514,.551,227,278,.817,54,173,227,713,132,21,203,194,944
384,Peja Stojakovic\stojape01,SF,23,SAC,75,75,2905,559,1189,.470,144,360,.400,415,829,.501,.531,267,312,.856,93,341,434,164,91,13,146,144,1529
385,Damon Stoudamire\stoudda01,PG,27,POR,82,82,2655,406,935,.434,82,219,.374,324,716,.453,.478,172,207,.831,69,234,303,468,106,8,191,202,1066
386,Erick Strickland\stricer01,PG,27,TOT,50,0,830,81,267,.303,30,95,.316,51,172,.297,.360,68,79,.861,18,110,128,95,44,2,48,88,260
386,Erick Strickland\stricer01,PG,27,NYK,28,0,421,40,131,.305,16,47,.340,24,84,.286,.366,24,28,.857,9,43,52,29,22,1,21,46,120
386,Erick Strickland\stricer01,PG,27,VAN,22,0,409,41,136,.301,14,48,.292,27,88,.307,.353,44,51,.863,9,67,76,66,22,1,27,42,140
387,Mark Strickland\stricma01,SF,30,TOT,55,2,719,103,239,.431,1,2,.500,102,237,.430,.433,45,70,.643,54,107,161,24,16,22,34,72,252
387,Mark Strickland\stricma01,SF,30,DEN,46,2,517,82,185,.443,0,1,.000,82,184,.446,.443,37,59,.627,43,77,120,17,12,19,24,58,201
387,Mark Strickland\stricma01,SF,30,NJN,9,0,202,21,54,.389,1,1,1.000,20,53,.377,.398,8,11,.727,11,30,41,7,4,3,10,14,51
388,Rod Strickland\stricro02,PG,34,TOT,54,28,1371,182,429,.424,4,17,.235,178,412,.432,.429,130,173,.751,36,104,140,303,53,5,107,76,498
388,Rod Strickland\stricro02,PG,34,WAS,33,28,1020,141,331,.426,4,16,.250,137,315,.435,.432,115,147,.782,25,80,105,231,43,4,83,55,401
388,Rod Strickland\stricro02,PG,34,POR,21,0,351,41,98,.418,0,1,.000,41,97,.423,.418,15,26,.577,11,24,35,72,10,1,24,21,97
389,Derek Strong\stronde01,PF,32,LAC,28,8,491,45,117,.385,0,1,.000,45,116,.388,.385,28,37,.757,34,74,108,7,14,1,22,30,118
390,Bruno Sundov\sundobr01,C,20,IND,11,4,120,20,41,.488,0,4,.000,20,37,.541,.488,3,5,.600,4,19,23,2,2,4,3,21,43
391,Bob Sura\surabo01,SG,27,GSW,53,42,1684,202,518,.390,47,172,.273,155,346,.448,.435,135,189,.714,54,173,227,242,54,8,160,127,586
392,Stromile Swift\swiftst01,PF,21,VAN,80,6,1312,153,339,.451,0,4,.000,153,335,.457,.451,85,141,.603,109,175,284,28,62,82,64,160,391
393,Wally Szczerbiak\szczewa02,SF,23,MIN,82,82,2856,469,920,.510,26,77,.338,443,843,.526,.524,181,208,.870,133,314,447,260,59,33,138,226,1145
394,Zan Tabak\tabakza01,C,30,IND,55,14,777,98,186,.527,0,0,,98,186,.527,.527,20,47,.426,65,148,213,33,10,30,57,125,216
395,Dragan Tarlac\tarladr01,C,27,CHI,43,12,598,39,99,.394,0,0,,39,99,.394,.394,25,33,.758,37,85,122,31,7,19,38,95,103
396,Maurice Taylor\tayloma01,SF,24,HOU,69,69,1972,390,797,.489,0,4,.000,390,793,.492,.489,119,162,.735,109,269,378,104,28,38,125,208,899
397,Jason Terry\terryja01,SG,23,ATL,82,77,3089,596,1367,.436,124,314,.395,472,1053,.448,.481,303,358,.846,42,227,269,403,104,12,239,204,1619
398,Jamel Thomas\thomaja01,SF,27,NJN,5,0,56,6,19,.316,1,3,.333,5,16,.313,.342,0,0,,4,5,9,0,3,0,6,6,13
399,Kenny Thomas\thomake01,PF,23,HOU,74,21,1820,206,465,.443,25,92,.272,181,373,.485,.470,91,126,.722,122,295,417,77,40,43,116,178,528
400,Kurt Thomas\thomaku01,PF,28,NYK,77,29,2125,314,614,.511,1,3,.333,313,611,.512,.512,171,210,.814,172,343,515,63,61,69,99,287,800
401,Tim Thomas\thomati01,PF,23,MIL,76,16,2086,326,758,.430,107,260,.412,219,498,.440,.501,195,253,.771,79,234,313,138,78,45,114,194,954
402,Otis Thorpe\thorpot01,PF,38,CHH,49,4,647,59,131,.450,0,0,,59,131,.450,.450,20,24,.833,50,95,145,29,12,7,32,108,138
403,Robert Traylor\traylro01,C,23,CLE,70,7,1212,161,324,.497,0,2,.000,161,322,.500,.497,80,141,.567,124,176,300,63,49,76,98,204,402
404,Gary Trent\trentga01,PF,26,DAL,33,4,319,57,130,.438,0,1,.000,57,129,.442,.438,19,36,.528,39,53,92,10,13,8,22,52,133
405,Jake Tsakalidis\tsakaja01,C,21,PHO,57,39,947,101,215,.470,0,0,,101,215,.470,.470,54,91,.593,83,159,242,19,10,55,66,137,256
406,Hedo Turkoglu\turkohe01,SF,21,SAC,74,7,1245,138,335,.412,28,86,.326,110,249,.442,.454,87,112,.777,49,161,210,69,52,24,55,139,391
407,Nick Van Exel\vanexni01,PG,29,DEN,71,70,2688,460,1112,.414,135,358,.377,325,754,.431,.474,204,249,.819,44,197,241,600,61,18,165,109,1259
408,Keith Van Horn\vanhoke01,SF,25,NJN,49,47,1733,308,708,.435,65,170,.382,243,538,.452,.481,150,186,.806,78,269,347,82,40,20,103,150,831
409,David Vanterpool\vanteda01,PG,27,WAS,22,0,411,46,110,.418,0,6,.000,46,104,.442,.418,30,50,.600,15,22,37,66,23,3,37,44,122
410,Jacque Vaughn\vaughja01,PG,25,UTA,82,0,1620,170,393,.433,30,78,.385,140,315,.444,.471,128,164,.780,18,132,150,323,48,3,129,145,498
411,Loy Vaught\vaughlo01,PF,32,TOT,51,1,549,80,169,.473,0,0,,80,169,.473,.473,8,10,.800,51,122,173,23,21,7,26,74,168
411,Loy Vaught\vaughlo01,PF,32,DAL,37,1,392,55,121,.455,0,0,,55,121,.455,.455,4,6,.667,35,88,123,16,15,5,18,61,114
411,Loy Vaught\vaughlo01,PF,32,WAS,14,0,157,25,48,.521,0,0,,25,48,.521,.521,4,4,1.000,16,34,50,7,6,2,8,13,54
412,Jake Voskuhl\voskuja01,C,23,CHI,16,2,143,11,25,.440,0,0,,11,25,.440,.440,8,14,.571,12,22,34,5,5,6,12,38,30
413,Antoine Walker\walkean02,PF,24,BOS,81,81,3396,711,1720,.413,221,603,.367,490,1117,.439,.478,249,348,.716,151,568,719,445,138,49,301,251,1892
414,Samaki Walker\walkesa01,PF,24,SAS,61,1,963,121,252,.480,1,3,.333,120,249,.482,.482,78,124,.629,67,176,243,29,10,41,68,103,321
415,Ben Wallace\wallabe01,C,26,DET,80,80,2760,215,439,.490,1,4,.250,214,435,.492,.491,80,238,.336,303,749,1052,123,107,186,117,192,511
416,John Wallace\wallajo01,SF,26,DET,40,0,527,100,236,.424,2,15,.133,98,221,.443,.428,35,45,.778,25,58,83,23,13,16,36,72,237
417,Rasheed Wallace\wallara01,PF,26,POR,77,75,2940,590,1178,.501,52,162,.321,538,1016,.530,.523,245,320,.766,147,455,602,212,90,135,158,206,1477
418,Charlie Ward\wardch01,PG,30,NYK,61,33,1492,155,373,.416,67,175,.383,88,198,.444,.505,56,70,.800,32,127,159,273,70,10,112,132,433
419,Clarence Weatherspoon\weathcl01,PF,30,CLE,82,82,2774,347,692,.501,0,0,,347,692,.501,.501,230,291,.790,223,573,796,103,85,105,112,171,924
420,Chris Webber\webbech01,PF,27,SAC,70,70,2836,786,1635,.481,2,28,.071,784,1607,.488,.481,324,461,.703,179,598,777,294,93,118,195,226,1898
421,Bonzi Wells\wellsbo01,SF,24,POR,75,46,1995,387,726,.533,17,50,.340,370,676,.547,.545,159,240,.663,120,247,367,208,94,20,169,203,950
422,David Wesley\wesleda01,SG,30,CHH,82,82,3106,523,1239,.422,97,258,.376,426,981,.434,.461,271,339,.799,64,160,224,361,128,16,171,220,1414
423,Doug West\westdo01,SG,33,VAN,15,6,171,11,38,.289,0,2,.000,11,36,.306,.289,6,7,.857,4,11,15,14,3,4,4,21,28
424,Jahidi White\whiteja01,C,24,WAS,68,56,1609,203,408,.498,0,1,.000,203,407,.499,.498,177,312,.567,178,343,521,20,32,111,136,211,583
425,Chris Whitney\whitnch01,PG,29,WAS,59,31,1532,182,470,.387,93,248,.375,89,222,.401,.486,101,113,.894,12,94,106,248,55,3,103,150,558
426,Aaron Williams\williaa01,PF,29,NJN,82,25,2336,297,650,.457,0,2,.000,297,648,.458,.457,244,310,.787,211,379,590,88,59,113,132,319,838
427,Alvin Williams\willial02,SG,26,TOR,82,34,2394,330,767,.430,33,108,.306,297,659,.451,.452,109,145,.752,50,162,212,407,123,26,103,171,802
428,Eric Williams\willier01,SF,28,BOS,81,11,1745,162,448,.362,46,139,.331,116,309,.375,.413,165,231,.714,64,143,207,112,64,13,76,179,535
429,Jason Williams\willija02,PG,25,SAC,77,77,2290,281,690,.407,98,311,.315,183,379,.483,.478,60,76,.789,19,166,185,416,94,9,160,114,720
430,Jerome Williams\willije01,PF,27,TOT,59,2,1182,136,294,.463,0,3,.000,136,291,.467,.463,100,135,.741,133,249,382,45,57,20,63,124,372
430,Jerome Williams\willije01,PF,27,DET,33,2,804,88,201,.438,0,2,.000,88,199,.442,.438,65,90,.722,98,180,278,32,39,10,47,81,241
430,Jerome Williams\willije01,PF,27,TOR,26,0,378,48,93,.516,0,1,.000,48,92,.522,.516,35,45,.778,35,69,104,13,18,10,16,43,131
431,Monty Williams\willimo01,SF,29,ORL,82,0,1211,162,364,.445,1,13,.077,161,351,.459,.446,85,133,.639,86,157,243,79,29,16,85,136,410
432,Scott Williams\willisc01,C,32,MIL,66,31,1272,171,361,.474,1,4,.250,170,357,.476,.475,60,70,.857,97,267,364,35,48,32,41,178,403
433,Shammond Williams\willish01,PG,25,SEA,69,6,1238,161,368,.438,61,133,.459,100,235,.426,.520,84,96,.875,34,98,132,190,31,4,82,83,467
434,Walt Williams\williwa02,SF,30,HOU,72,31,1583,202,513,.394,98,248,.395,104,265,.392,.489,97,126,.770,31,214,245,97,30,28,73,153,599
435,Corliss Williamson\willico02,SF,27,TOT,69,40,1686,325,647,.502,0,2,.000,325,645,.504,.502,151,237,.637,110,211,321,61,50,21,110,185,801
435,Corliss Williamson\willico02,SF,27,TOR,42,31,886,153,325,.471,0,2,.000,153,323,.474,.471,84,130,.646,57,96,153,33,15,13,65,98,390
435,Corliss Williamson\willico02,SF,27,DET,27,9,800,172,322,.534,0,0,,172,322,.534,.534,67,107,.626,53,115,168,28,35,8,45,87,411
436,Kevin Willis\willike02,C,38,TOT,78,22,1830,304,690,.441,1,6,.167,303,684,.443,.441,113,147,.769,177,355,532,50,57,52,87,216,722
436,Kevin Willis\willike02,C,38,TOR,35,9,771,124,269,.461,0,2,.000,124,267,.464,.461,61,81,.753,68,155,223,21,19,21,40,78,309
436,Kevin Willis\willike02,C,38,DEN,43,13,1059,180,421,.428,1,4,.250,179,417,.429,.429,52,66,.788,109,200,309,29,38,31,47,138,413
437,David Wingate\wingada01,SG,37,SEA,1,0,9,3,3,1.000,0,0,,3,3,1.000,1.000,0,0,,0,0,0,2,0,0,0,1,6
438,Ruben Wolkowyski\wolkoru01,PF,27,SEA,34,1,305,25,79,.316,0,2,.000,25,77,.325,.316,25,34,.735,12,34,46,3,6,18,12,38,75
439,Metta World Peace\artesro01,SF,21,CHI,76,74,2363,327,815,.401,43,148,.291,284,667,.426,.428,210,280,.750,59,235,294,228,152,45,159,254,907
440,Lorenzen Wright\wrighlo02,C,25,ATL,71,46,1988,363,811,.448,0,2,.000,363,809,.449,.448,155,216,.718,180,355,535,87,42,63,125,232,881
441,Wang Zhizhi\zhizhwa01,C,23,DAL,5,0,38,8,19,.421,0,2,.000,8,17,.471,.421,8,10,.800,1,6,7,0,0,0,1,8,24